data_point;region;vac_interval_group;vaccine;vac_count_18_59;vac_count_60;vac_count_total;nas_age_18_59;nas_age_60;nas_age_adult_total
2021.11_01-07-2022;Алтайский край;105_165_days;AllVaccines;128206;62600;190806;1240936;570412;1811348
2021.11_01-07-2022;Алтайский край;105_165_days;CoviVac;1606;698;2304;1240936;570412;1811348
2021.11_01-07-2022;Алтайский край;105_165_days;EpiVacCorona;4320;2383;6703;1240936;570412;1811348
2021.11_01-07-2022;Алтайский край;105_165_days;SputnikLite;551;54;605;1240936;570412;1811348
2021.11_01-07-2022;Алтайский край;105_165_days;SputnikV;121729;59465;181194;1240936;570412;1811348
2021.11_01-07-2022;Алтайский край;165_195_days;AllVaccines;34642;44213;78855;1240936;570412;1811348
2021.11_01-07-2022;Алтайский край;165_195_days;CoviVac;2;0;2;1240936;570412;1811348
2021.11_01-07-2022;Алтайский край;165_195_days;EpiVacCorona;1354;1131;2485;1240936;570412;1811348
2021.11_01-07-2022;Алтайский край;165_195_days;SputnikLite;6;0;6;1240936;570412;1811348
2021.11_01-07-2022;Алтайский край;165_195_days;SputnikV;33280;43082;76362;1240936;570412;1811348
2021.11_01-07-2022;Алтайский край;21_45_days;AllVaccines;29340;19816;49156;1240936;570412;1811348
2021.11_01-07-2022;Алтайский край;21_45_days;CoviVac;232;61;293;1240936;570412;1811348
2021.11_01-07-2022;Алтайский край;21_45_days;EpiVacCorona;288;150;438;1240936;570412;1811348
2021.11_01-07-2022;Алтайский край;21_45_days;SputnikLite;17864;13495;31359;1240936;570412;1811348
2021.11_01-07-2022;Алтайский край;21_45_days;SputnikV;10956;6110;17066;1240936;570412;1811348
2021.11_01-07-2022;Алтайский край;45_75_days;AllVaccines;67586;24191;91777;1240936;570412;1811348
2021.11_01-07-2022;Алтайский край;45_75_days;CoviVac;997;99;1096;1240936;570412;1811348
2021.11_01-07-2022;Алтайский край;45_75_days;EpiVacCorona;1414;324;1738;1240936;570412;1811348
2021.11_01-07-2022;Алтайский край;45_75_days;SputnikLite;19788;11392;31180;1240936;570412;1811348
2021.11_01-07-2022;Алтайский край;45_75_days;SputnikV;45387;12376;57763;1240936;570412;1811348
2021.11_01-07-2022;Алтайский край;75_90_days;AllVaccines;73488;12796;86284;1240936;570412;1811348
2021.11_01-07-2022;Алтайский край;75_90_days;CoviVac;1135;84;1219;1240936;570412;1811348
2021.11_01-07-2022;Алтайский край;75_90_days;EpiVacCorona;2206;467;2673;1240936;570412;1811348
2021.11_01-07-2022;Алтайский край;75_90_days;SputnikLite;20658;2344;23002;1240936;570412;1811348
2021.11_01-07-2022;Алтайский край;75_90_days;SputnikV;49489;9901;59390;1240936;570412;1811348
2021.11_01-07-2022;Алтайский край;90_105_days;AllVaccines;66099;14238;80337;1240936;570412;1811348
2021.11_01-07-2022;Алтайский край;90_105_days;CoviVac;458;54;512;1240936;570412;1811348
2021.11_01-07-2022;Алтайский край;90_105_days;EpiVacCorona;518;107;625;1240936;570412;1811348
2021.11_01-07-2022;Алтайский край;90_105_days;SputnikLite;17887;1289;19176;1240936;570412;1811348
2021.11_01-07-2022;Алтайский край;90_105_days;SputnikV;47236;12788;60024;1240936;570412;1811348
2021.11_01-07-2022;Амурская область;105_165_days;AllVaccines;63446;15757;79203;444961;159780;604741
2021.11_01-07-2022;Амурская область;105_165_days;CoviVac;800;210;1010;444961;159780;604741
2021.11_01-07-2022;Амурская область;105_165_days;EpiVacCorona;817;349;1166;444961;159780;604741
2021.11_01-07-2022;Амурская область;105_165_days;SputnikLite;2652;13;2665;444961;159780;604741
2021.11_01-07-2022;Амурская область;105_165_days;SputnikV;59177;15185;74362;444961;159780;604741
2021.11_01-07-2022;Амурская область;165_195_days;AllVaccines;15095;8691;23786;444961;159780;604741
2021.11_01-07-2022;Амурская область;165_195_days;EpiVacCorona;258;132;390;444961;159780;604741
2021.11_01-07-2022;Амурская область;165_195_days;SputnikV;14837;8559;23396;444961;159780;604741
2021.11_01-07-2022;Амурская область;21_45_days;AllVaccines;16404;6979;23383;444961;159780;604741
2021.11_01-07-2022;Амурская область;21_45_days;CoviVac;221;75;296;444961;159780;604741
2021.11_01-07-2022;Амурская область;21_45_days;EpiVacCorona;77;42;119;444961;159780;604741
2021.11_01-07-2022;Амурская область;21_45_days;SputnikLite;10371;5278;15649;444961;159780;604741
2021.11_01-07-2022;Амурская область;21_45_days;SputnikV;5735;1584;7319;444961;159780;604741
2021.11_01-07-2022;Амурская область;45_75_days;AllVaccines;27266;8636;35902;444961;159780;604741
2021.11_01-07-2022;Амурская область;45_75_days;CoviVac;281;90;371;444961;159780;604741
2021.11_01-07-2022;Амурская область;45_75_days;EpiVacCorona;194;88;282;444961;159780;604741
2021.11_01-07-2022;Амурская область;45_75_days;SputnikLite;9409;4908;14317;444961;159780;604741
2021.11_01-07-2022;Амурская область;45_75_days;SputnikV;17382;3550;20932;444961;159780;604741
2021.11_01-07-2022;Амурская область;75_90_days;AllVaccines;26824;3817;30641;444961;159780;604741
2021.11_01-07-2022;Амурская область;75_90_days;CoviVac;10;0;10;444961;159780;604741
2021.11_01-07-2022;Амурская область;75_90_days;EpiVacCorona;700;169;869;444961;159780;604741
2021.11_01-07-2022;Амурская область;75_90_days;SputnikLite;9196;1532;10728;444961;159780;604741
2021.11_01-07-2022;Амурская область;75_90_days;SputnikV;16918;2116;19034;444961;159780;604741
2021.11_01-07-2022;Амурская область;90_105_days;AllVaccines;37445;4120;41565;444961;159780;604741
2021.11_01-07-2022;Амурская область;90_105_days;CoviVac;13;2;15;444961;159780;604741
2021.11_01-07-2022;Амурская область;90_105_days;EpiVacCorona;213;39;252;444961;159780;604741
2021.11_01-07-2022;Амурская область;90_105_days;SputnikLite;10879;390;11269;444961;159780;604741
2021.11_01-07-2022;Амурская область;90_105_days;SputnikV;26340;3689;30029;444961;159780;604741
2021.11_01-07-2022;Архангельская область;105_165_days;AllVaccines;55962;26518;82480;595439;264499;859938
2021.11_01-07-2022;Архангельская область;105_165_days;CoviVac;978;106;1084;595439;264499;859938
2021.11_01-07-2022;Архангельская область;105_165_days;EpiVacCorona;1102;220;1322;595439;264499;859938
2021.11_01-07-2022;Архангельская область;105_165_days;SputnikLite;1737;126;1863;595439;264499;859938
2021.11_01-07-2022;Архангельская область;105_165_days;SputnikV;52145;26066;78211;595439;264499;859938
2021.11_01-07-2022;Архангельская область;165_195_days;AllVaccines;19086;22688;41774;595439;264499;859938
2021.11_01-07-2022;Архангельская область;165_195_days;EpiVacCorona;51;24;75;595439;264499;859938
2021.11_01-07-2022;Архангельская область;165_195_days;SputnikV;19035;22664;41699;595439;264499;859938
2021.11_01-07-2022;Архангельская область;21_45_days;AllVaccines;29320;13258;42578;595439;264499;859938
2021.11_01-07-2022;Архангельская область;21_45_days;CoviVac;181;38;219;595439;264499;859938
2021.11_01-07-2022;Архангельская область;21_45_days;EpiVacCorona;116;52;168;595439;264499;859938
2021.11_01-07-2022;Архангельская область;21_45_days;SputnikLite;22470;10161;32631;595439;264499;859938
2021.11_01-07-2022;Архангельская область;21_45_days;SputnikV;6553;3007;9560;595439;264499;859938
2021.11_01-07-2022;Архангельская область;45_75_days;AllVaccines;29632;12748;42380;595439;264499;859938
2021.11_01-07-2022;Архангельская область;45_75_days;CoviVac;92;18;110;595439;264499;859938
2021.11_01-07-2022;Архангельская область;45_75_days;EpiVacCorona;674;289;963;595439;264499;859938
2021.11_01-07-2022;Архангельская область;45_75_days;SputnikLite;10594;6035;16629;595439;264499;859938
2021.11_01-07-2022;Архангельская область;45_75_days;SputnikV;18272;6406;24678;595439;264499;859938
2021.11_01-07-2022;Архангельская область;75_90_days;AllVaccines;39605;8673;48278;595439;264499;859938
2021.11_01-07-2022;Архангельская область;75_90_days;CoviVac;95;13;108;595439;264499;859938
2021.11_01-07-2022;Архангельская область;75_90_days;EpiVacCorona;1527;439;1966;595439;264499;859938
2021.11_01-07-2022;Архангельская область;75_90_days;SputnikLite;8908;1492;10400;595439;264499;859938
2021.11_01-07-2022;Архангельская область;75_90_days;SputnikV;29075;6729;35804;595439;264499;859938
2021.11_01-07-2022;Архангельская область;90_105_days;AllVaccines;38952;8787;47739;595439;264499;859938
2021.11_01-07-2022;Архангельская область;90_105_days;CoviVac;482;49;531;595439;264499;859938
2021.11_01-07-2022;Архангельская область;90_105_days;EpiVacCorona;552;81;633;595439;264499;859938
2021.11_01-07-2022;Архангельская область;90_105_days;SputnikLite;5756;473;6229;595439;264499;859938
2021.11_01-07-2022;Архангельская область;90_105_days;SputnikV;32162;8184;40346;595439;264499;859938
2021.11_01-07-2022;Астраханская область;105_165_days;AllVaccines;97051;23274;120325;550968;219749;770717
2021.11_01-07-2022;Астраханская область;105_165_days;CoviVac;760;214;974;550968;219749;770717
2021.11_01-07-2022;Астраханская область;105_165_days;EpiVacCorona;4036;982;5018;550968;219749;770717
2021.11_01-07-2022;Астраханская область;105_165_days;SputnikLite;136;8;144;550968;219749;770717
2021.11_01-07-2022;Астраханская область;105_165_days;SputnikV;92119;22070;114189;550968;219749;770717
2021.11_01-07-2022;Астраханская область;165_195_days;AllVaccines;25193;12142;37335;550968;219749;770717
2021.11_01-07-2022;Астраханская область;165_195_days;EpiVacCorona;129;86;215;550968;219749;770717
2021.11_01-07-2022;Астраханская область;165_195_days;SputnikLite;1;0;1;550968;219749;770717
2021.11_01-07-2022;Астраханская область;165_195_days;SputnikV;25063;12056;37119;550968;219749;770717
2021.11_01-07-2022;Астраханская область;21_45_days;AllVaccines;18413;6968;25381;550968;219749;770717
2021.11_01-07-2022;Астраханская область;21_45_days;CoviVac;157;76;233;550968;219749;770717
2021.11_01-07-2022;Астраханская область;21_45_days;EpiVacCorona;249;130;379;550968;219749;770717
2021.11_01-07-2022;Астраханская область;21_45_days;SputnikLite;10720;4807;15527;550968;219749;770717
2021.11_01-07-2022;Астраханская область;21_45_days;SputnikV;7287;1955;9242;550968;219749;770717
2021.11_01-07-2022;Астраханская область;45_75_days;AllVaccines;26844;8652;35496;550968;219749;770717
2021.11_01-07-2022;Астраханская область;45_75_days;CoviVac;194;64;258;550968;219749;770717
2021.11_01-07-2022;Астраханская область;45_75_days;EpiVacCorona;573;279;852;550968;219749;770717
2021.11_01-07-2022;Астраханская область;45_75_days;SputnikLite;7293;3200;10493;550968;219749;770717
2021.11_01-07-2022;Астраханская область;45_75_days;SputnikV;18784;5109;23893;550968;219749;770717
2021.11_01-07-2022;Астраханская область;75_90_days;AllVaccines;26521;4147;30668;550968;219749;770717
2021.11_01-07-2022;Астраханская область;75_90_days;CoviVac;75;11;86;550968;219749;770717
2021.11_01-07-2022;Астраханская область;75_90_days;EpiVacCorona;272;115;387;550968;219749;770717
2021.11_01-07-2022;Астраханская область;75_90_days;SputnikLite;4200;658;4858;550968;219749;770717
2021.11_01-07-2022;Астраханская область;75_90_days;SputnikV;21974;3363;25337;550968;219749;770717
2021.11_01-07-2022;Астраханская область;90_105_days;AllVaccines;36608;5623;42231;550968;219749;770717
2021.11_01-07-2022;Астраханская область;90_105_days;CoviVac;180;50;230;550968;219749;770717
2021.11_01-07-2022;Астраханская область;90_105_days;EpiVacCorona;335;68;403;550968;219749;770717
2021.11_01-07-2022;Астраханская область;90_105_days;SputnikLite;2497;252;2749;550968;219749;770717
2021.11_01-07-2022;Астраханская область;90_105_days;SputnikV;33596;5253;38849;550968;219749;770717
2021.11_01-07-2022;Белгородская область;105_165_days;AllVaccines;240530;65152;305682;867731;383871;1251602
2021.11_01-07-2022;Белгородская область;105_165_days;CoviVac;240;51;291;867731;383871;1251602
2021.11_01-07-2022;Белгородская область;105_165_days;EpiVacCorona;16604;4441;21045;867731;383871;1251602
2021.11_01-07-2022;Белгородская область;105_165_days;SputnikLite;882;126;1008;867731;383871;1251602
2021.11_01-07-2022;Белгородская область;105_165_days;SputnikV;222804;60534;283338;867731;383871;1251602
2021.11_01-07-2022;Белгородская область;165_195_days;AllVaccines;59942;26274;86216;867731;383871;1251602
2021.11_01-07-2022;Белгородская область;165_195_days;CoviVac;420;182;602;867731;383871;1251602
2021.11_01-07-2022;Белгородская область;165_195_days;EpiVacCorona;442;343;785;867731;383871;1251602
2021.11_01-07-2022;Белгородская область;165_195_days;SputnikLite;3;0;3;867731;383871;1251602
2021.11_01-07-2022;Белгородская область;165_195_days;SputnikV;59077;25749;84826;867731;383871;1251602
2021.11_01-07-2022;Белгородская область;21_45_days;AllVaccines;39639;26416;66055;867731;383871;1251602
2021.11_01-07-2022;Белгородская область;21_45_days;CoviVac;340;127;467;867731;383871;1251602
2021.11_01-07-2022;Белгородская область;21_45_days;EpiVacCorona;218;101;319;867731;383871;1251602
2021.11_01-07-2022;Белгородская область;21_45_days;SputnikLite;28546;21050;49596;867731;383871;1251602
2021.11_01-07-2022;Белгородская область;21_45_days;SputnikV;10535;5138;15673;867731;383871;1251602
2021.11_01-07-2022;Белгородская область;45_75_days;AllVaccines;40525;21009;61534;867731;383871;1251602
2021.11_01-07-2022;Белгородская область;45_75_days;CoviVac;725;208;933;867731;383871;1251602
2021.11_01-07-2022;Белгородская область;45_75_days;EpiVacCorona;357;230;587;867731;383871;1251602
2021.11_01-07-2022;Белгородская область;45_75_days;SputnikLite;12059;9219;21278;867731;383871;1251602
2021.11_01-07-2022;Белгородская область;45_75_days;SputnikV;27384;11352;38736;867731;383871;1251602
2021.11_01-07-2022;Белгородская область;75_90_days;AllVaccines;43485;11314;54799;867731;383871;1251602
2021.11_01-07-2022;Белгородская область;75_90_days;CoviVac;837;125;962;867731;383871;1251602
2021.11_01-07-2022;Белгородская область;75_90_days;EpiVacCorona;1247;543;1790;867731;383871;1251602
2021.11_01-07-2022;Белгородская область;75_90_days;SputnikLite;7403;2104;9507;867731;383871;1251602
2021.11_01-07-2022;Белгородская область;75_90_days;SputnikV;33998;8542;42540;867731;383871;1251602
2021.11_01-07-2022;Белгородская область;90_105_days;AllVaccines;64552;12224;76776;867731;383871;1251602
2021.11_01-07-2022;Белгородская область;90_105_days;CoviVac;989;218;1207;867731;383871;1251602
2021.11_01-07-2022;Белгородская область;90_105_days;EpiVacCorona;1589;526;2115;867731;383871;1251602
2021.11_01-07-2022;Белгородская область;90_105_days;SputnikLite;5791;768;6559;867731;383871;1251602
2021.11_01-07-2022;Белгородская область;90_105_days;SputnikV;56183;10712;66895;867731;383871;1251602
2021.11_01-07-2022;Брянская область;105_165_days;AllVaccines;88449;32220;120669;659625;298625;958250
2021.11_01-07-2022;Брянская область;105_165_days;CoviVac;837;279;1116;659625;298625;958250
2021.11_01-07-2022;Брянская область;105_165_days;EpiVacCorona;781;714;1495;659625;298625;958250
2021.11_01-07-2022;Брянская область;105_165_days;SputnikLite;6;2;8;659625;298625;958250
2021.11_01-07-2022;Брянская область;105_165_days;SputnikV;86825;31225;118050;659625;298625;958250
2021.11_01-07-2022;Брянская область;165_195_days;AllVaccines;13378;13580;26958;659625;298625;958250
2021.11_01-07-2022;Брянская область;165_195_days;EpiVacCorona;66;68;134;659625;298625;958250
2021.11_01-07-2022;Брянская область;165_195_days;SputnikV;13312;13512;26824;659625;298625;958250
2021.11_01-07-2022;Брянская область;21_45_days;AllVaccines;30149;14663;44812;659625;298625;958250
2021.11_01-07-2022;Брянская область;21_45_days;CoviVac;170;43;213;659625;298625;958250
2021.11_01-07-2022;Брянская область;21_45_days;EpiVacCorona;98;47;145;659625;298625;958250
2021.11_01-07-2022;Брянская область;21_45_days;SputnikLite;17504;11189;28693;659625;298625;958250
2021.11_01-07-2022;Брянская область;21_45_days;SputnikV;12377;3384;15761;659625;298625;958250
2021.11_01-07-2022;Брянская область;45_75_days;AllVaccines;32764;10389;43153;659625;298625;958250
2021.11_01-07-2022;Брянская область;45_75_days;CoviVac;395;106;501;659625;298625;958250
2021.11_01-07-2022;Брянская область;45_75_days;EpiVacCorona;211;76;287;659625;298625;958250
2021.11_01-07-2022;Брянская область;45_75_days;SputnikLite;13775;5487;19262;659625;298625;958250
2021.11_01-07-2022;Брянская область;45_75_days;SputnikV;18383;4720;23103;659625;298625;958250
2021.11_01-07-2022;Брянская область;75_90_days;AllVaccines;25508;5914;31422;659625;298625;958250
2021.11_01-07-2022;Брянская область;75_90_days;CoviVac;120;25;145;659625;298625;958250
2021.11_01-07-2022;Брянская область;75_90_days;EpiVacCorona;624;211;835;659625;298625;958250
2021.11_01-07-2022;Брянская область;75_90_days;SputnikLite;4163;891;5054;659625;298625;958250
2021.11_01-07-2022;Брянская область;75_90_days;SputnikV;20601;4787;25388;659625;298625;958250
2021.11_01-07-2022;Брянская область;90_105_days;AllVaccines;36452;8288;44740;659625;298625;958250
2021.11_01-07-2022;Брянская область;90_105_days;CoviVac;164;46;210;659625;298625;958250
2021.11_01-07-2022;Брянская область;90_105_days;EpiVacCorona;235;80;315;659625;298625;958250
2021.11_01-07-2022;Брянская область;90_105_days;SputnikLite;2677;411;3088;659625;298625;958250
2021.11_01-07-2022;Брянская область;90_105_days;SputnikV;33376;7751;41127;659625;298625;958250
2021.11_01-07-2022;Владимирская область;105_165_days;AllVaccines;56806;24096;80902;739166;354521;1093687
2021.11_01-07-2022;Владимирская область;105_165_days;CoviVac;1563;487;2050;739166;354521;1093687
2021.11_01-07-2022;Владимирская область;105_165_days;EpiVacCorona;826;670;1496;739166;354521;1093687
2021.11_01-07-2022;Владимирская область;105_165_days;SputnikLite;534;47;581;739166;354521;1093687
2021.11_01-07-2022;Владимирская область;105_165_days;SputnikV;53883;22892;76775;739166;354521;1093687
2021.11_01-07-2022;Владимирская область;165_195_days;AllVaccines;11206;14735;25941;739166;354521;1093687
2021.11_01-07-2022;Владимирская область;165_195_days;CoviVac;0;1;1;739166;354521;1093687
2021.11_01-07-2022;Владимирская область;165_195_days;EpiVacCorona;75;55;130;739166;354521;1093687
2021.11_01-07-2022;Владимирская область;165_195_days;SputnikLite;2;1;3;739166;354521;1093687
2021.11_01-07-2022;Владимирская область;165_195_days;SputnikV;11129;14678;25807;739166;354521;1093687
2021.11_01-07-2022;Владимирская область;21_45_days;AllVaccines;19252;13051;32303;739166;354521;1093687
2021.11_01-07-2022;Владимирская область;21_45_days;CoviVac;61;16;77;739166;354521;1093687
2021.11_01-07-2022;Владимирская область;21_45_days;EpiVacCorona;148;92;240;739166;354521;1093687
2021.11_01-07-2022;Владимирская область;21_45_days;SputnikLite;11485;9465;20950;739166;354521;1093687
2021.11_01-07-2022;Владимирская область;21_45_days;SputnikV;7558;3478;11036;739166;354521;1093687
2021.11_01-07-2022;Владимирская область;45_75_days;AllVaccines;40042;16783;56825;739166;354521;1093687
2021.11_01-07-2022;Владимирская область;45_75_days;CoviVac;593;124;717;739166;354521;1093687
2021.11_01-07-2022;Владимирская область;45_75_days;EpiVacCorona;571;192;763;739166;354521;1093687
2021.11_01-07-2022;Владимирская область;45_75_days;SputnikLite;16168;8635;24803;739166;354521;1093687
2021.11_01-07-2022;Владимирская область;45_75_days;SputnikV;22710;7832;30542;739166;354521;1093687
2021.11_01-07-2022;Владимирская область;75_90_days;AllVaccines;33510;8924;42434;739166;354521;1093687
2021.11_01-07-2022;Владимирская область;75_90_days;CoviVac;251;45;296;739166;354521;1093687
2021.11_01-07-2022;Владимирская область;75_90_days;EpiVacCorona;1153;385;1538;739166;354521;1093687
2021.11_01-07-2022;Владимирская область;75_90_days;SputnikLite;12239;3226;15465;739166;354521;1093687
2021.11_01-07-2022;Владимирская область;75_90_days;SputnikV;19867;5268;25135;739166;354521;1093687
2021.11_01-07-2022;Владимирская область;90_105_days;AllVaccines;37287;7268;44555;739166;354521;1093687
2021.11_01-07-2022;Владимирская область;90_105_days;CoviVac;558;98;656;739166;354521;1093687
2021.11_01-07-2022;Владимирская область;90_105_days;EpiVacCorona;274;66;340;739166;354521;1093687
2021.11_01-07-2022;Владимирская область;90_105_days;SputnikLite;10944;1492;12436;739166;354521;1093687
2021.11_01-07-2022;Владимирская область;90_105_days;SputnikV;25511;5612;31123;739166;354521;1093687
2021.11_01-07-2022;Волгоградская область;105_165_days;AllVaccines;205709;65800;271509;1387837;615020;2002857
2021.11_01-07-2022;Волгоградская область;105_165_days;CoviVac;6760;1108;7868;1387837;615020;2002857
2021.11_01-07-2022;Волгоградская область;105_165_days;EpiVacCorona;6475;3131;9606;1387837;615020;2002857
2021.11_01-07-2022;Волгоградская область;105_165_days;SputnikLite;601;113;714;1387837;615020;2002857
2021.11_01-07-2022;Волгоградская область;105_165_days;SputnikV;191873;61448;253321;1387837;615020;2002857
2021.11_01-07-2022;Волгоградская область;165_195_days;AllVaccines;55555;42991;98546;1387837;615020;2002857
2021.11_01-07-2022;Волгоградская область;165_195_days;EpiVacCorona;1657;1169;2826;1387837;615020;2002857
2021.11_01-07-2022;Волгоградская область;165_195_days;SputnikLite;1;1;2;1387837;615020;2002857
2021.11_01-07-2022;Волгоградская область;165_195_days;SputnikV;53897;41821;95718;1387837;615020;2002857
2021.11_01-07-2022;Волгоградская область;21_45_days;AllVaccines;43341;25519;68860;1387837;615020;2002857
2021.11_01-07-2022;Волгоградская область;21_45_days;CoviVac;477;150;627;1387837;615020;2002857
2021.11_01-07-2022;Волгоградская область;21_45_days;EpiVacCorona;406;144;550;1387837;615020;2002857
2021.11_01-07-2022;Волгоградская область;21_45_days;SputnikLite;26330;18086;44416;1387837;615020;2002857
2021.11_01-07-2022;Волгоградская область;21_45_days;SputnikV;16128;7139;23267;1387837;615020;2002857
2021.11_01-07-2022;Волгоградская область;45_75_days;AllVaccines;90420;26676;117096;1387837;615020;2002857
2021.11_01-07-2022;Волгоградская область;45_75_days;CoviVac;1287;224;1511;1387837;615020;2002857
2021.11_01-07-2022;Волгоградская область;45_75_days;EpiVacCorona;1841;671;2512;1387837;615020;2002857
2021.11_01-07-2022;Волгоградская область;45_75_days;SputnikLite;25017;12052;37069;1387837;615020;2002857
2021.11_01-07-2022;Волгоградская область;45_75_days;SputnikV;62275;13729;76004;1387837;615020;2002857
2021.11_01-07-2022;Волгоградская область;75_90_days;AllVaccines;87085;15784;102869;1387837;615020;2002857
2021.11_01-07-2022;Волгоградская область;75_90_days;CoviVac;998;91;1089;1387837;615020;2002857
2021.11_01-07-2022;Волгоградская область;75_90_days;EpiVacCorona;2905;724;3629;1387837;615020;2002857
2021.11_01-07-2022;Волгоградская область;75_90_days;SputnikLite;27710;5299;33009;1387837;615020;2002857
2021.11_01-07-2022;Волгоградская область;75_90_days;SputnikV;55472;9670;65142;1387837;615020;2002857
2021.11_01-07-2022;Волгоградская область;90_105_days;AllVaccines;90594;16077;106671;1387837;615020;2002857
2021.11_01-07-2022;Волгоградская область;90_105_days;CoviVac;1721;189;1910;1387837;615020;2002857
2021.11_01-07-2022;Волгоградская область;90_105_days;EpiVacCorona;1041;208;1249;1387837;615020;2002857
2021.11_01-07-2022;Волгоградская область;90_105_days;SputnikLite;16211;2130;18341;1387837;615020;2002857
2021.11_01-07-2022;Волгоградская область;90_105_days;SputnikV;71621;13550;85171;1387837;615020;2002857
2021.11_01-07-2022;Вологодская область;105_165_days;AllVaccines;58459;26997;85456;628100;275171;903271
2021.11_01-07-2022;Вологодская область;105_165_days;CoviVac;639;247;886;628100;275171;903271
2021.11_01-07-2022;Вологодская область;105_165_days;EpiVacCorona;814;1124;1938;628100;275171;903271
2021.11_01-07-2022;Вологодская область;105_165_days;SputnikLite;1106;36;1142;628100;275171;903271
2021.11_01-07-2022;Вологодская область;105_165_days;SputnikV;55900;25590;81490;628100;275171;903271
2021.11_01-07-2022;Вологодская область;165_195_days;AllVaccines;16874;22097;38971;628100;275171;903271
2021.11_01-07-2022;Вологодская область;165_195_days;EpiVacCorona;2434;4124;6558;628100;275171;903271
2021.11_01-07-2022;Вологодская область;165_195_days;SputnikLite;7;2;9;628100;275171;903271
2021.11_01-07-2022;Вологодская область;165_195_days;SputnikV;14433;17971;32404;628100;275171;903271
2021.11_01-07-2022;Вологодская область;21_45_days;AllVaccines;38668;13692;52360;628100;275171;903271
2021.11_01-07-2022;Вологодская область;21_45_days;CoviVac;19;1;20;628100;275171;903271
2021.11_01-07-2022;Вологодская область;21_45_days;EpiVacCorona;45;32;77;628100;275171;903271
2021.11_01-07-2022;Вологодская область;21_45_days;SputnikLite;34983;10552;45535;628100;275171;903271
2021.11_01-07-2022;Вологодская область;21_45_days;SputnikV;3621;3107;6728;628100;275171;903271
2021.11_01-07-2022;Вологодская область;45_75_days;AllVaccines;23661;12110;35771;628100;275171;903271
2021.11_01-07-2022;Вологодская область;45_75_days;CoviVac;69;10;79;628100;275171;903271
2021.11_01-07-2022;Вологодская область;45_75_days;EpiVacCorona;188;184;372;628100;275171;903271
2021.11_01-07-2022;Вологодская область;45_75_days;SputnikLite;15229;6819;22048;628100;275171;903271
2021.11_01-07-2022;Вологодская область;45_75_days;SputnikV;8175;5097;13272;628100;275171;903271
2021.11_01-07-2022;Вологодская область;75_90_days;AllVaccines;27186;6446;33632;628100;275171;903271
2021.11_01-07-2022;Вологодская область;75_90_days;CoviVac;144;16;160;628100;275171;903271
2021.11_01-07-2022;Вологодская область;75_90_days;EpiVacCorona;469;290;759;628100;275171;903271
2021.11_01-07-2022;Вологодская область;75_90_days;SputnikLite;13281;1610;14891;628100;275171;903271
2021.11_01-07-2022;Вологодская область;75_90_days;SputnikV;13292;4530;17822;628100;275171;903271
2021.11_01-07-2022;Вологодская область;90_105_days;AllVaccines;36764;7956;44720;628100;275171;903271
2021.11_01-07-2022;Вологодская область;90_105_days;CoviVac;333;37;370;628100;275171;903271
2021.11_01-07-2022;Вологодская область;90_105_days;EpiVacCorona;59;29;88;628100;275171;903271
2021.11_01-07-2022;Вологодская область;90_105_days;SputnikLite;12449;587;13036;628100;275171;903271
2021.11_01-07-2022;Вологодская область;90_105_days;SputnikV;23923;7303;31226;628100;275171;903271
2021.11_01-07-2022;Воронежская область;105_165_days;AllVaccines;162694;51076;213770;1293123;602333;1895456
2021.11_01-07-2022;Воронежская область;105_165_days;CoviVac;2236;606;2842;1293123;602333;1895456
2021.11_01-07-2022;Воронежская область;105_165_days;EpiVacCorona;6498;3434;9932;1293123;602333;1895456
2021.11_01-07-2022;Воронежская область;105_165_days;SputnikLite;410;71;481;1293123;602333;1895456
2021.11_01-07-2022;Воронежская область;105_165_days;SputnikV;153550;46965;200515;1293123;602333;1895456
2021.11_01-07-2022;Воронежская область;165_195_days;AllVaccines;39346;28905;68251;1293123;602333;1895456
2021.11_01-07-2022;Воронежская область;165_195_days;CoviVac;480;236;716;1293123;602333;1895456
2021.11_01-07-2022;Воронежская область;165_195_days;EpiVacCorona;1953;2084;4037;1293123;602333;1895456
2021.11_01-07-2022;Воронежская область;165_195_days;SputnikLite;1;1;2;1293123;602333;1895456
2021.11_01-07-2022;Воронежская область;165_195_days;SputnikV;36912;26584;63496;1293123;602333;1895456
2021.11_01-07-2022;Воронежская область;21_45_days;AllVaccines;64395;32304;96699;1293123;602333;1895456
2021.11_01-07-2022;Воронежская область;21_45_days;CoviVac;937;325;1262;1293123;602333;1895456
2021.11_01-07-2022;Воронежская область;21_45_days;EpiVacCorona;275;172;447;1293123;602333;1895456
2021.11_01-07-2022;Воронежская область;21_45_days;SputnikLite;46895;22527;69422;1293123;602333;1895456
2021.11_01-07-2022;Воронежская область;21_45_days;SputnikV;16288;9280;25568;1293123;602333;1895456
2021.11_01-07-2022;Воронежская область;45_75_days;AllVaccines;58795;34424;93219;1293123;602333;1895456
2021.11_01-07-2022;Воронежская область;45_75_days;CoviVac;1163;382;1545;1293123;602333;1895456
2021.11_01-07-2022;Воронежская область;45_75_days;EpiVacCorona;682;510;1192;1293123;602333;1895456
2021.11_01-07-2022;Воронежская область;45_75_days;SputnikLite;20989;19735;40724;1293123;602333;1895456
2021.11_01-07-2022;Воронежская область;45_75_days;SputnikV;35961;13797;49758;1293123;602333;1895456
2021.11_01-07-2022;Воронежская область;75_90_days;AllVaccines;50768;13118;63886;1293123;602333;1895456
2021.11_01-07-2022;Воронежская область;75_90_days;CoviVac;999;206;1205;1293123;602333;1895456
2021.11_01-07-2022;Воронежская область;75_90_days;EpiVacCorona;1994;781;2775;1293123;602333;1895456
2021.11_01-07-2022;Воронежская область;75_90_days;SputnikLite;14100;5225;19325;1293123;602333;1895456
2021.11_01-07-2022;Воронежская область;75_90_days;SputnikV;33675;6906;40581;1293123;602333;1895456
2021.11_01-07-2022;Воронежская область;90_105_days;AllVaccines;72750;13568;86318;1293123;602333;1895456
2021.11_01-07-2022;Воронежская область;90_105_days;CoviVac;1514;358;1872;1293123;602333;1895456
2021.11_01-07-2022;Воронежская область;90_105_days;EpiVacCorona;1414;507;1921;1293123;602333;1895456
2021.11_01-07-2022;Воронежская область;90_105_days;SputnikLite;15321;2160;17481;1293123;602333;1895456
2021.11_01-07-2022;Воронежская область;90_105_days;SputnikV;54501;10543;65044;1293123;602333;1895456
2021.11_01-07-2022;Еврейская автономная область;105_165_days;AllVaccines;11932;4523;16455;88207;31969;120176
2021.11_01-07-2022;Еврейская автономная область;105_165_days;CoviVac;606;89;695;88207;31969;120176
2021.11_01-07-2022;Еврейская автономная область;105_165_days;EpiVacCorona;4126;1740;5866;88207;31969;120176
2021.11_01-07-2022;Еврейская автономная область;105_165_days;SputnikLite;1;0;1;88207;31969;120176
2021.11_01-07-2022;Еврейская автономная область;105_165_days;SputnikV;7199;2694;9893;88207;31969;120176
2021.11_01-07-2022;Еврейская автономная область;165_195_days;AllVaccines;1709;1340;3049;88207;31969;120176
2021.11_01-07-2022;Еврейская автономная область;165_195_days;EpiVacCorona;669;418;1087;88207;31969;120176
2021.11_01-07-2022;Еврейская автономная область;165_195_days;SputnikV;1040;922;1962;88207;31969;120176
2021.11_01-07-2022;Еврейская автономная область;21_45_days;AllVaccines;1770;1143;2913;88207;31969;120176
2021.11_01-07-2022;Еврейская автономная область;21_45_days;CoviVac;2;0;2;88207;31969;120176
2021.11_01-07-2022;Еврейская автономная область;21_45_days;EpiVacCorona;5;1;6;88207;31969;120176
2021.11_01-07-2022;Еврейская автономная область;21_45_days;SputnikLite;1161;890;2051;88207;31969;120176
2021.11_01-07-2022;Еврейская автономная область;21_45_days;SputnikV;602;252;854;88207;31969;120176
2021.11_01-07-2022;Еврейская автономная область;45_75_days;AllVaccines;2386;1112;3498;88207;31969;120176
2021.11_01-07-2022;Еврейская автономная область;45_75_days;CoviVac;20;2;22;88207;31969;120176
2021.11_01-07-2022;Еврейская автономная область;45_75_days;EpiVacCorona;3;2;5;88207;31969;120176
2021.11_01-07-2022;Еврейская автономная область;45_75_days;SputnikLite;472;452;924;88207;31969;120176
2021.11_01-07-2022;Еврейская автономная область;45_75_days;SputnikV;1891;656;2547;88207;31969;120176
2021.11_01-07-2022;Еврейская автономная область;75_90_days;AllVaccines;2598;451;3049;88207;31969;120176
2021.11_01-07-2022;Еврейская автономная область;75_90_days;CoviVac;19;1;20;88207;31969;120176
2021.11_01-07-2022;Еврейская автономная область;75_90_days;EpiVacCorona;415;80;495;88207;31969;120176
2021.11_01-07-2022;Еврейская автономная область;75_90_days;SputnikLite;184;70;254;88207;31969;120176
2021.11_01-07-2022;Еврейская автономная область;75_90_days;SputnikV;1980;300;2280;88207;31969;120176
2021.11_01-07-2022;Еврейская автономная область;90_105_days;AllVaccines;3089;692;3781;88207;31969;120176
2021.11_01-07-2022;Еврейская автономная область;90_105_days;CoviVac;35;1;36;88207;31969;120176
2021.11_01-07-2022;Еврейская автономная область;90_105_days;EpiVacCorona;77;17;94;88207;31969;120176
2021.11_01-07-2022;Еврейская автономная область;90_105_days;SputnikLite;18;10;28;88207;31969;120176
2021.11_01-07-2022;Еврейская автономная область;90_105_days;SputnikV;2959;664;3623;88207;31969;120176
2021.11_01-07-2022;Забайкальский край;105_165_days;AllVaccines;65217;19119;84336;596322;191826;788148
2021.11_01-07-2022;Забайкальский край;105_165_days;CoviVac;1997;74;2071;596322;191826;788148
2021.11_01-07-2022;Забайкальский край;105_165_days;EpiVacCorona;1366;351;1717;596322;191826;788148
2021.11_01-07-2022;Забайкальский край;105_165_days;SputnikLite;1798;102;1900;596322;191826;788148
2021.11_01-07-2022;Забайкальский край;105_165_days;SputnikV;60056;18592;78648;596322;191826;788148
2021.11_01-07-2022;Забайкальский край;165_195_days;AllVaccines;29770;17798;47568;596322;191826;788148
2021.11_01-07-2022;Забайкальский край;165_195_days;EpiVacCorona;4;1;5;596322;191826;788148
2021.11_01-07-2022;Забайкальский край;165_195_days;SputnikLite;2;0;2;596322;191826;788148
2021.11_01-07-2022;Забайкальский край;165_195_days;SputnikV;29764;17797;47561;596322;191826;788148
2021.11_01-07-2022;Забайкальский край;21_45_days;AllVaccines;20383;9525;29908;596322;191826;788148
2021.11_01-07-2022;Забайкальский край;21_45_days;CoviVac;127;12;139;596322;191826;788148
2021.11_01-07-2022;Забайкальский край;21_45_days;EpiVacCorona;63;25;88;596322;191826;788148
2021.11_01-07-2022;Забайкальский край;21_45_days;SputnikLite;16422;7809;24231;596322;191826;788148
2021.11_01-07-2022;Забайкальский край;21_45_days;SputnikV;3771;1679;5450;596322;191826;788148
2021.11_01-07-2022;Забайкальский край;45_75_days;AllVaccines;30925;8887;39812;596322;191826;788148
2021.11_01-07-2022;Забайкальский край;45_75_days;CoviVac;234;13;247;596322;191826;788148
2021.11_01-07-2022;Забайкальский край;45_75_days;EpiVacCorona;259;47;306;596322;191826;788148
2021.11_01-07-2022;Забайкальский край;45_75_days;SputnikLite;15975;4098;20073;596322;191826;788148
2021.11_01-07-2022;Забайкальский край;45_75_days;SputnikV;14457;4729;19186;596322;191826;788148
2021.11_01-07-2022;Забайкальский край;75_90_days;AllVaccines;33489;5721;39210;596322;191826;788148
2021.11_01-07-2022;Забайкальский край;75_90_days;CoviVac;184;7;191;596322;191826;788148
2021.11_01-07-2022;Забайкальский край;75_90_days;EpiVacCorona;833;214;1047;596322;191826;788148
2021.11_01-07-2022;Забайкальский край;75_90_days;SputnikLite;9834;397;10231;596322;191826;788148
2021.11_01-07-2022;Забайкальский край;75_90_days;SputnikV;22638;5103;27741;596322;191826;788148
2021.11_01-07-2022;Забайкальский край;90_105_days;AllVaccines;31066;4828;35894;596322;191826;788148
2021.11_01-07-2022;Забайкальский край;90_105_days;CoviVac;174;8;182;596322;191826;788148
2021.11_01-07-2022;Забайкальский край;90_105_days;EpiVacCorona;269;152;421;596322;191826;788148
2021.11_01-07-2022;Забайкальский край;90_105_days;SputnikLite;7465;188;7653;596322;191826;788148
2021.11_01-07-2022;Забайкальский край;90_105_days;SputnikV;23158;4480;27638;596322;191826;788148
2021.11_01-07-2022;Ивановская область;105_165_days;AllVaccines;82789;20234;103023;549803;255947;805750
2021.11_01-07-2022;Ивановская область;105_165_days;CoviVac;2937;279;3216;549803;255947;805750
2021.11_01-07-2022;Ивановская область;105_165_days;EpiVacCorona;356;441;797;549803;255947;805750
2021.11_01-07-2022;Ивановская область;105_165_days;SputnikLite;546;49;595;549803;255947;805750
2021.11_01-07-2022;Ивановская область;105_165_days;SputnikV;78950;19465;98415;549803;255947;805750
2021.11_01-07-2022;Ивановская область;165_195_days;AllVaccines;16331;14759;31090;549803;255947;805750
2021.11_01-07-2022;Ивановская область;165_195_days;CoviVac;1;1;2;549803;255947;805750
2021.11_01-07-2022;Ивановская область;165_195_days;EpiVacCorona;348;291;639;549803;255947;805750
2021.11_01-07-2022;Ивановская область;165_195_days;SputnikLite;1;0;1;549803;255947;805750
2021.11_01-07-2022;Ивановская область;165_195_days;SputnikV;15981;14467;30448;549803;255947;805750
2021.11_01-07-2022;Ивановская область;21_45_days;AllVaccines;15172;10925;26097;549803;255947;805750
2021.11_01-07-2022;Ивановская область;21_45_days;CoviVac;69;10;79;549803;255947;805750
2021.11_01-07-2022;Ивановская область;21_45_days;EpiVacCorona;80;70;150;549803;255947;805750
2021.11_01-07-2022;Ивановская область;21_45_days;SputnikLite;10961;8195;19156;549803;255947;805750
2021.11_01-07-2022;Ивановская область;21_45_days;SputnikV;4062;2650;6712;549803;255947;805750
2021.11_01-07-2022;Ивановская область;45_75_days;AllVaccines;15008;8447;23455;549803;255947;805750
2021.11_01-07-2022;Ивановская область;45_75_days;CoviVac;51;5;56;549803;255947;805750
2021.11_01-07-2022;Ивановская область;45_75_days;EpiVacCorona;111;70;181;549803;255947;805750
2021.11_01-07-2022;Ивановская область;45_75_days;SputnikLite;5432;4675;10107;549803;255947;805750
2021.11_01-07-2022;Ивановская область;45_75_days;SputnikV;9414;3697;13111;549803;255947;805750
2021.11_01-07-2022;Ивановская область;75_90_days;AllVaccines;19897;4426;24323;549803;255947;805750
2021.11_01-07-2022;Ивановская область;75_90_days;CoviVac;97;8;105;549803;255947;805750
2021.11_01-07-2022;Ивановская область;75_90_days;EpiVacCorona;341;215;556;549803;255947;805750
2021.11_01-07-2022;Ивановская область;75_90_days;SputnikLite;4022;1109;5131;549803;255947;805750
2021.11_01-07-2022;Ивановская область;75_90_days;SputnikV;15437;3094;18531;549803;255947;805750
2021.11_01-07-2022;Ивановская область;90_105_days;AllVaccines;37849;5521;43370;549803;255947;805750
2021.11_01-07-2022;Ивановская область;90_105_days;CoviVac;343;31;374;549803;255947;805750
2021.11_01-07-2022;Ивановская область;90_105_days;EpiVacCorona;156;105;261;549803;255947;805750
2021.11_01-07-2022;Ивановская область;90_105_days;SputnikLite;3833;449;4282;549803;255947;805750
2021.11_01-07-2022;Ивановская область;90_105_days;SputnikV;33517;4936;38453;549803;255947;805750
2021.11_01-07-2022;Иркутская область;105_165_days;AllVaccines;150698;56670;207368;1316761;480655;1797416
2021.11_01-07-2022;Иркутская область;105_165_days;CoviVac;917;233;1150;1316761;480655;1797416
2021.11_01-07-2022;Иркутская область;105_165_days;EpiVacCorona;4812;2462;7274;1316761;480655;1797416
2021.11_01-07-2022;Иркутская область;105_165_days;SputnikLite;497;111;608;1316761;480655;1797416
2021.11_01-07-2022;Иркутская область;105_165_days;SputnikV;144472;53864;198336;1316761;480655;1797416
2021.11_01-07-2022;Иркутская область;165_195_days;AllVaccines;50517;39213;89730;1316761;480655;1797416
2021.11_01-07-2022;Иркутская область;165_195_days;CoviVac;384;176;560;1316761;480655;1797416
2021.11_01-07-2022;Иркутская область;165_195_days;EpiVacCorona;4322;3792;8114;1316761;480655;1797416
2021.11_01-07-2022;Иркутская область;165_195_days;SputnikLite;2;0;2;1316761;480655;1797416
2021.11_01-07-2022;Иркутская область;165_195_days;SputnikV;45809;35245;81054;1316761;480655;1797416
2021.11_01-07-2022;Иркутская область;21_45_days;AllVaccines;38989;21609;60598;1316761;480655;1797416
2021.11_01-07-2022;Иркутская область;21_45_days;CoviVac;400;146;546;1316761;480655;1797416
2021.11_01-07-2022;Иркутская область;21_45_days;EpiVacCorona;754;319;1073;1316761;480655;1797416
2021.11_01-07-2022;Иркутская область;21_45_days;SputnikLite;20825;16104;36929;1316761;480655;1797416
2021.11_01-07-2022;Иркутская область;21_45_days;SputnikV;17010;5040;22050;1316761;480655;1797416
2021.11_01-07-2022;Иркутская область;45_75_days;AllVaccines;56193;21764;77957;1316761;480655;1797416
2021.11_01-07-2022;Иркутская область;45_75_days;CoviVac;894;217;1111;1316761;480655;1797416
2021.11_01-07-2022;Иркутская область;45_75_days;EpiVacCorona;3672;1138;4810;1316761;480655;1797416
2021.11_01-07-2022;Иркутская область;45_75_days;SputnikLite;13036;10099;23135;1316761;480655;1797416
2021.11_01-07-2022;Иркутская область;45_75_days;SputnikV;38591;10310;48901;1316761;480655;1797416
2021.11_01-07-2022;Иркутская область;75_90_days;AllVaccines;46503;11496;57999;1316761;480655;1797416
2021.11_01-07-2022;Иркутская область;75_90_days;CoviVac;923;186;1109;1316761;480655;1797416
2021.11_01-07-2022;Иркутская область;75_90_days;EpiVacCorona;3959;1018;4977;1316761;480655;1797416
2021.11_01-07-2022;Иркутская область;75_90_days;SputnikLite;6067;2359;8426;1316761;480655;1797416
2021.11_01-07-2022;Иркутская область;75_90_days;SputnikV;35554;7933;43487;1316761;480655;1797416
2021.11_01-07-2022;Иркутская область;90_105_days;AllVaccines;42086;10131;52217;1316761;480655;1797416
2021.11_01-07-2022;Иркутская область;90_105_days;CoviVac;812;185;997;1316761;480655;1797416
2021.11_01-07-2022;Иркутская область;90_105_days;EpiVacCorona;255;67;322;1316761;480655;1797416
2021.11_01-07-2022;Иркутская область;90_105_days;SputnikLite;3373;989;4362;1316761;480655;1797416
2021.11_01-07-2022;Иркутская область;90_105_days;SputnikV;37646;8890;46536;1316761;480655;1797416
2021.11_01-07-2022;Кабардино-Балкарская Республика;105_165_days;AllVaccines;43479;13980;57459;502388;159241;661629
2021.11_01-07-2022;Кабардино-Балкарская Республика;105_165_days;CoviVac;2200;539;2739;502388;159241;661629
2021.11_01-07-2022;Кабардино-Балкарская Республика;105_165_days;EpiVacCorona;3586;1343;4929;502388;159241;661629
2021.11_01-07-2022;Кабардино-Балкарская Республика;105_165_days;SputnikLite;932;167;1099;502388;159241;661629
2021.11_01-07-2022;Кабардино-Балкарская Республика;105_165_days;SputnikV;36761;11931;48692;502388;159241;661629
2021.11_01-07-2022;Кабардино-Балкарская Республика;165_195_days;AllVaccines;4727;3295;8022;502388;159241;661629
2021.11_01-07-2022;Кабардино-Балкарская Республика;165_195_days;CoviVac;1;1;2;502388;159241;661629
2021.11_01-07-2022;Кабардино-Балкарская Республика;165_195_days;EpiVacCorona;2;0;2;502388;159241;661629
2021.11_01-07-2022;Кабардино-Балкарская Республика;165_195_days;SputnikLite;1;1;2;502388;159241;661629
2021.11_01-07-2022;Кабардино-Балкарская Республика;165_195_days;SputnikV;4723;3293;8016;502388;159241;661629
2021.11_01-07-2022;Кабардино-Балкарская Республика;21_45_days;AllVaccines;12962;4821;17783;502388;159241;661629
2021.11_01-07-2022;Кабардино-Балкарская Республика;21_45_days;CoviVac;95;37;132;502388;159241;661629
2021.11_01-07-2022;Кабардино-Балкарская Республика;21_45_days;EpiVacCorona;49;21;70;502388;159241;661629
2021.11_01-07-2022;Кабардино-Балкарская Республика;21_45_days;SputnikLite;9684;3441;13125;502388;159241;661629
2021.11_01-07-2022;Кабардино-Балкарская Республика;21_45_days;SputnikV;3134;1322;4456;502388;159241;661629
2021.11_01-07-2022;Кабардино-Балкарская Республика;45_75_days;AllVaccines;15878;4480;20358;502388;159241;661629
2021.11_01-07-2022;Кабардино-Балкарская Республика;45_75_days;CoviVac;111;27;138;502388;159241;661629
2021.11_01-07-2022;Кабардино-Балкарская Республика;45_75_days;EpiVacCorona;48;22;70;502388;159241;661629
2021.11_01-07-2022;Кабардино-Балкарская Республика;45_75_days;SputnikLite;5774;1837;7611;502388;159241;661629
2021.11_01-07-2022;Кабардино-Балкарская Республика;45_75_days;SputnikV;9945;2594;12539;502388;159241;661629
2021.11_01-07-2022;Кабардино-Балкарская Республика;75_90_days;AllVaccines;24196;4766;28962;502388;159241;661629
2021.11_01-07-2022;Кабардино-Балкарская Республика;75_90_days;CoviVac;145;30;175;502388;159241;661629
2021.11_01-07-2022;Кабардино-Балкарская Республика;75_90_days;EpiVacCorona;409;93;502;502388;159241;661629
2021.11_01-07-2022;Кабардино-Балкарская Республика;75_90_days;SputnikLite;5900;1027;6927;502388;159241;661629
2021.11_01-07-2022;Кабардино-Балкарская Республика;75_90_days;SputnikV;17742;3616;21358;502388;159241;661629
2021.11_01-07-2022;Кабардино-Балкарская Республика;90_105_days;AllVaccines;22372;5160;27532;502388;159241;661629
2021.11_01-07-2022;Кабардино-Балкарская Республика;90_105_days;CoviVac;172;17;189;502388;159241;661629
2021.11_01-07-2022;Кабардино-Балкарская Республика;90_105_days;EpiVacCorona;493;105;598;502388;159241;661629
2021.11_01-07-2022;Кабардино-Балкарская Республика;90_105_days;SputnikLite;2618;567;3185;502388;159241;661629
2021.11_01-07-2022;Кабардино-Балкарская Республика;90_105_days;SputnikV;19089;4471;23560;502388;159241;661629
2021.11_01-07-2022;Калининградская область;105_165_days;AllVaccines;69926;27490;97416;585700;231702;817402
2021.11_01-07-2022;Калининградская область;105_165_days;CoviVac;850;221;1071;585700;231702;817402
2021.11_01-07-2022;Калининградская область;105_165_days;EpiVacCorona;663;531;1194;585700;231702;817402
2021.11_01-07-2022;Калининградская область;105_165_days;SputnikLite;59;70;129;585700;231702;817402
2021.11_01-07-2022;Калининградская область;105_165_days;SputnikV;68354;26668;95022;585700;231702;817402
2021.11_01-07-2022;Калининградская область;165_195_days;AllVaccines;18978;18756;37734;585700;231702;817402
2021.11_01-07-2022;Калининградская область;165_195_days;EpiVacCorona;149;170;319;585700;231702;817402
2021.11_01-07-2022;Калининградская область;165_195_days;SputnikLite;2;0;2;585700;231702;817402
2021.11_01-07-2022;Калининградская область;165_195_days;SputnikV;18827;18586;37413;585700;231702;817402
2021.11_01-07-2022;Калининградская область;21_45_days;AllVaccines;34401;11149;45550;585700;231702;817402
2021.11_01-07-2022;Калининградская область;21_45_days;CoviVac;119;32;151;585700;231702;817402
2021.11_01-07-2022;Калининградская область;21_45_days;EpiVacCorona;251;54;305;585700;231702;817402
2021.11_01-07-2022;Калининградская область;21_45_days;SputnikLite;25776;7828;33604;585700;231702;817402
2021.11_01-07-2022;Калининградская область;21_45_days;SputnikV;8255;3235;11490;585700;231702;817402
2021.11_01-07-2022;Калининградская область;45_75_days;AllVaccines;30363;13758;44121;585700;231702;817402
2021.11_01-07-2022;Калининградская область;45_75_days;CoviVac;379;93;472;585700;231702;817402
2021.11_01-07-2022;Калининградская область;45_75_days;EpiVacCorona;1151;363;1514;585700;231702;817402
2021.11_01-07-2022;Калининградская область;45_75_days;SputnikLite;11436;6320;17756;585700;231702;817402
2021.11_01-07-2022;Калининградская область;45_75_days;SputnikV;17397;6982;24379;585700;231702;817402
2021.11_01-07-2022;Калининградская область;75_90_days;AllVaccines;32881;6834;39715;585700;231702;817402
2021.11_01-07-2022;Калининградская область;75_90_days;CoviVac;61;17;78;585700;231702;817402
2021.11_01-07-2022;Калининградская область;75_90_days;EpiVacCorona;5915;1179;7094;585700;231702;817402
2021.11_01-07-2022;Калининградская область;75_90_days;SputnikLite;11615;2222;13837;585700;231702;817402
2021.11_01-07-2022;Калининградская область;75_90_days;SputnikV;15290;3416;18706;585700;231702;817402
2021.11_01-07-2022;Калининградская область;90_105_days;AllVaccines;34001;5264;39265;585700;231702;817402
2021.11_01-07-2022;Калининградская область;90_105_days;CoviVac;237;37;274;585700;231702;817402
2021.11_01-07-2022;Калининградская область;90_105_days;EpiVacCorona;1124;172;1296;585700;231702;817402
2021.11_01-07-2022;Калининградская область;90_105_days;SputnikLite;6436;495;6931;585700;231702;817402
2021.11_01-07-2022;Калининградская область;90_105_days;SputnikV;26204;4560;30764;585700;231702;817402
2021.11_01-07-2022;Калужская область;105_165_days;AllVaccines;78509;24854;103363;559789;253023;812812
2021.11_01-07-2022;Калужская область;105_165_days;CoviVac;927;228;1155;559789;253023;812812
2021.11_01-07-2022;Калужская область;105_165_days;EpiVacCorona;1884;1231;3115;559789;253023;812812
2021.11_01-07-2022;Калужская область;105_165_days;SputnikLite;396;101;497;559789;253023;812812
2021.11_01-07-2022;Калужская область;105_165_days;SputnikV;75302;23294;98596;559789;253023;812812
2021.11_01-07-2022;Калужская область;165_195_days;AllVaccines;11695;12146;23841;559789;253023;812812
2021.11_01-07-2022;Калужская область;165_195_days;CoviVac;1;0;1;559789;253023;812812
2021.11_01-07-2022;Калужская область;165_195_days;EpiVacCorona;156;168;324;559789;253023;812812
2021.11_01-07-2022;Калужская область;165_195_days;SputnikLite;1;0;1;559789;253023;812812
2021.11_01-07-2022;Калужская область;165_195_days;SputnikV;11537;11978;23515;559789;253023;812812
2021.11_01-07-2022;Калужская область;21_45_days;AllVaccines;21024;11193;32217;559789;253023;812812
2021.11_01-07-2022;Калужская область;21_45_days;CoviVac;97;20;117;559789;253023;812812
2021.11_01-07-2022;Калужская область;21_45_days;EpiVacCorona;299;179;478;559789;253023;812812
2021.11_01-07-2022;Калужская область;21_45_days;SputnikLite;14922;8565;23487;559789;253023;812812
2021.11_01-07-2022;Калужская область;21_45_days;SputnikV;5706;2429;8135;559789;253023;812812
2021.11_01-07-2022;Калужская область;45_75_days;AllVaccines;22835;9655;32490;559789;253023;812812
2021.11_01-07-2022;Калужская область;45_75_days;CoviVac;401;88;489;559789;253023;812812
2021.11_01-07-2022;Калужская область;45_75_days;EpiVacCorona;858;376;1234;559789;253023;812812
2021.11_01-07-2022;Калужская область;45_75_days;SputnikLite;7664;4598;12262;559789;253023;812812
2021.11_01-07-2022;Калужская область;45_75_days;SputnikV;13912;4593;18505;559789;253023;812812
2021.11_01-07-2022;Калужская область;75_90_days;AllVaccines;20498;5894;26392;559789;253023;812812
2021.11_01-07-2022;Калужская область;75_90_days;CoviVac;53;12;65;559789;253023;812812
2021.11_01-07-2022;Калужская область;75_90_days;EpiVacCorona;1476;520;1996;559789;253023;812812
2021.11_01-07-2022;Калужская область;75_90_days;SputnikLite;4345;1759;6104;559789;253023;812812
2021.11_01-07-2022;Калужская область;75_90_days;SputnikV;14624;3603;18227;559789;253023;812812
2021.11_01-07-2022;Калужская область;90_105_days;AllVaccines;31102;6945;38047;559789;253023;812812
2021.11_01-07-2022;Калужская область;90_105_days;CoviVac;264;47;311;559789;253023;812812
2021.11_01-07-2022;Калужская область;90_105_days;EpiVacCorona;504;155;659;559789;253023;812812
2021.11_01-07-2022;Калужская область;90_105_days;SputnikLite;2742;815;3557;559789;253023;812812
2021.11_01-07-2022;Калужская область;90_105_days;SputnikV;27592;5928;33520;559789;253023;812812
2021.11_01-07-2022;Камчатский край;105_165_days;AllVaccines;17463;4942;22405;189425;56856;246281
2021.11_01-07-2022;Камчатский край;105_165_days;CoviVac;608;79;687;189425;56856;246281
2021.11_01-07-2022;Камчатский край;105_165_days;EpiVacCorona;1479;613;2092;189425;56856;246281
2021.11_01-07-2022;Камчатский край;105_165_days;SputnikLite;2;1;3;189425;56856;246281
2021.11_01-07-2022;Камчатский край;105_165_days;SputnikV;15374;4249;19623;189425;56856;246281
2021.11_01-07-2022;Камчатский край;165_195_days;AllVaccines;8048;3762;11810;189425;56856;246281
2021.11_01-07-2022;Камчатский край;165_195_days;EpiVacCorona;3331;1718;5049;189425;56856;246281
2021.11_01-07-2022;Камчатский край;165_195_days;SputnikV;4717;2044;6761;189425;56856;246281
2021.11_01-07-2022;Камчатский край;21_45_days;AllVaccines;5366;1916;7282;189425;56856;246281
2021.11_01-07-2022;Камчатский край;21_45_days;CoviVac;3;3;6;189425;56856;246281
2021.11_01-07-2022;Камчатский край;21_45_days;EpiVacCorona;210;67;277;189425;56856;246281
2021.11_01-07-2022;Камчатский край;21_45_days;SputnikLite;2960;1406;4366;189425;56856;246281
2021.11_01-07-2022;Камчатский край;21_45_days;SputnikV;2193;440;2633;189425;56856;246281
2021.11_01-07-2022;Камчатский край;45_75_days;AllVaccines;10847;2719;13566;189425;56856;246281
2021.11_01-07-2022;Камчатский край;45_75_days;CoviVac;19;4;23;189425;56856;246281
2021.11_01-07-2022;Камчатский край;45_75_days;EpiVacCorona;1024;205;1229;189425;56856;246281
2021.11_01-07-2022;Камчатский край;45_75_days;SputnikLite;3486;1317;4803;189425;56856;246281
2021.11_01-07-2022;Камчатский край;45_75_days;SputnikV;6318;1193;7511;189425;56856;246281
2021.11_01-07-2022;Камчатский край;75_90_days;AllVaccines;9810;1554;11364;189425;56856;246281
2021.11_01-07-2022;Камчатский край;75_90_days;CoviVac;14;9;23;189425;56856;246281
2021.11_01-07-2022;Камчатский край;75_90_days;EpiVacCorona;614;126;740;189425;56856;246281
2021.11_01-07-2022;Камчатский край;75_90_days;SputnikLite;2279;397;2676;189425;56856;246281
2021.11_01-07-2022;Камчатский край;75_90_days;SputnikV;6903;1022;7925;189425;56856;246281
2021.11_01-07-2022;Камчатский край;90_105_days;AllVaccines;6598;1431;8029;189425;56856;246281
2021.11_01-07-2022;Камчатский край;90_105_days;CoviVac;22;6;28;189425;56856;246281
2021.11_01-07-2022;Камчатский край;90_105_days;EpiVacCorona;167;44;211;189425;56856;246281
2021.11_01-07-2022;Камчатский край;90_105_days;SputnikLite;642;64;706;189425;56856;246281
2021.11_01-07-2022;Камчатский край;90_105_days;SputnikV;5767;1317;7084;189425;56856;246281
2021.11_01-07-2022;Карачаево-Черкесская Республика;105_165_days;AllVaccines;32635;8342;40977;266261;94005;360266
2021.11_01-07-2022;Карачаево-Черкесская Республика;105_165_days;CoviVac;1833;467;2300;266261;94005;360266
2021.11_01-07-2022;Карачаево-Черкесская Республика;105_165_days;EpiVacCorona;3196;699;3895;266261;94005;360266
2021.11_01-07-2022;Карачаево-Черкесская Республика;105_165_days;SputnikLite;147;36;183;266261;94005;360266
2021.11_01-07-2022;Карачаево-Черкесская Республика;105_165_days;SputnikV;27459;7140;34599;266261;94005;360266
2021.11_01-07-2022;Карачаево-Черкесская Республика;165_195_days;AllVaccines;12770;4708;17478;266261;94005;360266
2021.11_01-07-2022;Карачаево-Черкесская Республика;165_195_days;EpiVacCorona;584;223;807;266261;94005;360266
2021.11_01-07-2022;Карачаево-Черкесская Республика;165_195_days;SputnikLite;1;0;1;266261;94005;360266
2021.11_01-07-2022;Карачаево-Черкесская Республика;165_195_days;SputnikV;12185;4485;16670;266261;94005;360266
2021.11_01-07-2022;Карачаево-Черкесская Республика;21_45_days;AllVaccines;4585;2144;6729;266261;94005;360266
2021.11_01-07-2022;Карачаево-Черкесская Республика;21_45_days;CoviVac;15;15;30;266261;94005;360266
2021.11_01-07-2022;Карачаево-Черкесская Республика;21_45_days;EpiVacCorona;29;10;39;266261;94005;360266
2021.11_01-07-2022;Карачаево-Черкесская Республика;21_45_days;SputnikLite;2820;1398;4218;266261;94005;360266
2021.11_01-07-2022;Карачаево-Черкесская Республика;21_45_days;SputnikV;1721;721;2442;266261;94005;360266
2021.11_01-07-2022;Карачаево-Черкесская Республика;45_75_days;AllVaccines;12185;3192;15377;266261;94005;360266
2021.11_01-07-2022;Карачаево-Черкесская Республика;45_75_days;CoviVac;91;22;113;266261;94005;360266
2021.11_01-07-2022;Карачаево-Черкесская Республика;45_75_days;EpiVacCorona;424;47;471;266261;94005;360266
2021.11_01-07-2022;Карачаево-Черкесская Республика;45_75_days;SputnikLite;4213;1337;5550;266261;94005;360266
2021.11_01-07-2022;Карачаево-Черкесская Республика;45_75_days;SputnikV;7457;1786;9243;266261;94005;360266
2021.11_01-07-2022;Карачаево-Черкесская Республика;75_90_days;AllVaccines;11476;2371;13847;266261;94005;360266
2021.11_01-07-2022;Карачаево-Черкесская Республика;75_90_days;CoviVac;115;29;144;266261;94005;360266
2021.11_01-07-2022;Карачаево-Черкесская Республика;75_90_days;EpiVacCorona;892;115;1007;266261;94005;360266
2021.11_01-07-2022;Карачаево-Черкесская Республика;75_90_days;SputnikLite;3374;715;4089;266261;94005;360266
2021.11_01-07-2022;Карачаево-Черкесская Республика;75_90_days;SputnikV;7095;1512;8607;266261;94005;360266
2021.11_01-07-2022;Карачаево-Черкесская Республика;90_105_days;AllVaccines;9692;1782;11474;266261;94005;360266
2021.11_01-07-2022;Карачаево-Черкесская Республика;90_105_days;CoviVac;311;64;375;266261;94005;360266
2021.11_01-07-2022;Карачаево-Черкесская Республика;90_105_days;EpiVacCorona;443;58;501;266261;94005;360266
2021.11_01-07-2022;Карачаево-Черкесская Республика;90_105_days;SputnikLite;1489;308;1797;266261;94005;360266
2021.11_01-07-2022;Карачаево-Черкесская Республика;90_105_days;SputnikV;7449;1352;8801;266261;94005;360266
2021.11_01-07-2022;Кемеровская область;105_165_days;AllVaccines;237956;69408;307364;1453976;610256;2064232
2021.11_01-07-2022;Кемеровская область;105_165_days;CoviVac;1852;284;2136;1453976;610256;2064232
2021.11_01-07-2022;Кемеровская область;105_165_days;EpiVacCorona;2395;1311;3706;1453976;610256;2064232
2021.11_01-07-2022;Кемеровская область;105_165_days;SputnikLite;160;20;180;1453976;610256;2064232
2021.11_01-07-2022;Кемеровская область;105_165_days;SputnikV;233549;67793;301342;1453976;610256;2064232
2021.11_01-07-2022;Кемеровская область;165_195_days;AllVaccines;42093;33817;75910;1453976;610256;2064232
2021.11_01-07-2022;Кемеровская область;165_195_days;CoviVac;956;256;1212;1453976;610256;2064232
2021.11_01-07-2022;Кемеровская область;165_195_days;EpiVacCorona;1049;1198;2247;1453976;610256;2064232
2021.11_01-07-2022;Кемеровская область;165_195_days;SputnikLite;1;1;2;1453976;610256;2064232
2021.11_01-07-2022;Кемеровская область;165_195_days;SputnikV;40087;32362;72449;1453976;610256;2064232
2021.11_01-07-2022;Кемеровская область;21_45_days;AllVaccines;31147;18829;49976;1453976;610256;2064232
2021.11_01-07-2022;Кемеровская область;21_45_days;CoviVac;644;145;789;1453976;610256;2064232
2021.11_01-07-2022;Кемеровская область;21_45_days;EpiVacCorona;288;122;410;1453976;610256;2064232
2021.11_01-07-2022;Кемеровская область;21_45_days;SputnikLite;10499;12346;22845;1453976;610256;2064232
2021.11_01-07-2022;Кемеровская область;21_45_days;SputnikV;19716;6216;25932;1453976;610256;2064232
2021.11_01-07-2022;Кемеровская область;45_75_days;AllVaccines;69073;19414;88487;1453976;610256;2064232
2021.11_01-07-2022;Кемеровская область;45_75_days;CoviVac;1101;208;1309;1453976;610256;2064232
2021.11_01-07-2022;Кемеровская область;45_75_days;EpiVacCorona;890;292;1182;1453976;610256;2064232
2021.11_01-07-2022;Кемеровская область;45_75_days;SputnikLite;6375;6556;12931;1453976;610256;2064232
2021.11_01-07-2022;Кемеровская область;45_75_days;SputnikV;60707;12358;73065;1453976;610256;2064232
2021.11_01-07-2022;Кемеровская область;75_90_days;AllVaccines;65026;11872;76898;1453976;610256;2064232
2021.11_01-07-2022;Кемеровская область;75_90_days;CoviVac;209;28;237;1453976;610256;2064232
2021.11_01-07-2022;Кемеровская область;75_90_days;EpiVacCorona;1045;319;1364;1453976;610256;2064232
2021.11_01-07-2022;Кемеровская область;75_90_days;SputnikLite;2618;1193;3811;1453976;610256;2064232
2021.11_01-07-2022;Кемеровская область;75_90_days;SputnikV;61154;10332;71486;1453976;610256;2064232
2021.11_01-07-2022;Кемеровская область;90_105_days;AllVaccines;94692;17285;111977;1453976;610256;2064232
2021.11_01-07-2022;Кемеровская область;90_105_days;CoviVac;609;125;734;1453976;610256;2064232
2021.11_01-07-2022;Кемеровская область;90_105_days;EpiVacCorona;282;95;377;1453976;610256;2064232
2021.11_01-07-2022;Кемеровская область;90_105_days;SputnikLite;1669;464;2133;1453976;610256;2064232
2021.11_01-07-2022;Кемеровская область;90_105_days;SputnikV;92132;16601;108733;1453976;610256;2064232
2021.11_01-07-2022;Кировская область;105_165_days;AllVaccines;73238;38466;111704;663621;334585;998206
2021.11_01-07-2022;Кировская область;105_165_days;CoviVac;1264;130;1394;663621;334585;998206
2021.11_01-07-2022;Кировская область;105_165_days;EpiVacCorona;2265;1015;3280;663621;334585;998206
2021.11_01-07-2022;Кировская область;105_165_days;SputnikLite;236;17;253;663621;334585;998206
2021.11_01-07-2022;Кировская область;105_165_days;SputnikV;69473;37304;106777;663621;334585;998206
2021.11_01-07-2022;Кировская область;165_195_days;AllVaccines;25009;32737;57746;663621;334585;998206
2021.11_01-07-2022;Кировская область;165_195_days;CoviVac;3;1;4;663621;334585;998206
2021.11_01-07-2022;Кировская область;165_195_days;EpiVacCorona;194;238;432;663621;334585;998206
2021.11_01-07-2022;Кировская область;165_195_days;SputnikV;24812;32498;57310;663621;334585;998206
2021.11_01-07-2022;Кировская область;21_45_days;AllVaccines;33565;18315;51880;663621;334585;998206
2021.11_01-07-2022;Кировская область;21_45_days;CoviVac;177;40;217;663621;334585;998206
2021.11_01-07-2022;Кировская область;21_45_days;EpiVacCorona;69;44;113;663621;334585;998206
2021.11_01-07-2022;Кировская область;21_45_days;SputnikLite;29654;15166;44820;663621;334585;998206
2021.11_01-07-2022;Кировская область;21_45_days;SputnikV;3665;3065;6730;663621;334585;998206
2021.11_01-07-2022;Кировская область;45_75_days;AllVaccines;17945;15133;33078;663621;334585;998206
2021.11_01-07-2022;Кировская область;45_75_days;CoviVac;538;34;572;663621;334585;998206
2021.11_01-07-2022;Кировская область;45_75_days;EpiVacCorona;246;107;353;663621;334585;998206
2021.11_01-07-2022;Кировская область;45_75_days;SputnikLite;9320;8802;18122;663621;334585;998206
2021.11_01-07-2022;Кировская область;45_75_days;SputnikV;7841;6190;14031;663621;334585;998206
2021.11_01-07-2022;Кировская область;75_90_days;AllVaccines;21320;7432;28752;663621;334585;998206
2021.11_01-07-2022;Кировская область;75_90_days;CoviVac;61;0;61;663621;334585;998206
2021.11_01-07-2022;Кировская область;75_90_days;EpiVacCorona;670;253;923;663621;334585;998206
2021.11_01-07-2022;Кировская область;75_90_days;SputnikLite;7848;1878;9726;663621;334585;998206
2021.11_01-07-2022;Кировская область;75_90_days;SputnikV;12741;5301;18042;663621;334585;998206
2021.11_01-07-2022;Кировская область;90_105_days;AllVaccines;30196;8214;38410;663621;334585;998206
2021.11_01-07-2022;Кировская область;90_105_days;CoviVac;239;25;264;663621;334585;998206
2021.11_01-07-2022;Кировская область;90_105_days;EpiVacCorona;130;32;162;663621;334585;998206
2021.11_01-07-2022;Кировская область;90_105_days;SputnikLite;7843;710;8553;663621;334585;998206
2021.11_01-07-2022;Кировская область;90_105_days;SputnikV;21984;7447;29431;663621;334585;998206
2021.11_01-07-2022;Костромская область;105_165_days;AllVaccines;36129;14507;50636;339046;160543;499589
2021.11_01-07-2022;Костромская область;105_165_days;CoviVac;861;92;953;339046;160543;499589
2021.11_01-07-2022;Костромская область;105_165_days;EpiVacCorona;367;339;706;339046;160543;499589
2021.11_01-07-2022;Костромская область;105_165_days;SputnikLite;170;33;203;339046;160543;499589
2021.11_01-07-2022;Костромская область;105_165_days;SputnikV;34731;14043;48774;339046;160543;499589
2021.11_01-07-2022;Костромская область;165_195_days;AllVaccines;8189;9818;18007;339046;160543;499589
2021.11_01-07-2022;Костромская область;165_195_days;EpiVacCorona;29;36;65;339046;160543;499589
2021.11_01-07-2022;Костромская область;165_195_days;SputnikV;8160;9782;17942;339046;160543;499589
2021.11_01-07-2022;Костромская область;21_45_days;AllVaccines;12704;7619;20323;339046;160543;499589
2021.11_01-07-2022;Костромская область;21_45_days;CoviVac;27;8;35;339046;160543;499589
2021.11_01-07-2022;Костромская область;21_45_days;EpiVacCorona;2;1;3;339046;160543;499589
2021.11_01-07-2022;Костромская область;21_45_days;SputnikLite;9784;5919;15703;339046;160543;499589
2021.11_01-07-2022;Костромская область;21_45_days;SputnikV;2891;1691;4582;339046;160543;499589
2021.11_01-07-2022;Костромская область;45_75_days;AllVaccines;15303;7146;22449;339046;160543;499589
2021.11_01-07-2022;Костромская область;45_75_days;CoviVac;18;6;24;339046;160543;499589
2021.11_01-07-2022;Костромская область;45_75_days;EpiVacCorona;13;8;21;339046;160543;499589
2021.11_01-07-2022;Костромская область;45_75_days;SputnikLite;5527;3656;9183;339046;160543;499589
2021.11_01-07-2022;Костромская область;45_75_days;SputnikV;9745;3476;13221;339046;160543;499589
2021.11_01-07-2022;Костромская область;75_90_days;AllVaccines;19392;4143;23535;339046;160543;499589
2021.11_01-07-2022;Костромская область;75_90_days;CoviVac;119;21;140;339046;160543;499589
2021.11_01-07-2022;Костромская область;75_90_days;SputnikLite;4427;875;5302;339046;160543;499589
2021.11_01-07-2022;Костромская область;75_90_days;SputnikV;14846;3247;18093;339046;160543;499589
2021.11_01-07-2022;Костромская область;90_105_days;AllVaccines;21208;4457;25665;339046;160543;499589
2021.11_01-07-2022;Костромская область;90_105_days;CoviVac;338;26;364;339046;160543;499589
2021.11_01-07-2022;Костромская область;90_105_days;EpiVacCorona;2;0;2;339046;160543;499589
2021.11_01-07-2022;Костромская область;90_105_days;SputnikLite;4717;669;5386;339046;160543;499589
2021.11_01-07-2022;Костромская область;90_105_days;SputnikV;16151;3762;19913;339046;160543;499589
2021.11_01-07-2022;Краснодарский край;105_165_days;AllVaccines;522654;151268;673922;3157155;1334085;4491240
2021.11_01-07-2022;Краснодарский край;105_165_days;CoviVac;7075;1418;8493;3157155;1334085;4491240
2021.11_01-07-2022;Краснодарский край;105_165_days;EpiVacCorona;34144;17997;52141;3157155;1334085;4491240
2021.11_01-07-2022;Краснодарский край;105_165_days;SputnikLite;744;176;920;3157155;1334085;4491240
2021.11_01-07-2022;Краснодарский край;105_165_days;SputnikV;480691;131677;612368;3157155;1334085;4491240
2021.11_01-07-2022;Краснодарский край;165_195_days;AllVaccines;91717;82333;174050;3157155;1334085;4491240
2021.11_01-07-2022;Краснодарский край;165_195_days;CoviVac;3;0;3;3157155;1334085;4491240
2021.11_01-07-2022;Краснодарский край;165_195_days;EpiVacCorona;1291;1042;2333;3157155;1334085;4491240
2021.11_01-07-2022;Краснодарский край;165_195_days;SputnikLite;1;0;1;3157155;1334085;4491240
2021.11_01-07-2022;Краснодарский край;165_195_days;SputnikV;90422;81291;171713;3157155;1334085;4491240
2021.11_01-07-2022;Краснодарский край;21_45_days;AllVaccines;82556;57356;139912;3157155;1334085;4491240
2021.11_01-07-2022;Краснодарский край;21_45_days;CoviVac;1551;501;2052;3157155;1334085;4491240
2021.11_01-07-2022;Краснодарский край;21_45_days;EpiVacCorona;1594;874;2468;3157155;1334085;4491240
2021.11_01-07-2022;Краснодарский край;21_45_days;SputnikLite;20060;25724;45784;3157155;1334085;4491240
2021.11_01-07-2022;Краснодарский край;21_45_days;SputnikV;59351;30257;89608;3157155;1334085;4491240
2021.11_01-07-2022;Краснодарский край;45_75_days;AllVaccines;174994;73378;248372;3157155;1334085;4491240
2021.11_01-07-2022;Краснодарский край;45_75_days;CoviVac;3057;829;3886;3157155;1334085;4491240
2021.11_01-07-2022;Краснодарский край;45_75_days;EpiVacCorona;3380;1512;4892;3157155;1334085;4491240
2021.11_01-07-2022;Краснодарский край;45_75_days;SputnikLite;15001;23270;38271;3157155;1334085;4491240
2021.11_01-07-2022;Краснодарский край;45_75_days;SputnikV;153556;47767;201323;3157155;1334085;4491240
2021.11_01-07-2022;Краснодарский край;75_90_days;AllVaccines;167509;35677;203186;3157155;1334085;4491240
2021.11_01-07-2022;Краснодарский край;75_90_days;CoviVac;1875;401;2276;3157155;1334085;4491240
2021.11_01-07-2022;Краснодарский край;75_90_days;EpiVacCorona;1179;404;1583;3157155;1334085;4491240
2021.11_01-07-2022;Краснодарский край;75_90_days;SputnikLite;5657;4487;10144;3157155;1334085;4491240
2021.11_01-07-2022;Краснодарский край;75_90_days;SputnikV;158798;30385;189183;3157155;1334085;4491240
2021.11_01-07-2022;Краснодарский край;90_105_days;AllVaccines;299489;47667;347156;3157155;1334085;4491240
2021.11_01-07-2022;Краснодарский край;90_105_days;CoviVac;1487;316;1803;3157155;1334085;4491240
2021.11_01-07-2022;Краснодарский край;90_105_days;EpiVacCorona;707;222;929;3157155;1334085;4491240
2021.11_01-07-2022;Краснодарский край;90_105_days;SputnikLite;3873;1784;5657;3157155;1334085;4491240
2021.11_01-07-2022;Краснодарский край;90_105_days;SputnikV;293422;45345;338767;3157155;1334085;4491240
2021.11_01-07-2022;Красноярский край;105_165_days;AllVaccines;170028;61231;231259;1637377;585822;2223199
2021.11_01-07-2022;Красноярский край;105_165_days;CoviVac;3530;348;3878;1637377;585822;2223199
2021.11_01-07-2022;Красноярский край;105_165_days;EpiVacCorona;7754;5093;12847;1637377;585822;2223199
2021.11_01-07-2022;Красноярский край;105_165_days;SputnikLite;50;5;55;1637377;585822;2223199
2021.11_01-07-2022;Красноярский край;105_165_days;SputnikV;158694;55785;214479;1637377;585822;2223199
2021.11_01-07-2022;Красноярский край;165_195_days;AllVaccines;49269;35496;84765;1637377;585822;2223199
2021.11_01-07-2022;Красноярский край;165_195_days;EpiVacCorona;1624;1504;3128;1637377;585822;2223199
2021.11_01-07-2022;Красноярский край;165_195_days;SputnikLite;4;1;5;1637377;585822;2223199
2021.11_01-07-2022;Красноярский край;165_195_days;SputnikV;47641;33991;81632;1637377;585822;2223199
2021.11_01-07-2022;Красноярский край;21_45_days;AllVaccines;52285;21824;74109;1637377;585822;2223199
2021.11_01-07-2022;Красноярский край;21_45_days;CoviVac;738;183;921;1637377;585822;2223199
2021.11_01-07-2022;Красноярский край;21_45_days;EpiVacCorona;323;169;492;1637377;585822;2223199
2021.11_01-07-2022;Красноярский край;21_45_days;SputnikLite;33192;14600;47792;1637377;585822;2223199
2021.11_01-07-2022;Красноярский край;21_45_days;SputnikV;18032;6872;24904;1637377;585822;2223199
2021.11_01-07-2022;Красноярский край;45_75_days;AllVaccines;116832;29644;146476;1637377;585822;2223199
2021.11_01-07-2022;Красноярский край;45_75_days;CoviVac;1573;178;1751;1637377;585822;2223199
2021.11_01-07-2022;Красноярский край;45_75_days;EpiVacCorona;2289;850;3139;1637377;585822;2223199
2021.11_01-07-2022;Красноярский край;45_75_days;SputnikLite;46953;12830;59783;1637377;585822;2223199
2021.11_01-07-2022;Красноярский край;45_75_days;SputnikV;66017;15786;81803;1637377;585822;2223199
2021.11_01-07-2022;Красноярский край;75_90_days;AllVaccines;107307;16710;124017;1637377;585822;2223199
2021.11_01-07-2022;Красноярский край;75_90_days;CoviVac;654;65;719;1637377;585822;2223199
2021.11_01-07-2022;Красноярский край;75_90_days;EpiVacCorona;4599;1385;5984;1637377;585822;2223199
2021.11_01-07-2022;Красноярский край;75_90_days;SputnikLite;35594;3252;38846;1637377;585822;2223199
2021.11_01-07-2022;Красноярский край;75_90_days;SputnikV;66460;12008;78468;1637377;585822;2223199
2021.11_01-07-2022;Красноярский край;90_105_days;AllVaccines;95335;18825;114160;1637377;585822;2223199
2021.11_01-07-2022;Красноярский край;90_105_days;CoviVac;1842;195;2037;1637377;585822;2223199
2021.11_01-07-2022;Красноярский край;90_105_days;EpiVacCorona;556;256;812;1637377;585822;2223199
2021.11_01-07-2022;Красноярский край;90_105_days;SputnikLite;27443;1554;28997;1637377;585822;2223199
2021.11_01-07-2022;Красноярский край;90_105_days;SputnikV;65494;16820;82314;1637377;585822;2223199
2021.11_01-07-2022;Курганская область;105_165_days;AllVaccines;61222;31410;92632;425081;217502;642583
2021.11_01-07-2022;Курганская область;105_165_days;CoviVac;222;46;268;425081;217502;642583
2021.11_01-07-2022;Курганская область;105_165_days;EpiVacCorona;7414;4842;12256;425081;217502;642583
2021.11_01-07-2022;Курганская область;105_165_days;SputnikLite;18;8;26;425081;217502;642583
2021.11_01-07-2022;Курганская область;105_165_days;SputnikV;53568;26514;80082;425081;217502;642583
2021.11_01-07-2022;Курганская область;165_195_days;AllVaccines;13389;16741;30130;425081;217502;642583
2021.11_01-07-2022;Курганская область;165_195_days;EpiVacCorona;2;0;2;425081;217502;642583
2021.11_01-07-2022;Курганская область;165_195_days;SputnikLite;0;1;1;425081;217502;642583
2021.11_01-07-2022;Курганская область;165_195_days;SputnikV;13387;16740;30127;425081;217502;642583
2021.11_01-07-2022;Курганская область;21_45_days;AllVaccines;27003;11312;38315;425081;217502;642583
2021.11_01-07-2022;Курганская область;21_45_days;CoviVac;107;39;146;425081;217502;642583
2021.11_01-07-2022;Курганская область;21_45_days;EpiVacCorona;28;25;53;425081;217502;642583
2021.11_01-07-2022;Курганская область;21_45_days;SputnikLite;19764;9140;28904;425081;217502;642583
2021.11_01-07-2022;Курганская область;21_45_days;SputnikV;7104;2108;9212;425081;217502;642583
2021.11_01-07-2022;Курганская область;45_75_days;AllVaccines;17020;10323;27343;425081;217502;642583
2021.11_01-07-2022;Курганская область;45_75_days;CoviVac;122;28;150;425081;217502;642583
2021.11_01-07-2022;Курганская область;45_75_days;EpiVacCorona;57;43;100;425081;217502;642583
2021.11_01-07-2022;Курганская область;45_75_days;SputnikLite;5013;6041;11054;425081;217502;642583
2021.11_01-07-2022;Курганская область;45_75_days;SputnikV;11828;4211;16039;425081;217502;642583
2021.11_01-07-2022;Курганская область;75_90_days;AllVaccines;16775;5888;22663;425081;217502;642583
2021.11_01-07-2022;Курганская область;75_90_days;CoviVac;157;25;182;425081;217502;642583
2021.11_01-07-2022;Курганская область;75_90_days;EpiVacCorona;37;17;54;425081;217502;642583
2021.11_01-07-2022;Курганская область;75_90_days;SputnikLite;2769;1895;4664;425081;217502;642583
2021.11_01-07-2022;Курганская область;75_90_days;SputnikV;13812;3951;17763;425081;217502;642583
2021.11_01-07-2022;Курганская область;90_105_days;AllVaccines;21202;7752;28954;425081;217502;642583
2021.11_01-07-2022;Курганская область;90_105_days;CoviVac;225;64;289;425081;217502;642583
2021.11_01-07-2022;Курганская область;90_105_days;EpiVacCorona;81;38;119;425081;217502;642583
2021.11_01-07-2022;Курганская область;90_105_days;SputnikLite;2335;1125;3460;425081;217502;642583
2021.11_01-07-2022;Курганская область;90_105_days;SputnikV;18561;6525;25086;425081;217502;642583
2021.11_01-07-2022;Курская область;105_165_days;AllVaccines;82908;24395;107303;604409;285634;890043
2021.11_01-07-2022;Курская область;105_165_days;CoviVac;1505;275;1780;604409;285634;890043
2021.11_01-07-2022;Курская область;105_165_days;EpiVacCorona;2279;1230;3509;604409;285634;890043
2021.11_01-07-2022;Курская область;105_165_days;SputnikLite;41;14;55;604409;285634;890043
2021.11_01-07-2022;Курская область;105_165_days;SputnikV;79083;22876;101959;604409;285634;890043
2021.11_01-07-2022;Курская область;165_195_days;AllVaccines;15419;13612;29031;604409;285634;890043
2021.11_01-07-2022;Курская область;165_195_days;EpiVacCorona;288;220;508;604409;285634;890043
2021.11_01-07-2022;Курская область;165_195_days;SputnikLite;1;1;2;604409;285634;890043
2021.11_01-07-2022;Курская область;165_195_days;SputnikV;15130;13391;28521;604409;285634;890043
2021.11_01-07-2022;Курская область;21_45_days;AllVaccines;23192;15145;38337;604409;285634;890043
2021.11_01-07-2022;Курская область;21_45_days;CoviVac;102;11;113;604409;285634;890043
2021.11_01-07-2022;Курская область;21_45_days;EpiVacCorona;97;63;160;604409;285634;890043
2021.11_01-07-2022;Курская область;21_45_days;SputnikLite;17056;11699;28755;604409;285634;890043
2021.11_01-07-2022;Курская область;21_45_days;SputnikV;5937;3372;9309;604409;285634;890043
2021.11_01-07-2022;Курская область;45_75_days;AllVaccines;42896;16963;59859;604409;285634;890043
2021.11_01-07-2022;Курская область;45_75_days;CoviVac;576;89;665;604409;285634;890043
2021.11_01-07-2022;Курская область;45_75_days;EpiVacCorona;139;55;194;604409;285634;890043
2021.11_01-07-2022;Курская область;45_75_days;SputnikLite;15750;9730;25480;604409;285634;890043
2021.11_01-07-2022;Курская область;45_75_days;SputnikV;26431;7089;33520;604409;285634;890043
2021.11_01-07-2022;Курская область;75_90_days;AllVaccines;40600;8323;48923;604409;285634;890043
2021.11_01-07-2022;Курская область;75_90_days;CoviVac;191;22;213;604409;285634;890043
2021.11_01-07-2022;Курская область;75_90_days;EpiVacCorona;631;216;847;604409;285634;890043
2021.11_01-07-2022;Курская область;75_90_days;SputnikLite;7111;2264;9375;604409;285634;890043
2021.11_01-07-2022;Курская область;75_90_days;SputnikV;32667;5821;38488;604409;285634;890043
2021.11_01-07-2022;Курская область;90_105_days;AllVaccines;43623;7948;51571;604409;285634;890043
2021.11_01-07-2022;Курская область;90_105_days;CoviVac;458;42;500;604409;285634;890043
2021.11_01-07-2022;Курская область;90_105_days;EpiVacCorona;398;153;551;604409;285634;890043
2021.11_01-07-2022;Курская область;90_105_days;SputnikLite;3040;539;3579;604409;285634;890043
2021.11_01-07-2022;Курская область;90_105_days;SputnikV;39727;7214;46941;604409;285634;890043
2021.11_01-07-2022;Ленинградская область;105_165_days;AllVaccines;118308;46565;164873;1100343;462742;1563085
2021.11_01-07-2022;Ленинградская область;105_165_days;CoviVac;2200;325;2525;1100343;462742;1563085
2021.11_01-07-2022;Ленинградская область;105_165_days;EpiVacCorona;7036;3561;10597;1100343;462742;1563085
2021.11_01-07-2022;Ленинградская область;105_165_days;SputnikLite;373;63;436;1100343;462742;1563085
2021.11_01-07-2022;Ленинградская область;105_165_days;SputnikV;108699;42616;151315;1100343;462742;1563085
2021.11_01-07-2022;Ленинградская область;165_195_days;AllVaccines;24373;30174;54547;1100343;462742;1563085
2021.11_01-07-2022;Ленинградская область;165_195_days;CoviVac;768;166;934;1100343;462742;1563085
2021.11_01-07-2022;Ленинградская область;165_195_days;EpiVacCorona;1127;1534;2661;1100343;462742;1563085
2021.11_01-07-2022;Ленинградская область;165_195_days;SputnikV;22478;28474;50952;1100343;462742;1563085
2021.11_01-07-2022;Ленинградская область;21_45_days;AllVaccines;41404;19446;60850;1100343;462742;1563085
2021.11_01-07-2022;Ленинградская область;21_45_days;CoviVac;741;155;896;1100343;462742;1563085
2021.11_01-07-2022;Ленинградская область;21_45_days;EpiVacCorona;87;22;109;1100343;462742;1563085
2021.11_01-07-2022;Ленинградская область;21_45_days;SputnikLite;26149;12961;39110;1100343;462742;1563085
2021.11_01-07-2022;Ленинградская область;21_45_days;SputnikV;14427;6308;20735;1100343;462742;1563085
2021.11_01-07-2022;Ленинградская область;45_75_days;AllVaccines;50749;19212;69961;1100343;462742;1563085
2021.11_01-07-2022;Ленинградская область;45_75_days;CoviVac;1366;120;1486;1100343;462742;1563085
2021.11_01-07-2022;Ленинградская область;45_75_days;EpiVacCorona;89;59;148;1100343;462742;1563085
2021.11_01-07-2022;Ленинградская область;45_75_days;SputnikLite;14162;7055;21217;1100343;462742;1563085
2021.11_01-07-2022;Ленинградская область;45_75_days;SputnikV;35132;11978;47110;1100343;462742;1563085
2021.11_01-07-2022;Ленинградская область;75_90_days;AllVaccines;53651;12252;65903;1100343;462742;1563085
2021.11_01-07-2022;Ленинградская область;75_90_days;CoviVac;1262;118;1380;1100343;462742;1563085
2021.11_01-07-2022;Ленинградская область;75_90_days;EpiVacCorona;225;112;337;1100343;462742;1563085
2021.11_01-07-2022;Ленинградская область;75_90_days;SputnikLite;11738;1918;13656;1100343;462742;1563085
2021.11_01-07-2022;Ленинградская область;75_90_days;SputnikV;40426;10104;50530;1100343;462742;1563085
2021.11_01-07-2022;Ленинградская область;90_105_days;AllVaccines;66147;15375;81522;1100343;462742;1563085
2021.11_01-07-2022;Ленинградская область;90_105_days;CoviVac;1615;135;1750;1100343;462742;1563085
2021.11_01-07-2022;Ленинградская область;90_105_days;EpiVacCorona;951;265;1216;1100343;462742;1563085
2021.11_01-07-2022;Ленинградская область;90_105_days;SputnikLite;7458;858;8316;1100343;462742;1563085
2021.11_01-07-2022;Ленинградская область;90_105_days;SputnikV;56123;14117;70240;1100343;462742;1563085
2021.11_01-07-2022;Липецкая область;105_165_days;AllVaccines;106888;26939;133827;621641;290878;912519
2021.11_01-07-2022;Липецкая область;105_165_days;CoviVac;3399;313;3712;621641;290878;912519
2021.11_01-07-2022;Липецкая область;105_165_days;EpiVacCorona;1035;1018;2053;621641;290878;912519
2021.11_01-07-2022;Липецкая область;105_165_days;SputnikLite;114;20;134;621641;290878;912519
2021.11_01-07-2022;Липецкая область;105_165_days;SputnikV;102340;25588;127928;621641;290878;912519
2021.11_01-07-2022;Липецкая область;165_195_days;AllVaccines;17723;14872;32595;621641;290878;912519
2021.11_01-07-2022;Липецкая область;165_195_days;EpiVacCorona;104;163;267;621641;290878;912519
2021.11_01-07-2022;Липецкая область;165_195_days;SputnikV;17619;14709;32328;621641;290878;912519
2021.11_01-07-2022;Липецкая область;21_45_days;AllVaccines;24784;13471;38255;621641;290878;912519
2021.11_01-07-2022;Липецкая область;21_45_days;CoviVac;540;60;600;621641;290878;912519
2021.11_01-07-2022;Липецкая область;21_45_days;EpiVacCorona;130;55;185;621641;290878;912519
2021.11_01-07-2022;Липецкая область;21_45_days;SputnikLite;14267;9804;24071;621641;290878;912519
2021.11_01-07-2022;Липецкая область;21_45_days;SputnikV;9847;3552;13399;621641;290878;912519
2021.11_01-07-2022;Липецкая область;45_75_days;AllVaccines;29542;13156;42698;621641;290878;912519
2021.11_01-07-2022;Липецкая область;45_75_days;CoviVac;647;41;688;621641;290878;912519
2021.11_01-07-2022;Липецкая область;45_75_days;EpiVacCorona;293;170;463;621641;290878;912519
2021.11_01-07-2022;Липецкая область;45_75_days;SputnikLite;6494;7287;13781;621641;290878;912519
2021.11_01-07-2022;Липецкая область;45_75_days;SputnikV;22108;5658;27766;621641;290878;912519
2021.11_01-07-2022;Липецкая область;75_90_days;AllVaccines;31989;5819;37808;621641;290878;912519
2021.11_01-07-2022;Липецкая область;75_90_days;CoviVac;287;14;301;621641;290878;912519
2021.11_01-07-2022;Липецкая область;75_90_days;EpiVacCorona;497;193;690;621641;290878;912519
2021.11_01-07-2022;Липецкая область;75_90_days;SputnikLite;3174;1604;4778;621641;290878;912519
2021.11_01-07-2022;Липецкая область;75_90_days;SputnikV;28031;4008;32039;621641;290878;912519
2021.11_01-07-2022;Липецкая область;90_105_days;AllVaccines;47162;6924;54086;621641;290878;912519
2021.11_01-07-2022;Липецкая область;90_105_days;CoviVac;1063;36;1099;621641;290878;912519
2021.11_01-07-2022;Липецкая область;90_105_days;EpiVacCorona;110;58;168;621641;290878;912519
2021.11_01-07-2022;Липецкая область;90_105_days;SputnikLite;1725;135;1860;621641;290878;912519
2021.11_01-07-2022;Липецкая область;90_105_days;SputnikV;44264;6695;50959;621641;290878;912519
2021.11_01-07-2022;Магаданская область;105_165_days;AllVaccines;10938;2713;13651;83196;26810;110006
2021.11_01-07-2022;Магаданская область;105_165_days;CoviVac;751;256;1007;83196;26810;110006
2021.11_01-07-2022;Магаданская область;105_165_days;SputnikLite;66;1;67;83196;26810;110006
2021.11_01-07-2022;Магаданская область;105_165_days;SputnikV;10121;2456;12577;83196;26810;110006
2021.11_01-07-2022;Магаданская область;165_195_days;AllVaccines;5670;1925;7595;83196;26810;110006
2021.11_01-07-2022;Магаданская область;165_195_days;SputnikLite;1;0;1;83196;26810;110006
2021.11_01-07-2022;Магаданская область;165_195_days;SputnikV;5669;1925;7594;83196;26810;110006
2021.11_01-07-2022;Магаданская область;21_45_days;AllVaccines;3237;979;4216;83196;26810;110006
2021.11_01-07-2022;Магаданская область;21_45_days;CoviVac;26;2;28;83196;26810;110006
2021.11_01-07-2022;Магаданская область;21_45_days;EpiVacCorona;0;1;1;83196;26810;110006
2021.11_01-07-2022;Магаданская область;21_45_days;SputnikLite;2489;781;3270;83196;26810;110006
2021.11_01-07-2022;Магаданская область;21_45_days;SputnikV;722;195;917;83196;26810;110006
2021.11_01-07-2022;Магаданская область;45_75_days;AllVaccines;5023;1240;6263;83196;26810;110006
2021.11_01-07-2022;Магаданская область;45_75_days;CoviVac;29;3;32;83196;26810;110006
2021.11_01-07-2022;Магаданская область;45_75_days;EpiVacCorona;1;0;1;83196;26810;110006
2021.11_01-07-2022;Магаданская область;45_75_days;SputnikLite;2343;650;2993;83196;26810;110006
2021.11_01-07-2022;Магаданская область;45_75_days;SputnikV;2650;587;3237;83196;26810;110006
2021.11_01-07-2022;Магаданская область;75_90_days;AllVaccines;4522;672;5194;83196;26810;110006
2021.11_01-07-2022;Магаданская область;75_90_days;CoviVac;52;8;60;83196;26810;110006
2021.11_01-07-2022;Магаданская область;75_90_days;EpiVacCorona;1;0;1;83196;26810;110006
2021.11_01-07-2022;Магаданская область;75_90_days;SputnikLite;1827;192;2019;83196;26810;110006
2021.11_01-07-2022;Магаданская область;75_90_days;SputnikV;2642;472;3114;83196;26810;110006
2021.11_01-07-2022;Магаданская область;90_105_days;AllVaccines;4208;626;4834;83196;26810;110006
2021.11_01-07-2022;Магаданская область;90_105_days;CoviVac;91;23;114;83196;26810;110006
2021.11_01-07-2022;Магаданская область;90_105_days;SputnikLite;1060;81;1141;83196;26810;110006
2021.11_01-07-2022;Магаданская область;90_105_days;SputnikV;3057;522;3579;83196;26810;110006
2021.11_01-07-2022;Московская область;105_165_days;AllVaccines;1206241;216395;1422636;4485323;1674471;6159794
2021.11_01-07-2022;Московская область;105_165_days;CoviVac;18139;4192;22331;4485323;1674471;6159794
2021.11_01-07-2022;Московская область;105_165_days;EpiVacCorona;23988;11672;35660;4485323;1674471;6159794
2021.11_01-07-2022;Московская область;105_165_days;SputnikLite;2435;209;2644;4485323;1674471;6159794
2021.11_01-07-2022;Московская область;105_165_days;SputnikV;1161679;200322;1362001;4485323;1674471;6159794
2021.11_01-07-2022;Московская область;165_195_days;AllVaccines;163609;94271;257880;4485323;1674471;6159794
2021.11_01-07-2022;Московская область;165_195_days;CoviVac;3330;1436;4766;4485323;1674471;6159794
2021.11_01-07-2022;Московская область;165_195_days;EpiVacCorona;2422;2754;5176;4485323;1674471;6159794
2021.11_01-07-2022;Московская область;165_195_days;SputnikLite;9;2;11;4485323;1674471;6159794
2021.11_01-07-2022;Московская область;165_195_days;SputnikV;157848;90079;247927;4485323;1674471;6159794
2021.11_01-07-2022;Московская область;21_45_days;AllVaccines;131300;70942;202242;4485323;1674471;6159794
2021.11_01-07-2022;Московская область;21_45_days;CoviVac;2188;810;2998;4485323;1674471;6159794
2021.11_01-07-2022;Московская область;21_45_days;EpiVacCorona;1075;732;1807;4485323;1674471;6159794
2021.11_01-07-2022;Московская область;21_45_days;SputnikLite;44179;46009;90188;4485323;1674471;6159794
2021.11_01-07-2022;Московская область;21_45_days;SputnikV;83858;23391;107249;4485323;1674471;6159794
2021.11_01-07-2022;Московская область;45_75_days;AllVaccines;211857;71600;283457;4485323;1674471;6159794
2021.11_01-07-2022;Московская область;45_75_days;CoviVac;3462;1022;4484;4485323;1674471;6159794
2021.11_01-07-2022;Московская область;45_75_days;EpiVacCorona;2769;1609;4378;4485323;1674471;6159794
2021.11_01-07-2022;Московская область;45_75_days;SputnikLite;28719;26103;54822;4485323;1674471;6159794
2021.11_01-07-2022;Московская область;45_75_days;SputnikV;176907;42866;219773;4485323;1674471;6159794
2021.11_01-07-2022;Московская область;75_90_days;AllVaccines;228828;50802;279630;4485323;1674471;6159794
2021.11_01-07-2022;Московская область;75_90_days;CoviVac;4344;1037;5381;4485323;1674471;6159794
2021.11_01-07-2022;Московская область;75_90_days;EpiVacCorona;2604;1226;3830;4485323;1674471;6159794
2021.11_01-07-2022;Московская область;75_90_days;SputnikLite;12088;6217;18305;4485323;1674471;6159794
2021.11_01-07-2022;Московская область;75_90_days;SputnikV;209792;42322;252114;4485323;1674471;6159794
2021.11_01-07-2022;Московская область;90_105_days;AllVaccines;472059;69808;541867;4485323;1674471;6159794
2021.11_01-07-2022;Московская область;90_105_days;CoviVac;3081;625;3706;4485323;1674471;6159794
2021.11_01-07-2022;Московская область;90_105_days;EpiVacCorona;1017;404;1421;4485323;1674471;6159794
2021.11_01-07-2022;Московская область;90_105_days;SputnikLite;6159;2319;8478;4485323;1674471;6159794
2021.11_01-07-2022;Московская область;90_105_days;SputnikV;461802;66460;528262;4485323;1674471;6159794
2021.11_01-07-2022;Мурманская область;105_165_days;AllVaccines;51825;13268;65093;436555;144366;580921
2021.11_01-07-2022;Мурманская область;105_165_days;CoviVac;775;161;936;436555;144366;580921
2021.11_01-07-2022;Мурманская область;105_165_days;EpiVacCorona;353;246;599;436555;144366;580921
2021.11_01-07-2022;Мурманская область;105_165_days;SputnikLite;39;6;45;436555;144366;580921
2021.11_01-07-2022;Мурманская область;105_165_days;SputnikV;50658;12855;63513;436555;144366;580921
2021.11_01-07-2022;Мурманская область;165_195_days;AllVaccines;19107;10704;29811;436555;144366;580921
2021.11_01-07-2022;Мурманская область;165_195_days;EpiVacCorona;172;110;282;436555;144366;580921
2021.11_01-07-2022;Мурманская область;165_195_days;SputnikV;18935;10594;29529;436555;144366;580921
2021.11_01-07-2022;Мурманская область;21_45_days;AllVaccines;16926;5839;22765;436555;144366;580921
2021.11_01-07-2022;Мурманская область;21_45_days;CoviVac;60;7;67;436555;144366;580921
2021.11_01-07-2022;Мурманская область;21_45_days;EpiVacCorona;100;40;140;436555;144366;580921
2021.11_01-07-2022;Мурманская область;21_45_days;SputnikLite;8561;4041;12602;436555;144366;580921
2021.11_01-07-2022;Мурманская область;21_45_days;SputnikV;8205;1751;9956;436555;144366;580921
2021.11_01-07-2022;Мурманская область;45_75_days;AllVaccines;32051;6179;38230;436555;144366;580921
2021.11_01-07-2022;Мурманская область;45_75_days;CoviVac;103;12;115;436555;144366;580921
2021.11_01-07-2022;Мурманская область;45_75_days;EpiVacCorona;335;76;411;436555;144366;580921
2021.11_01-07-2022;Мурманская область;45_75_days;SputnikLite;15372;2998;18370;436555;144366;580921
2021.11_01-07-2022;Мурманская область;45_75_days;SputnikV;16241;3093;19334;436555;144366;580921
2021.11_01-07-2022;Мурманская область;75_90_days;AllVaccines;32626;3993;36619;436555;144366;580921
2021.11_01-07-2022;Мурманская область;75_90_days;CoviVac;301;16;317;436555;144366;580921
2021.11_01-07-2022;Мурманская область;75_90_days;EpiVacCorona;214;48;262;436555;144366;580921
2021.11_01-07-2022;Мурманская область;75_90_days;SputnikLite;13258;957;14215;436555;144366;580921
2021.11_01-07-2022;Мурманская область;75_90_days;SputnikV;18853;2972;21825;436555;144366;580921
2021.11_01-07-2022;Мурманская область;90_105_days;AllVaccines;23958;3926;27884;436555;144366;580921
2021.11_01-07-2022;Мурманская область;90_105_days;CoviVac;375;54;429;436555;144366;580921
2021.11_01-07-2022;Мурманская область;90_105_days;EpiVacCorona;96;21;117;436555;144366;580921
2021.11_01-07-2022;Мурманская область;90_105_days;SputnikLite;4679;340;5019;436555;144366;580921
2021.11_01-07-2022;Мурманская область;90_105_days;SputnikV;18808;3511;22319;436555;144366;580921
2021.11_01-07-2022;Ненецкий автономный округ;105_165_days;AllVaccines;3962;993;4955;24931;7449;32380
2021.11_01-07-2022;Ненецкий автономный округ;105_165_days;CoviVac;402;59;461;24931;7449;32380
2021.11_01-07-2022;Ненецкий автономный округ;105_165_days;EpiVacCorona;2852;676;3528;24931;7449;32380
2021.11_01-07-2022;Ненецкий автономный округ;105_165_days;SputnikLite;20;11;31;24931;7449;32380
2021.11_01-07-2022;Ненецкий автономный округ;105_165_days;SputnikV;688;247;935;24931;7449;32380
2021.11_01-07-2022;Ненецкий автономный округ;165_195_days;AllVaccines;1919;658;2577;24931;7449;32380
2021.11_01-07-2022;Ненецкий автономный округ;165_195_days;EpiVacCorona;1211;144;1355;24931;7449;32380
2021.11_01-07-2022;Ненецкий автономный округ;165_195_days;SputnikV;708;514;1222;24931;7449;32380
2021.11_01-07-2022;Ненецкий автономный округ;21_45_days;AllVaccines;744;388;1132;24931;7449;32380
2021.11_01-07-2022;Ненецкий автономный округ;21_45_days;CoviVac;32;0;32;24931;7449;32380
2021.11_01-07-2022;Ненецкий автономный округ;21_45_days;EpiVacCorona;10;1;11;24931;7449;32380
2021.11_01-07-2022;Ненецкий автономный округ;21_45_days;SputnikLite;666;381;1047;24931;7449;32380
2021.11_01-07-2022;Ненецкий автономный округ;21_45_days;SputnikV;36;6;42;24931;7449;32380
2021.11_01-07-2022;Ненецкий автономный округ;45_75_days;AllVaccines;694;290;984;24931;7449;32380
2021.11_01-07-2022;Ненецкий автономный округ;45_75_days;CoviVac;36;5;41;24931;7449;32380
2021.11_01-07-2022;Ненецкий автономный округ;45_75_days;EpiVacCorona;0;2;2;24931;7449;32380
2021.11_01-07-2022;Ненецкий автономный округ;45_75_days;SputnikLite;485;247;732;24931;7449;32380
2021.11_01-07-2022;Ненецкий автономный округ;45_75_days;SputnikV;173;36;209;24931;7449;32380
2021.11_01-07-2022;Ненецкий автономный округ;75_90_days;AllVaccines;714;105;819;24931;7449;32380
2021.11_01-07-2022;Ненецкий автономный округ;75_90_days;CoviVac;54;8;62;24931;7449;32380
2021.11_01-07-2022;Ненецкий автономный округ;75_90_days;EpiVacCorona;211;23;234;24931;7449;32380
2021.11_01-07-2022;Ненецкий автономный округ;75_90_days;SputnikLite;309;57;366;24931;7449;32380
2021.11_01-07-2022;Ненецкий автономный округ;75_90_days;SputnikV;140;17;157;24931;7449;32380
2021.11_01-07-2022;Ненецкий автономный округ;90_105_days;AllVaccines;945;221;1166;24931;7449;32380
2021.11_01-07-2022;Ненецкий автономный округ;90_105_days;CoviVac;36;9;45;24931;7449;32380
2021.11_01-07-2022;Ненецкий автономный округ;90_105_days;EpiVacCorona;492;82;574;24931;7449;32380
2021.11_01-07-2022;Ненецкий автономный округ;90_105_days;SputnikLite;161;72;233;24931;7449;32380
2021.11_01-07-2022;Ненецкий автономный округ;90_105_days;SputnikV;256;58;314;24931;7449;32380
2021.11_01-07-2022;Нижегородская область;105_165_days;AllVaccines;248082;72987;321069;1769909;800663;2570572
2021.11_01-07-2022;Нижегородская область;105_165_days;CoviVac;12909;1751;14660;1769909;800663;2570572
2021.11_01-07-2022;Нижегородская область;105_165_days;EpiVacCorona;5862;3288;9150;1769909;800663;2570572
2021.11_01-07-2022;Нижегородская область;105_165_days;SputnikLite;9158;717;9875;1769909;800663;2570572
2021.11_01-07-2022;Нижегородская область;105_165_days;SputnikV;220153;67231;287384;1769909;800663;2570572
2021.11_01-07-2022;Нижегородская область;165_195_days;AllVaccines;48300;57264;105564;1769909;800663;2570572
2021.11_01-07-2022;Нижегородская область;165_195_days;CoviVac;180;79;259;1769909;800663;2570572
2021.11_01-07-2022;Нижегородская область;165_195_days;EpiVacCorona;1625;2179;3804;1769909;800663;2570572
2021.11_01-07-2022;Нижегородская область;165_195_days;SputnikLite;3;1;4;1769909;800663;2570572
2021.11_01-07-2022;Нижегородская область;165_195_days;SputnikV;46492;55005;101497;1769909;800663;2570572
2021.11_01-07-2022;Нижегородская область;21_45_days;AllVaccines;80279;37101;117380;1769909;800663;2570572
2021.11_01-07-2022;Нижегородская область;21_45_days;CoviVac;1068;243;1311;1769909;800663;2570572
2021.11_01-07-2022;Нижегородская область;21_45_days;EpiVacCorona;377;310;687;1769909;800663;2570572
2021.11_01-07-2022;Нижегородская область;21_45_days;SputnikLite;61258;27438;88696;1769909;800663;2570572
2021.11_01-07-2022;Нижегородская область;21_45_days;SputnikV;17576;9110;26686;1769909;800663;2570572
2021.11_01-07-2022;Нижегородская область;45_75_days;AllVaccines;76545;35515;112060;1769909;800663;2570572
2021.11_01-07-2022;Нижегородская область;45_75_days;CoviVac;2580;418;2998;1769909;800663;2570572
2021.11_01-07-2022;Нижегородская область;45_75_days;EpiVacCorona;1258;816;2074;1769909;800663;2570572
2021.11_01-07-2022;Нижегородская область;45_75_days;SputnikLite;27163;16097;43260;1769909;800663;2570572
2021.11_01-07-2022;Нижегородская область;45_75_days;SputnikV;45544;18184;63728;1769909;800663;2570572
2021.11_01-07-2022;Нижегородская область;75_90_days;AllVaccines;82265;16971;99236;1769909;800663;2570572
2021.11_01-07-2022;Нижегородская область;75_90_days;CoviVac;895;106;1001;1769909;800663;2570572
2021.11_01-07-2022;Нижегородская область;75_90_days;EpiVacCorona;3479;1349;4828;1769909;800663;2570572
2021.11_01-07-2022;Нижегородская область;75_90_days;SputnikLite;29849;4694;34543;1769909;800663;2570572
2021.11_01-07-2022;Нижегородская область;75_90_days;SputnikV;48042;10822;58864;1769909;800663;2570572
2021.11_01-07-2022;Нижегородская область;90_105_days;AllVaccines;128208;17423;145631;1769909;800663;2570572
2021.11_01-07-2022;Нижегородская область;90_105_days;CoviVac;2457;258;2715;1769909;800663;2570572
2021.11_01-07-2022;Нижегородская область;90_105_days;EpiVacCorona;3072;747;3819;1769909;800663;2570572
2021.11_01-07-2022;Нижегородская область;90_105_days;SputnikLite;35912;3432;39344;1769909;800663;2570572
2021.11_01-07-2022;Нижегородская область;90_105_days;SputnikV;86767;12986;99753;1769909;800663;2570572
2021.11_01-07-2022;Новгородская область;105_165_days;AllVaccines;32530;16236;48766;317276;158308;475584
2021.11_01-07-2022;Новгородская область;105_165_days;CoviVac;894;184;1078;317276;158308;475584
2021.11_01-07-2022;Новгородская область;105_165_days;EpiVacCorona;153;99;252;317276;158308;475584
2021.11_01-07-2022;Новгородская область;105_165_days;SputnikLite;584;48;632;317276;158308;475584
2021.11_01-07-2022;Новгородская область;105_165_days;SputnikV;30899;15905;46804;317276;158308;475584
2021.11_01-07-2022;Новгородская область;165_195_days;AllVaccines;8375;11826;20201;317276;158308;475584
2021.11_01-07-2022;Новгородская область;165_195_days;EpiVacCorona;351;143;494;317276;158308;475584
2021.11_01-07-2022;Новгородская область;165_195_days;SputnikLite;1;0;1;317276;158308;475584
2021.11_01-07-2022;Новгородская область;165_195_days;SputnikV;8023;11683;19706;317276;158308;475584
2021.11_01-07-2022;Новгородская область;21_45_days;AllVaccines;14883;6959;21842;317276;158308;475584
2021.11_01-07-2022;Новгородская область;21_45_days;CoviVac;12;2;14;317276;158308;475584
2021.11_01-07-2022;Новгородская область;21_45_days;EpiVacCorona;36;33;69;317276;158308;475584
2021.11_01-07-2022;Новгородская область;21_45_days;SputnikLite;13243;5946;19189;317276;158308;475584
2021.11_01-07-2022;Новгородская область;21_45_days;SputnikV;1592;978;2570;317276;158308;475584
2021.11_01-07-2022;Новгородская область;45_75_days;AllVaccines;14926;7378;22304;317276;158308;475584
2021.11_01-07-2022;Новгородская область;45_75_days;CoviVac;36;15;51;317276;158308;475584
2021.11_01-07-2022;Новгородская область;45_75_days;EpiVacCorona;84;37;121;317276;158308;475584
2021.11_01-07-2022;Новгородская область;45_75_days;SputnikLite;9611;4801;14412;317276;158308;475584
2021.11_01-07-2022;Новгородская область;45_75_days;SputnikV;5195;2525;7720;317276;158308;475584
2021.11_01-07-2022;Новгородская область;75_90_days;AllVaccines;16002;3684;19686;317276;158308;475584
2021.11_01-07-2022;Новгородская область;75_90_days;CoviVac;45;13;58;317276;158308;475584
2021.11_01-07-2022;Новгородская область;75_90_days;EpiVacCorona;259;86;345;317276;158308;475584
2021.11_01-07-2022;Новгородская область;75_90_days;SputnikLite;7268;977;8245;317276;158308;475584
2021.11_01-07-2022;Новгородская область;75_90_days;SputnikV;8430;2608;11038;317276;158308;475584
2021.11_01-07-2022;Новгородская область;90_105_days;AllVaccines;20214;4320;24534;317276;158308;475584
2021.11_01-07-2022;Новгородская область;90_105_days;CoviVac;248;40;288;317276;158308;475584
2021.11_01-07-2022;Новгородская область;90_105_days;EpiVacCorona;55;3;58;317276;158308;475584
2021.11_01-07-2022;Новгородская область;90_105_days;SputnikLite;6508;517;7025;317276;158308;475584
2021.11_01-07-2022;Новгородская область;90_105_days;SputnikV;13403;3760;17163;317276;158308;475584
2021.11_01-07-2022;Новосибирская область;105_165_days;AllVaccines;176175;78979;255154;1571829;624100;2195929
2021.11_01-07-2022;Новосибирская область;105_165_days;CoviVac;7096;1179;8275;1571829;624100;2195929
2021.11_01-07-2022;Новосибирская область;105_165_days;EpiVacCorona;13746;10783;24529;1571829;624100;2195929
2021.11_01-07-2022;Новосибирская область;105_165_days;SputnikLite;4106;283;4389;1571829;624100;2195929
2021.11_01-07-2022;Новосибирская область;105_165_days;SputnikV;151227;66734;217961;1571829;624100;2195929
2021.11_01-07-2022;Новосибирская область;165_195_days;AllVaccines;52784;55762;108546;1571829;624100;2195929
2021.11_01-07-2022;Новосибирская область;165_195_days;CoviVac;2;0;2;1571829;624100;2195929
2021.11_01-07-2022;Новосибирская область;165_195_days;EpiVacCorona;9310;10309;19619;1571829;624100;2195929
2021.11_01-07-2022;Новосибирская область;165_195_days;SputnikLite;11;0;11;1571829;624100;2195929
2021.11_01-07-2022;Новосибирская область;165_195_days;SputnikV;43461;45453;88914;1571829;624100;2195929
2021.11_01-07-2022;Новосибирская область;21_45_days;AllVaccines;53046;23884;76930;1571829;624100;2195929
2021.11_01-07-2022;Новосибирская область;21_45_days;CoviVac;1040;271;1311;1571829;624100;2195929
2021.11_01-07-2022;Новосибирская область;21_45_days;EpiVacCorona;470;309;779;1571829;624100;2195929
2021.11_01-07-2022;Новосибирская область;21_45_days;SputnikLite;37114;16721;53835;1571829;624100;2195929
2021.11_01-07-2022;Новосибирская область;21_45_days;SputnikV;14422;6583;21005;1571829;624100;2195929
2021.11_01-07-2022;Новосибирская область;45_75_days;AllVaccines;57459;24758;82217;1571829;624100;2195929
2021.11_01-07-2022;Новосибирская область;45_75_days;CoviVac;1531;261;1792;1571829;624100;2195929
2021.11_01-07-2022;Новосибирская область;45_75_days;EpiVacCorona;1377;872;2249;1571829;624100;2195929
2021.11_01-07-2022;Новосибирская область;45_75_days;SputnikLite;19669;11518;31187;1571829;624100;2195929
2021.11_01-07-2022;Новосибирская область;45_75_days;SputnikV;34882;12107;46989;1571829;624100;2195929
2021.11_01-07-2022;Новосибирская область;75_90_days;AllVaccines;45322;12139;57461;1571829;624100;2195929
2021.11_01-07-2022;Новосибирская область;75_90_days;CoviVac;389;62;451;1571829;624100;2195929
2021.11_01-07-2022;Новосибирская область;75_90_days;EpiVacCorona;2867;1538;4405;1571829;624100;2195929
2021.11_01-07-2022;Новосибирская область;75_90_days;SputnikLite;14808;2361;17169;1571829;624100;2195929
2021.11_01-07-2022;Новосибирская область;75_90_days;SputnikV;27258;8178;35436;1571829;624100;2195929
2021.11_01-07-2022;Новосибирская область;90_105_days;AllVaccines;54972;12693;67665;1571829;624100;2195929
2021.11_01-07-2022;Новосибирская область;90_105_days;CoviVac;1366;157;1523;1571829;624100;2195929
2021.11_01-07-2022;Новосибирская область;90_105_days;EpiVacCorona;1400;677;2077;1571829;624100;2195929
2021.11_01-07-2022;Новосибирская область;90_105_days;SputnikLite;13248;826;14074;1571829;624100;2195929
2021.11_01-07-2022;Новосибирская область;90_105_days;SputnikV;38958;11033;49991;1571829;624100;2195929
2021.11_01-07-2022;Омская область;105_165_days;AllVaccines;129723;41178;170901;1058291;431046;1489337
2021.11_01-07-2022;Омская область;105_165_days;CoviVac;2648;364;3012;1058291;431046;1489337
2021.11_01-07-2022;Омская область;105_165_days;EpiVacCorona;6316;2891;9207;1058291;431046;1489337
2021.11_01-07-2022;Омская область;105_165_days;SputnikLite;689;43;732;1058291;431046;1489337
2021.11_01-07-2022;Омская область;105_165_days;SputnikV;120070;37880;157950;1058291;431046;1489337
2021.11_01-07-2022;Омская область;165_195_days;AllVaccines;41165;30245;71410;1058291;431046;1489337
2021.11_01-07-2022;Омская область;165_195_days;EpiVacCorona;2216;1551;3767;1058291;431046;1489337
2021.11_01-07-2022;Омская область;165_195_days;SputnikLite;6;1;7;1058291;431046;1489337
2021.11_01-07-2022;Омская область;165_195_days;SputnikV;38943;28693;67636;1058291;431046;1489337
2021.11_01-07-2022;Омская область;21_45_days;AllVaccines;27475;13797;41272;1058291;431046;1489337
2021.11_01-07-2022;Омская область;21_45_days;CoviVac;342;94;436;1058291;431046;1489337
2021.11_01-07-2022;Омская область;21_45_days;EpiVacCorona;342;215;557;1058291;431046;1489337
2021.11_01-07-2022;Омская область;21_45_days;SputnikLite;15269;9550;24819;1058291;431046;1489337
2021.11_01-07-2022;Омская область;21_45_days;SputnikV;11522;3938;15460;1058291;431046;1489337
2021.11_01-07-2022;Омская область;45_75_days;AllVaccines;57256;16471;73727;1058291;431046;1489337
2021.11_01-07-2022;Омская область;45_75_days;CoviVac;735;175;910;1058291;431046;1489337
2021.11_01-07-2022;Омская область;45_75_days;EpiVacCorona;752;312;1064;1058291;431046;1489337
2021.11_01-07-2022;Омская область;45_75_days;SputnikLite;17173;6992;24165;1058291;431046;1489337
2021.11_01-07-2022;Омская область;45_75_days;SputnikV;38596;8992;47588;1058291;431046;1489337
2021.11_01-07-2022;Омская область;75_90_days;AllVaccines;66264;10328;76592;1058291;431046;1489337
2021.11_01-07-2022;Омская область;75_90_days;CoviVac;756;110;866;1058291;431046;1489337
2021.11_01-07-2022;Омская область;75_90_days;EpiVacCorona;1672;445;2117;1058291;431046;1489337
2021.11_01-07-2022;Омская область;75_90_days;SputnikLite;14654;1811;16465;1058291;431046;1489337
2021.11_01-07-2022;Омская область;75_90_days;SputnikV;49182;7962;57144;1058291;431046;1489337
2021.11_01-07-2022;Омская область;90_105_days;AllVaccines;84391;12220;96611;1058291;431046;1489337
2021.11_01-07-2022;Омская область;90_105_days;CoviVac;1315;180;1495;1058291;431046;1489337
2021.11_01-07-2022;Омская область;90_105_days;EpiVacCorona;1006;220;1226;1058291;431046;1489337
2021.11_01-07-2022;Омская область;90_105_days;SputnikLite;10054;715;10769;1058291;431046;1489337
2021.11_01-07-2022;Омская область;90_105_days;SputnikV;72016;11105;83121;1058291;431046;1489337
2021.11_01-07-2022;Оренбургская область;105_165_days;AllVaccines;148620;46000;194620;1068899;440686;1509585
2021.11_01-07-2022;Оренбургская область;105_165_days;CoviVac;993;221;1214;1068899;440686;1509585
2021.11_01-07-2022;Оренбургская область;105_165_days;EpiVacCorona;2067;1273;3340;1068899;440686;1509585
2021.11_01-07-2022;Оренбургская область;105_165_days;SputnikLite;28;3;31;1068899;440686;1509585
2021.11_01-07-2022;Оренбургская область;105_165_days;SputnikV;145532;44503;190035;1068899;440686;1509585
2021.11_01-07-2022;Оренбургская область;165_195_days;AllVaccines;41993;38047;80040;1068899;440686;1509585
2021.11_01-07-2022;Оренбургская область;165_195_days;CoviVac;1;0;1;1068899;440686;1509585
2021.11_01-07-2022;Оренбургская область;165_195_days;EpiVacCorona;1516;1478;2994;1068899;440686;1509585
2021.11_01-07-2022;Оренбургская область;165_195_days;SputnikV;40476;36569;77045;1068899;440686;1509585
2021.11_01-07-2022;Оренбургская область;21_45_days;AllVaccines;32801;19566;52367;1068899;440686;1509585
2021.11_01-07-2022;Оренбургская область;21_45_days;CoviVac;389;73;462;1068899;440686;1509585
2021.11_01-07-2022;Оренбургская область;21_45_days;EpiVacCorona;123;71;194;1068899;440686;1509585
2021.11_01-07-2022;Оренбургская область;21_45_days;SputnikLite;13932;13361;27293;1068899;440686;1509585
2021.11_01-07-2022;Оренбургская область;21_45_days;SputnikV;18357;6061;24418;1068899;440686;1509585
2021.11_01-07-2022;Оренбургская область;45_75_days;AllVaccines;53056;20558;73614;1068899;440686;1509585
2021.11_01-07-2022;Оренбургская область;45_75_days;CoviVac;785;128;913;1068899;440686;1509585
2021.11_01-07-2022;Оренбургская область;45_75_days;EpiVacCorona;802;207;1009;1068899;440686;1509585
2021.11_01-07-2022;Оренбургская область;45_75_days;SputnikLite;8255;9627;17882;1068899;440686;1509585
2021.11_01-07-2022;Оренбургская область;45_75_days;SputnikV;43214;10596;53810;1068899;440686;1509585
2021.11_01-07-2022;Оренбургская область;75_90_days;AllVaccines;49174;10526;59700;1068899;440686;1509585
2021.11_01-07-2022;Оренбургская область;75_90_days;CoviVac;168;15;183;1068899;440686;1509585
2021.11_01-07-2022;Оренбургская область;75_90_days;EpiVacCorona;1052;314;1366;1068899;440686;1509585
2021.11_01-07-2022;Оренбургская область;75_90_days;SputnikLite;2886;1906;4792;1068899;440686;1509585
2021.11_01-07-2022;Оренбургская область;75_90_days;SputnikV;45068;8291;53359;1068899;440686;1509585
2021.11_01-07-2022;Оренбургская область;90_105_days;AllVaccines;64085;12313;76398;1068899;440686;1509585
2021.11_01-07-2022;Оренбургская область;90_105_days;CoviVac;542;63;605;1068899;440686;1509585
2021.11_01-07-2022;Оренбургская область;90_105_days;EpiVacCorona;288;83;371;1068899;440686;1509585
2021.11_01-07-2022;Оренбургская область;90_105_days;SputnikLite;1927;184;2111;1068899;440686;1509585
2021.11_01-07-2022;Оренбургская область;90_105_days;SputnikV;61328;11983;73311;1068899;440686;1509585
2021.11_01-07-2022;Орловская область;105_165_days;AllVaccines;51885;17389;69274;398663;193123;591786
2021.11_01-07-2022;Орловская область;105_165_days;CoviVac;509;214;723;398663;193123;591786
2021.11_01-07-2022;Орловская область;105_165_days;EpiVacCorona;2776;1506;4282;398663;193123;591786
2021.11_01-07-2022;Орловская область;105_165_days;SputnikLite;200;40;240;398663;193123;591786
2021.11_01-07-2022;Орловская область;105_165_days;SputnikV;48400;15629;64029;398663;193123;591786
2021.11_01-07-2022;Орловская область;165_195_days;AllVaccines;10073;10621;20694;398663;193123;591786
2021.11_01-07-2022;Орловская область;165_195_days;EpiVacCorona;158;167;325;398663;193123;591786
2021.11_01-07-2022;Орловская область;165_195_days;SputnikLite;1;1;2;398663;193123;591786
2021.11_01-07-2022;Орловская область;165_195_days;SputnikV;9914;10453;20367;398663;193123;591786
2021.11_01-07-2022;Орловская область;21_45_days;AllVaccines;17075;9787;26862;398663;193123;591786
2021.11_01-07-2022;Орловская область;21_45_days;CoviVac;3;0;3;398663;193123;591786
2021.11_01-07-2022;Орловская область;21_45_days;EpiVacCorona;120;50;170;398663;193123;591786
2021.11_01-07-2022;Орловская область;21_45_days;SputnikLite;13457;7768;21225;398663;193123;591786
2021.11_01-07-2022;Орловская область;21_45_days;SputnikV;3495;1969;5464;398663;193123;591786
2021.11_01-07-2022;Орловская область;45_75_days;AllVaccines;20973;9833;30806;398663;193123;591786
2021.11_01-07-2022;Орловская область;45_75_days;CoviVac;2;3;5;398663;193123;591786
2021.11_01-07-2022;Орловская область;45_75_days;EpiVacCorona;661;200;861;398663;193123;591786
2021.11_01-07-2022;Орловская область;45_75_days;SputnikLite;8225;4974;13199;398663;193123;591786
2021.11_01-07-2022;Орловская область;45_75_days;SputnikV;12085;4656;16741;398663;193123;591786
2021.11_01-07-2022;Орловская область;75_90_days;AllVaccines;22279;5113;27392;398663;193123;591786
2021.11_01-07-2022;Орловская область;75_90_days;CoviVac;12;5;17;398663;193123;591786
2021.11_01-07-2022;Орловская область;75_90_days;EpiVacCorona;4633;1026;5659;398663;193123;591786
2021.11_01-07-2022;Орловская область;75_90_days;SputnikLite;6183;1264;7447;398663;193123;591786
2021.11_01-07-2022;Орловская область;75_90_days;SputnikV;11451;2818;14269;398663;193123;591786
2021.11_01-07-2022;Орловская область;90_105_days;AllVaccines;29669;5708;35377;398663;193123;591786
2021.11_01-07-2022;Орловская область;90_105_days;CoviVac;3;2;5;398663;193123;591786
2021.11_01-07-2022;Орловская область;90_105_days;EpiVacCorona;2042;421;2463;398663;193123;591786
2021.11_01-07-2022;Орловская область;90_105_days;SputnikLite;4762;554;5316;398663;193123;591786
2021.11_01-07-2022;Орловская область;90_105_days;SputnikV;22862;4731;27593;398663;193123;591786
2021.11_01-07-2022;Пензенская область;105_165_days;AllVaccines;85915;39208;125123;710438;350687;1061125
2021.11_01-07-2022;Пензенская область;105_165_days;CoviVac;595;46;641;710438;350687;1061125
2021.11_01-07-2022;Пензенская область;105_165_days;EpiVacCorona;5954;2909;8863;710438;350687;1061125
2021.11_01-07-2022;Пензенская область;105_165_days;SputnikLite;314;31;345;710438;350687;1061125
2021.11_01-07-2022;Пензенская область;105_165_days;SputnikV;79052;36222;115274;710438;350687;1061125
2021.11_01-07-2022;Пензенская область;165_195_days;AllVaccines;15740;20767;36507;710438;350687;1061125
2021.11_01-07-2022;Пензенская область;165_195_days;CoviVac;498;27;525;710438;350687;1061125
2021.11_01-07-2022;Пензенская область;165_195_days;EpiVacCorona;788;660;1448;710438;350687;1061125
2021.11_01-07-2022;Пензенская область;165_195_days;SputnikV;14454;20080;34534;710438;350687;1061125
2021.11_01-07-2022;Пензенская область;21_45_days;AllVaccines;37229;19849;57078;710438;350687;1061125
2021.11_01-07-2022;Пензенская область;21_45_days;CoviVac;57;9;66;710438;350687;1061125
2021.11_01-07-2022;Пензенская область;21_45_days;EpiVacCorona;190;87;277;710438;350687;1061125
2021.11_01-07-2022;Пензенская область;21_45_days;SputnikLite;24007;5934;29941;710438;350687;1061125
2021.11_01-07-2022;Пензенская область;21_45_days;SputnikV;12975;13819;26794;710438;350687;1061125
2021.11_01-07-2022;Пензенская область;45_75_days;AllVaccines;51895;34075;85970;710438;350687;1061125
2021.11_01-07-2022;Пензенская область;45_75_days;CoviVac;312;25;337;710438;350687;1061125
2021.11_01-07-2022;Пензенская область;45_75_days;EpiVacCorona;649;620;1269;710438;350687;1061125
2021.11_01-07-2022;Пензенская область;45_75_days;SputnikLite;30072;12003;42075;710438;350687;1061125
2021.11_01-07-2022;Пензенская область;45_75_days;SputnikV;20862;21427;42289;710438;350687;1061125
2021.11_01-07-2022;Пензенская область;75_90_days;AllVaccines;43478;11278;54756;710438;350687;1061125
2021.11_01-07-2022;Пензенская область;75_90_days;CoviVac;452;44;496;710438;350687;1061125
2021.11_01-07-2022;Пензенская область;75_90_days;EpiVacCorona;1591;587;2178;710438;350687;1061125
2021.11_01-07-2022;Пензенская область;75_90_days;SputnikLite;23828;5231;29059;710438;350687;1061125
2021.11_01-07-2022;Пензенская область;75_90_days;SputnikV;17607;5416;23023;710438;350687;1061125
2021.11_01-07-2022;Пензенская область;90_105_days;AllVaccines;40995;8061;49056;710438;350687;1061125
2021.11_01-07-2022;Пензенская область;90_105_days;CoviVac;330;52;382;710438;350687;1061125
2021.11_01-07-2022;Пензенская область;90_105_days;EpiVacCorona;591;164;755;710438;350687;1061125
2021.11_01-07-2022;Пензенская область;90_105_days;SputnikLite;9318;714;10032;710438;350687;1061125
2021.11_01-07-2022;Пензенская область;90_105_days;SputnikV;30756;7131;37887;710438;350687;1061125
2021.11_01-07-2022;Пермский край;105_165_days;AllVaccines;142870;56729;199599;1423011;574038;1997049
2021.11_01-07-2022;Пермский край;105_165_days;CoviVac;2718;516;3234;1423011;574038;1997049
2021.11_01-07-2022;Пермский край;105_165_days;EpiVacCorona;20798;12613;33411;1423011;574038;1997049
2021.11_01-07-2022;Пермский край;105_165_days;SputnikLite;630;84;714;1423011;574038;1997049
2021.11_01-07-2022;Пермский край;105_165_days;SputnikV;118724;43516;162240;1423011;574038;1997049
2021.11_01-07-2022;Пермский край;165_195_days;AllVaccines;37809;40002;77811;1423011;574038;1997049
2021.11_01-07-2022;Пермский край;165_195_days;EpiVacCorona;3613;3609;7222;1423011;574038;1997049
2021.11_01-07-2022;Пермский край;165_195_days;SputnikLite;1;0;1;1423011;574038;1997049
2021.11_01-07-2022;Пермский край;165_195_days;SputnikV;34195;36393;70588;1423011;574038;1997049
2021.11_01-07-2022;Пермский край;21_45_days;AllVaccines;55278;24316;79594;1423011;574038;1997049
2021.11_01-07-2022;Пермский край;21_45_days;CoviVac;918;250;1168;1423011;574038;1997049
2021.11_01-07-2022;Пермский край;21_45_days;EpiVacCorona;470;225;695;1423011;574038;1997049
2021.11_01-07-2022;Пермский край;21_45_days;SputnikLite;32379;16906;49285;1423011;574038;1997049
2021.11_01-07-2022;Пермский край;21_45_days;SputnikV;21511;6935;28446;1423011;574038;1997049
2021.11_01-07-2022;Пермский край;45_75_days;AllVaccines;97742;30990;128732;1423011;574038;1997049
2021.11_01-07-2022;Пермский край;45_75_days;CoviVac;1599;230;1829;1423011;574038;1997049
2021.11_01-07-2022;Пермский край;45_75_days;EpiVacCorona;2108;636;2744;1423011;574038;1997049
2021.11_01-07-2022;Пермский край;45_75_days;SputnikLite;26443;13982;40425;1423011;574038;1997049
2021.11_01-07-2022;Пермский край;45_75_days;SputnikV;67592;16142;83734;1423011;574038;1997049
2021.11_01-07-2022;Пермский край;75_90_days;AllVaccines;75441;13966;89407;1423011;574038;1997049
2021.11_01-07-2022;Пермский край;75_90_days;CoviVac;1246;148;1394;1423011;574038;1997049
2021.11_01-07-2022;Пермский край;75_90_days;EpiVacCorona;2399;617;3016;1423011;574038;1997049
2021.11_01-07-2022;Пермский край;75_90_days;SputnikLite;15930;2792;18722;1423011;574038;1997049
2021.11_01-07-2022;Пермский край;75_90_days;SputnikV;55866;10409;66275;1423011;574038;1997049
2021.11_01-07-2022;Пермский край;90_105_days;AllVaccines;88080;16741;104821;1423011;574038;1997049
2021.11_01-07-2022;Пермский край;90_105_days;CoviVac;1409;194;1603;1423011;574038;1997049
2021.11_01-07-2022;Пермский край;90_105_days;EpiVacCorona;944;204;1148;1423011;574038;1997049
2021.11_01-07-2022;Пермский край;90_105_days;SputnikLite;16953;1588;18541;1423011;574038;1997049
2021.11_01-07-2022;Пермский край;90_105_days;SputnikV;68774;14755;83529;1423011;574038;1997049
2021.11_01-07-2022;Приморский край;105_165_days;AllVaccines;105679;43546;149225;1086430;416518;1502948
2021.11_01-07-2022;Приморский край;105_165_days;CoviVac;874;108;982;1086430;416518;1502948
2021.11_01-07-2022;Приморский край;105_165_days;EpiVacCorona;14798;7469;22267;1086430;416518;1502948
2021.11_01-07-2022;Приморский край;105_165_days;SputnikLite;13;4;17;1086430;416518;1502948
2021.11_01-07-2022;Приморский край;105_165_days;SputnikV;89994;35965;125959;1086430;416518;1502948
2021.11_01-07-2022;Приморский край;165_195_days;AllVaccines;24375;16736;41111;1086430;416518;1502948
2021.11_01-07-2022;Приморский край;165_195_days;CoviVac;620;206;826;1086430;416518;1502948
2021.11_01-07-2022;Приморский край;165_195_days;EpiVacCorona;817;568;1385;1086430;416518;1502948
2021.11_01-07-2022;Приморский край;165_195_days;SputnikV;22938;15962;38900;1086430;416518;1502948
2021.11_01-07-2022;Приморский край;21_45_days;AllVaccines;27416;11982;39398;1086430;416518;1502948
2021.11_01-07-2022;Приморский край;21_45_days;CoviVac;507;70;577;1086430;416518;1502948
2021.11_01-07-2022;Приморский край;21_45_days;EpiVacCorona;518;238;756;1086430;416518;1502948
2021.11_01-07-2022;Приморский край;21_45_days;SputnikLite;15754;8315;24069;1086430;416518;1502948
2021.11_01-07-2022;Приморский край;21_45_days;SputnikV;10637;3359;13996;1086430;416518;1502948
2021.11_01-07-2022;Приморский край;45_75_days;AllVaccines;36383;13462;49845;1086430;416518;1502948
2021.11_01-07-2022;Приморский край;45_75_days;CoviVac;591;71;662;1086430;416518;1502948
2021.11_01-07-2022;Приморский край;45_75_days;EpiVacCorona;986;455;1441;1086430;416518;1502948
2021.11_01-07-2022;Приморский край;45_75_days;SputnikLite;9301;6058;15359;1086430;416518;1502948
2021.11_01-07-2022;Приморский край;45_75_days;SputnikV;25505;6878;32383;1086430;416518;1502948
2021.11_01-07-2022;Приморский край;75_90_days;AllVaccines;30830;6052;36882;1086430;416518;1502948
2021.11_01-07-2022;Приморский край;75_90_days;CoviVac;345;42;387;1086430;416518;1502948
2021.11_01-07-2022;Приморский край;75_90_days;EpiVacCorona;873;335;1208;1086430;416518;1502948
2021.11_01-07-2022;Приморский край;75_90_days;SputnikLite;5115;715;5830;1086430;416518;1502948
2021.11_01-07-2022;Приморский край;75_90_days;SputnikV;24497;4960;29457;1086430;416518;1502948
2021.11_01-07-2022;Приморский край;90_105_days;AllVaccines;36969;8846;45815;1086430;416518;1502948
2021.11_01-07-2022;Приморский край;90_105_days;CoviVac;615;29;644;1086430;416518;1502948
2021.11_01-07-2022;Приморский край;90_105_days;EpiVacCorona;393;122;515;1086430;416518;1502948
2021.11_01-07-2022;Приморский край;90_105_days;SputnikLite;2210;105;2315;1086430;416518;1502948
2021.11_01-07-2022;Приморский край;90_105_days;SputnikV;33751;8590;42341;1086430;416518;1502948
2021.11_01-07-2022;Псковская область;105_165_days;AllVaccines;37602;15986;53588;337881;166663;504544
2021.11_01-07-2022;Псковская область;105_165_days;CoviVac;913;169;1082;337881;166663;504544
2021.11_01-07-2022;Псковская область;105_165_days;EpiVacCorona;630;605;1235;337881;166663;504544
2021.11_01-07-2022;Псковская область;105_165_days;SputnikLite;1;0;1;337881;166663;504544
2021.11_01-07-2022;Псковская область;105_165_days;SputnikV;36058;15212;51270;337881;166663;504544
2021.11_01-07-2022;Псковская область;165_195_days;AllVaccines;7459;8741;16200;337881;166663;504544
2021.11_01-07-2022;Псковская область;165_195_days;EpiVacCorona;230;216;446;337881;166663;504544
2021.11_01-07-2022;Псковская область;165_195_days;SputnikV;7229;8525;15754;337881;166663;504544
2021.11_01-07-2022;Псковская область;21_45_days;AllVaccines;9956;6613;16569;337881;166663;504544
2021.11_01-07-2022;Псковская область;21_45_days;CoviVac;7;1;8;337881;166663;504544
2021.11_01-07-2022;Псковская область;21_45_days;EpiVacCorona;219;101;320;337881;166663;504544
2021.11_01-07-2022;Псковская область;21_45_days;SputnikLite;5268;4792;10060;337881;166663;504544
2021.11_01-07-2022;Псковская область;21_45_days;SputnikV;4462;1719;6181;337881;166663;504544
2021.11_01-07-2022;Псковская область;45_75_days;AllVaccines;16715;6961;23676;337881;166663;504544
2021.11_01-07-2022;Псковская область;45_75_days;CoviVac;21;3;24;337881;166663;504544
2021.11_01-07-2022;Псковская область;45_75_days;EpiVacCorona;826;282;1108;337881;166663;504544
2021.11_01-07-2022;Псковская область;45_75_days;SputnikLite;3123;2969;6092;337881;166663;504544
2021.11_01-07-2022;Псковская область;45_75_days;SputnikV;12745;3707;16452;337881;166663;504544
2021.11_01-07-2022;Псковская область;75_90_days;AllVaccines;21423;5084;26507;337881;166663;504544
2021.11_01-07-2022;Псковская область;75_90_days;CoviVac;31;4;35;337881;166663;504544
2021.11_01-07-2022;Псковская область;75_90_days;EpiVacCorona;4767;1159;5926;337881;166663;504544
2021.11_01-07-2022;Псковская область;75_90_days;SputnikLite;1659;536;2195;337881;166663;504544
2021.11_01-07-2022;Псковская область;75_90_days;SputnikV;14966;3385;18351;337881;166663;504544
2021.11_01-07-2022;Псковская область;90_105_days;AllVaccines;20663;4172;24835;337881;166663;504544
2021.11_01-07-2022;Псковская область;90_105_days;CoviVac;277;29;306;337881;166663;504544
2021.11_01-07-2022;Псковская область;90_105_days;EpiVacCorona;1464;329;1793;337881;166663;504544
2021.11_01-07-2022;Псковская область;90_105_days;SputnikLite;902;210;1112;337881;166663;504544
2021.11_01-07-2022;Псковская область;90_105_days;SputnikV;18020;3604;21624;337881;166663;504544
2021.11_01-07-2022;РФ;105_165_days;AllVaccines;12215555;3429848;15645403;82332898;33454776;115787674
2021.11_01-07-2022;РФ;105_165_days;CoviVac;245364;37058;282422;82332898;33454776;115787674
2021.11_01-07-2022;РФ;105_165_days;EpiVacCorona;589810;280430;870240;82332898;33454776;115787674
2021.11_01-07-2022;РФ;105_165_days;SputnikLite;300058;17188;317246;82332898;33454776;115787674
2021.11_01-07-2022;РФ;105_165_days;SputnikV;11080323;3095172;14175495;82332898;33454776;115787674
2021.11_01-07-2022;РФ;165_195_days;AllVaccines;2592180;2013921;4606101;82332898;33454776;115787674
2021.11_01-07-2022;РФ;165_195_days;CoviVac;16111;5241;21352;82332898;33454776;115787674
2021.11_01-07-2022;РФ;165_195_days;EpiVacCorona;110959;95885;206844;82332898;33454776;115787674
2021.11_01-07-2022;РФ;165_195_days;SputnikLite;284;546;830;82332898;33454776;115787674
2021.11_01-07-2022;РФ;165_195_days;SputnikV;2464826;1912249;4377075;82332898;33454776;115787674
2021.11_01-07-2022;РФ;21_45_days;AllVaccines;2941709;1404716;4346425;82332898;33454776;115787674
2021.11_01-07-2022;РФ;21_45_days;CoviVac;33314;8376;41690;82332898;33454776;115787674
2021.11_01-07-2022;РФ;21_45_days;EpiVacCorona;20681;11596;32277;82332898;33454776;115787674
2021.11_01-07-2022;РФ;21_45_days;SputnikLite;1815273;937577;2752850;82332898;33454776;115787674
2021.11_01-07-2022;РФ;21_45_days;SputnikV;1072441;447167;1519608;82332898;33454776;115787674
2021.11_01-07-2022;РФ;45_75_days;AllVaccines;3889431;1520613;5410044;82332898;33454776;115787674
2021.11_01-07-2022;РФ;45_75_days;CoviVac;63055;11018;74073;82332898;33454776;115787674
2021.11_01-07-2022;РФ;45_75_days;EpiVacCorona;60480;27029;87509;82332898;33454776;115787674
2021.11_01-07-2022;РФ;45_75_days;SputnikLite;1219911;670911;1890822;82332898;33454776;115787674
2021.11_01-07-2022;РФ;45_75_days;SputnikV;2545985;811655;3357640;82332898;33454776;115787674
2021.11_01-07-2022;РФ;75_90_days;AllVaccines;3866794;814039;4680833;82332898;33454776;115787674
2021.11_01-07-2022;РФ;75_90_days;CoviVac;43292;5998;49290;82332898;33454776;115787674
2021.11_01-07-2022;РФ;75_90_days;EpiVacCorona;113567;35762;149329;82332898;33454776;115787674
2021.11_01-07-2022;РФ;75_90_days;SputnikLite;903462;175180;1078642;82332898;33454776;115787674
2021.11_01-07-2022;РФ;75_90_days;SputnikV;2806473;597099;3403572;82332898;33454776;115787674
2021.11_01-07-2022;РФ;90_105_days;AllVaccines;5424164;940987;6365151;82332898;33454776;115787674
2021.11_01-07-2022;РФ;90_105_days;CoviVac;66419;8941;75360;82332898;33454776;115787674
2021.11_01-07-2022;РФ;90_105_days;EpiVacCorona;60642;15078;75720;82332898;33454776;115787674
2021.11_01-07-2022;РФ;90_105_days;SputnikLite;735537;71654;807191;82332898;33454776;115787674
2021.11_01-07-2022;РФ;90_105_days;SputnikV;4561566;845314;5406880;82332898;33454776;115787674
2021.11_01-07-2022;Республика Адыгея;105_165_days;AllVaccines;30532;10061;40593;256368;104563;360931
2021.11_01-07-2022;Республика Адыгея;105_165_days;CoviVac;588;108;696;256368;104563;360931
2021.11_01-07-2022;Республика Адыгея;105_165_days;EpiVacCorona;1419;544;1963;256368;104563;360931
2021.11_01-07-2022;Республика Адыгея;105_165_days;SputnikLite;195;22;217;256368;104563;360931
2021.11_01-07-2022;Республика Адыгея;105_165_days;SputnikV;28330;9387;37717;256368;104563;360931
2021.11_01-07-2022;Республика Адыгея;165_195_days;AllVaccines;3306;2670;5976;256368;104563;360931
2021.11_01-07-2022;Республика Адыгея;165_195_days;EpiVacCorona;54;58;112;256368;104563;360931
2021.11_01-07-2022;Республика Адыгея;165_195_days;SputnikV;3252;2612;5864;256368;104563;360931
2021.11_01-07-2022;Республика Адыгея;21_45_days;AllVaccines;10542;4044;14586;256368;104563;360931
2021.11_01-07-2022;Республика Адыгея;21_45_days;CoviVac;17;3;20;256368;104563;360931
2021.11_01-07-2022;Республика Адыгея;21_45_days;EpiVacCorona;57;25;82;256368;104563;360931
2021.11_01-07-2022;Республика Адыгея;21_45_days;SputnikLite;8209;3114;11323;256368;104563;360931
2021.11_01-07-2022;Республика Адыгея;21_45_days;SputnikV;2259;902;3161;256368;104563;360931
2021.11_01-07-2022;Республика Адыгея;45_75_days;AllVaccines;8821;3891;12712;256368;104563;360931
2021.11_01-07-2022;Республика Адыгея;45_75_days;CoviVac;17;6;23;256368;104563;360931
2021.11_01-07-2022;Республика Адыгея;45_75_days;EpiVacCorona;73;49;122;256368;104563;360931
2021.11_01-07-2022;Республика Адыгея;45_75_days;SputnikLite;2175;1526;3701;256368;104563;360931
2021.11_01-07-2022;Республика Адыгея;45_75_days;SputnikV;6556;2310;8866;256368;104563;360931
2021.11_01-07-2022;Республика Адыгея;75_90_days;AllVaccines;11503;2782;14285;256368;104563;360931
2021.11_01-07-2022;Республика Адыгея;75_90_days;CoviVac;5;2;7;256368;104563;360931
2021.11_01-07-2022;Республика Адыгея;75_90_days;EpiVacCorona;158;97;255;256368;104563;360931
2021.11_01-07-2022;Республика Адыгея;75_90_days;SputnikLite;2162;671;2833;256368;104563;360931
2021.11_01-07-2022;Республика Адыгея;75_90_days;SputnikV;9178;2012;11190;256368;104563;360931
2021.11_01-07-2022;Республика Адыгея;90_105_days;AllVaccines;16308;2799;19107;256368;104563;360931
2021.11_01-07-2022;Республика Адыгея;90_105_days;CoviVac;9;1;10;256368;104563;360931
2021.11_01-07-2022;Республика Адыгея;90_105_days;EpiVacCorona;216;50;266;256368;104563;360931
2021.11_01-07-2022;Республика Адыгея;90_105_days;SputnikLite;919;121;1040;256368;104563;360931
2021.11_01-07-2022;Республика Адыгея;90_105_days;SputnikV;15164;2627;17791;256368;104563;360931
2021.11_01-07-2022;Республика Алтай;105_165_days;AllVaccines;15117;4639;19756;117210;36468;153678
2021.11_01-07-2022;Республика Алтай;105_165_days;CoviVac;685;132;817;117210;36468;153678
2021.11_01-07-2022;Республика Алтай;105_165_days;EpiVacCorona;821;337;1158;117210;36468;153678
2021.11_01-07-2022;Республика Алтай;105_165_days;SputnikLite;24;3;27;117210;36468;153678
2021.11_01-07-2022;Республика Алтай;105_165_days;SputnikV;13587;4167;17754;117210;36468;153678
2021.11_01-07-2022;Республика Алтай;165_195_days;AllVaccines;5372;3455;8827;117210;36468;153678
2021.11_01-07-2022;Республика Алтай;165_195_days;EpiVacCorona;2165;1440;3605;117210;36468;153678
2021.11_01-07-2022;Республика Алтай;165_195_days;SputnikLite;0;1;1;117210;36468;153678
2021.11_01-07-2022;Республика Алтай;165_195_days;SputnikV;3207;2014;5221;117210;36468;153678
2021.11_01-07-2022;Республика Алтай;21_45_days;AllVaccines;3582;1974;5556;117210;36468;153678
2021.11_01-07-2022;Республика Алтай;21_45_days;CoviVac;15;7;22;117210;36468;153678
2021.11_01-07-2022;Республика Алтай;21_45_days;EpiVacCorona;24;21;45;117210;36468;153678
2021.11_01-07-2022;Республика Алтай;21_45_days;SputnikLite;2239;1571;3810;117210;36468;153678
2021.11_01-07-2022;Республика Алтай;21_45_days;SputnikV;1304;375;1679;117210;36468;153678
2021.11_01-07-2022;Республика Алтай;45_75_days;AllVaccines;5307;1637;6944;117210;36468;153678
2021.11_01-07-2022;Республика Алтай;45_75_days;CoviVac;18;8;26;117210;36468;153678
2021.11_01-07-2022;Республика Алтай;45_75_days;EpiVacCorona;6;1;7;117210;36468;153678
2021.11_01-07-2022;Республика Алтай;45_75_days;SputnikLite;2001;1095;3096;117210;36468;153678
2021.11_01-07-2022;Республика Алтай;45_75_days;SputnikV;3282;533;3815;117210;36468;153678
2021.11_01-07-2022;Республика Алтай;75_90_days;AllVaccines;5995;983;6978;117210;36468;153678
2021.11_01-07-2022;Республика Алтай;75_90_days;CoviVac;187;23;210;117210;36468;153678
2021.11_01-07-2022;Республика Алтай;75_90_days;EpiVacCorona;17;7;24;117210;36468;153678
2021.11_01-07-2022;Республика Алтай;75_90_days;SputnikLite;1613;420;2033;117210;36468;153678
2021.11_01-07-2022;Республика Алтай;75_90_days;SputnikV;4178;533;4711;117210;36468;153678
2021.11_01-07-2022;Республика Алтай;90_105_days;AllVaccines;6320;1047;7367;117210;36468;153678
2021.11_01-07-2022;Республика Алтай;90_105_days;CoviVac;335;61;396;117210;36468;153678
2021.11_01-07-2022;Республика Алтай;90_105_days;EpiVacCorona;57;17;74;117210;36468;153678
2021.11_01-07-2022;Республика Алтай;90_105_days;SputnikLite;897;127;1024;117210;36468;153678
2021.11_01-07-2022;Республика Алтай;90_105_days;SputnikV;5031;842;5873;117210;36468;153678
2021.11_01-07-2022;Республика Башкортостан;105_165_days;AllVaccines;352866;74928;427794;2235962;869874;3105836
2021.11_01-07-2022;Республика Башкортостан;105_165_days;CoviVac;6232;835;7067;2235962;869874;3105836
2021.11_01-07-2022;Республика Башкортостан;105_165_days;EpiVacCorona;10811;4125;14936;2235962;869874;3105836
2021.11_01-07-2022;Республика Башкортостан;105_165_days;SputnikLite;4121;552;4673;2235962;869874;3105836
2021.11_01-07-2022;Республика Башкортостан;105_165_days;SputnikV;331702;69416;401118;2235962;869874;3105836
2021.11_01-07-2022;Республика Башкортостан;165_195_days;AllVaccines;67183;46768;113951;2235962;869874;3105836
2021.11_01-07-2022;Республика Башкортостан;165_195_days;CoviVac;3;1;4;2235962;869874;3105836
2021.11_01-07-2022;Республика Башкортостан;165_195_days;EpiVacCorona;3064;2578;5642;2235962;869874;3105836
2021.11_01-07-2022;Республика Башкортостан;165_195_days;SputnikLite;12;1;13;2235962;869874;3105836
2021.11_01-07-2022;Республика Башкортостан;165_195_days;SputnikV;64104;44188;108292;2235962;869874;3105836
2021.11_01-07-2022;Республика Башкортостан;21_45_days;AllVaccines;90023;34831;124854;2235962;869874;3105836
2021.11_01-07-2022;Республика Башкортостан;21_45_days;CoviVac;1022;327;1349;2235962;869874;3105836
2021.11_01-07-2022;Республика Башкортостан;21_45_days;EpiVacCorona;611;384;995;2235962;869874;3105836
2021.11_01-07-2022;Республика Башкортостан;21_45_days;SputnikLite;42762;16387;59149;2235962;869874;3105836
2021.11_01-07-2022;Республика Башкортостан;21_45_days;SputnikV;45628;17733;63361;2235962;869874;3105836
2021.11_01-07-2022;Республика Башкортостан;45_75_days;AllVaccines;124296;43994;168290;2235962;869874;3105836
2021.11_01-07-2022;Республика Башкортостан;45_75_days;CoviVac;1873;436;2309;2235962;869874;3105836
2021.11_01-07-2022;Республика Башкортостан;45_75_days;EpiVacCorona;1653;855;2508;2235962;869874;3105836
2021.11_01-07-2022;Республика Башкортостан;45_75_days;SputnikLite;34743;15184;49927;2235962;869874;3105836
2021.11_01-07-2022;Республика Башкортостан;45_75_days;SputnikV;86027;27519;113546;2235962;869874;3105836
2021.11_01-07-2022;Республика Башкортостан;75_90_days;AllVaccines;120047;25310;145357;2235962;869874;3105836
2021.11_01-07-2022;Республика Башкортостан;75_90_days;CoviVac;1625;277;1902;2235962;869874;3105836
2021.11_01-07-2022;Республика Башкортостан;75_90_days;EpiVacCorona;2531;841;3372;2235962;869874;3105836
2021.11_01-07-2022;Республика Башкортостан;75_90_days;SputnikLite;25089;5037;30126;2235962;869874;3105836
2021.11_01-07-2022;Республика Башкортостан;75_90_days;SputnikV;90802;19155;109957;2235962;869874;3105836
2021.11_01-07-2022;Республика Башкортостан;90_105_days;AllVaccines;134007;22947;156954;2235962;869874;3105836
2021.11_01-07-2022;Республика Башкортостан;90_105_days;CoviVac;1974;245;2219;2235962;869874;3105836
2021.11_01-07-2022;Республика Башкортостан;90_105_days;EpiVacCorona;655;188;843;2235962;869874;3105836
2021.11_01-07-2022;Республика Башкортостан;90_105_days;SputnikLite;13104;1960;15064;2235962;869874;3105836
2021.11_01-07-2022;Республика Башкортостан;90_105_days;SputnikV;118274;20554;138828;2235962;869874;3105836
2021.11_01-07-2022;Республика Бурятия;105_165_days;AllVaccines;81194;28770;109964;542372;176777;719149
2021.11_01-07-2022;Республика Бурятия;105_165_days;CoviVac;614;208;822;542372;176777;719149
2021.11_01-07-2022;Республика Бурятия;105_165_days;EpiVacCorona;14529;6200;20729;542372;176777;719149
2021.11_01-07-2022;Республика Бурятия;105_165_days;SputnikLite;195;44;239;542372;176777;719149
2021.11_01-07-2022;Республика Бурятия;105_165_days;SputnikV;65856;22318;88174;542372;176777;719149
2021.11_01-07-2022;Республика Бурятия;165_195_days;AllVaccines;24055;17955;42010;542372;176777;719149
2021.11_01-07-2022;Республика Бурятия;165_195_days;CoviVac;2;0;2;542372;176777;719149
2021.11_01-07-2022;Республика Бурятия;165_195_days;EpiVacCorona;49;91;140;542372;176777;719149
2021.11_01-07-2022;Республика Бурятия;165_195_days;SputnikLite;4;2;6;542372;176777;719149
2021.11_01-07-2022;Республика Бурятия;165_195_days;SputnikV;24000;17862;41862;542372;176777;719149
2021.11_01-07-2022;Республика Бурятия;21_45_days;AllVaccines;19280;7366;26646;542372;176777;719149
2021.11_01-07-2022;Республика Бурятия;21_45_days;CoviVac;26;10;36;542372;176777;719149
2021.11_01-07-2022;Республика Бурятия;21_45_days;EpiVacCorona;138;34;172;542372;176777;719149
2021.11_01-07-2022;Республика Бурятия;21_45_days;SputnikLite;13460;5652;19112;542372;176777;719149
2021.11_01-07-2022;Республика Бурятия;21_45_days;SputnikV;5656;1670;7326;542372;176777;719149
2021.11_01-07-2022;Республика Бурятия;45_75_days;AllVaccines;34592;9249;43841;542372;176777;719149
2021.11_01-07-2022;Республика Бурятия;45_75_days;CoviVac;97;31;128;542372;176777;719149
2021.11_01-07-2022;Республика Бурятия;45_75_days;EpiVacCorona;186;47;233;542372;176777;719149
2021.11_01-07-2022;Республика Бурятия;45_75_days;SputnikLite;13848;4738;18586;542372;176777;719149
2021.11_01-07-2022;Республика Бурятия;45_75_days;SputnikV;20461;4433;24894;542372;176777;719149
2021.11_01-07-2022;Республика Бурятия;75_90_days;AllVaccines;30807;6133;36940;542372;176777;719149
2021.11_01-07-2022;Республика Бурятия;75_90_days;CoviVac;105;29;134;542372;176777;719149
2021.11_01-07-2022;Республика Бурятия;75_90_days;EpiVacCorona;254;85;339;542372;176777;719149
2021.11_01-07-2022;Республика Бурятия;75_90_days;SputnikLite;12710;2481;15191;542372;176777;719149
2021.11_01-07-2022;Республика Бурятия;75_90_days;SputnikV;17738;3538;21276;542372;176777;719149
2021.11_01-07-2022;Республика Бурятия;90_105_days;AllVaccines;30133;7222;37355;542372;176777;719149
2021.11_01-07-2022;Республика Бурятия;90_105_days;CoviVac;254;77;331;542372;176777;719149
2021.11_01-07-2022;Республика Бурятия;90_105_days;EpiVacCorona;1052;269;1321;542372;176777;719149
2021.11_01-07-2022;Республика Бурятия;90_105_days;SputnikLite;2169;336;2505;542372;176777;719149
2021.11_01-07-2022;Республика Бурятия;90_105_days;SputnikV;26658;6540;33198;542372;176777;719149
2021.11_01-07-2022;Республика Дагестан;105_165_days;AllVaccines;94251;18075;112326;1856109;394621;2250730
2021.11_01-07-2022;Республика Дагестан;105_165_days;CoviVac;2925;525;3450;1856109;394621;2250730
2021.11_01-07-2022;Республика Дагестан;105_165_days;EpiVacCorona;6042;1405;7447;1856109;394621;2250730
2021.11_01-07-2022;Республика Дагестан;105_165_days;SputnikLite;1961;243;2204;1856109;394621;2250730
2021.11_01-07-2022;Республика Дагестан;105_165_days;SputnikV;83323;15902;99225;1856109;394621;2250730
2021.11_01-07-2022;Республика Дагестан;165_195_days;AllVaccines;25178;5569;30747;1856109;394621;2250730
2021.11_01-07-2022;Республика Дагестан;165_195_days;CoviVac;14;5;19;1856109;394621;2250730
2021.11_01-07-2022;Республика Дагестан;165_195_days;EpiVacCorona;1537;442;1979;1856109;394621;2250730
2021.11_01-07-2022;Республика Дагестан;165_195_days;SputnikLite;5;0;5;1856109;394621;2250730
2021.11_01-07-2022;Республика Дагестан;165_195_days;SputnikV;23622;5122;28744;1856109;394621;2250730
2021.11_01-07-2022;Республика Дагестан;21_45_days;AllVaccines;31936;11378;43314;1856109;394621;2250730
2021.11_01-07-2022;Республика Дагестан;21_45_days;CoviVac;146;61;207;1856109;394621;2250730
2021.11_01-07-2022;Республика Дагестан;21_45_days;EpiVacCorona;107;51;158;1856109;394621;2250730
2021.11_01-07-2022;Республика Дагестан;21_45_days;SputnikLite;12468;2287;14755;1856109;394621;2250730
2021.11_01-07-2022;Республика Дагестан;21_45_days;SputnikV;19215;8979;28194;1856109;394621;2250730
2021.11_01-07-2022;Республика Дагестан;45_75_days;AllVaccines;75641;15996;91637;1856109;394621;2250730
2021.11_01-07-2022;Республика Дагестан;45_75_days;CoviVac;632;156;788;1856109;394621;2250730
2021.11_01-07-2022;Республика Дагестан;45_75_days;EpiVacCorona;731;213;944;1856109;394621;2250730
2021.11_01-07-2022;Республика Дагестан;45_75_days;SputnikLite;24050;6316;30366;1856109;394621;2250730
2021.11_01-07-2022;Республика Дагестан;45_75_days;SputnikV;50228;9311;59539;1856109;394621;2250730
2021.11_01-07-2022;Республика Дагестан;75_90_days;AllVaccines;72096;10451;82547;1856109;394621;2250730
2021.11_01-07-2022;Республика Дагестан;75_90_days;CoviVac;271;74;345;1856109;394621;2250730
2021.11_01-07-2022;Республика Дагестан;75_90_days;EpiVacCorona;3848;645;4493;1856109;394621;2250730
2021.11_01-07-2022;Республика Дагестан;75_90_days;SputnikLite;20735;2691;23426;1856109;394621;2250730
2021.11_01-07-2022;Республика Дагестан;75_90_days;SputnikV;47242;7041;54283;1856109;394621;2250730
2021.11_01-07-2022;Республика Дагестан;90_105_days;AllVaccines;51796;7366;59162;1856109;394621;2250730
2021.11_01-07-2022;Республика Дагестан;90_105_days;CoviVac;629;120;749;1856109;394621;2250730
2021.11_01-07-2022;Республика Дагестан;90_105_days;EpiVacCorona;1547;228;1775;1856109;394621;2250730
2021.11_01-07-2022;Республика Дагестан;90_105_days;SputnikLite;12038;1695;13733;1856109;394621;2250730
2021.11_01-07-2022;Республика Дагестан;90_105_days;SputnikV;37582;5323;42905;1856109;394621;2250730
2021.11_01-07-2022;Республика Ингушетия;105_165_days;AllVaccines;46628;7612;54240;295583;61477;357060
2021.11_01-07-2022;Республика Ингушетия;105_165_days;CoviVac;687;160;847;295583;61477;357060
2021.11_01-07-2022;Республика Ингушетия;105_165_days;EpiVacCorona;7194;891;8085;295583;61477;357060
2021.11_01-07-2022;Республика Ингушетия;105_165_days;SputnikLite;488;60;548;295583;61477;357060
2021.11_01-07-2022;Республика Ингушетия;105_165_days;SputnikV;38259;6501;44760;295583;61477;357060
2021.11_01-07-2022;Республика Ингушетия;165_195_days;AllVaccines;9307;3508;12815;295583;61477;357060
2021.11_01-07-2022;Республика Ингушетия;165_195_days;CoviVac;4;1;5;295583;61477;357060
2021.11_01-07-2022;Республика Ингушетия;165_195_days;EpiVacCorona;442;65;507;295583;61477;357060
2021.11_01-07-2022;Республика Ингушетия;165_195_days;SputnikLite;5;2;7;295583;61477;357060
2021.11_01-07-2022;Республика Ингушетия;165_195_days;SputnikV;8856;3440;12296;295583;61477;357060
2021.11_01-07-2022;Республика Ингушетия;21_45_days;AllVaccines;6225;1079;7304;295583;61477;357060
2021.11_01-07-2022;Республика Ингушетия;21_45_days;SputnikLite;2637;512;3149;295583;61477;357060
2021.11_01-07-2022;Республика Ингушетия;21_45_days;SputnikV;3588;567;4155;295583;61477;357060
2021.11_01-07-2022;Республика Ингушетия;45_75_days;AllVaccines;17852;2738;20590;295583;61477;357060
2021.11_01-07-2022;Республика Ингушетия;45_75_days;CoviVac;48;6;54;295583;61477;357060
2021.11_01-07-2022;Республика Ингушетия;45_75_days;EpiVacCorona;135;7;142;295583;61477;357060
2021.11_01-07-2022;Республика Ингушетия;45_75_days;SputnikLite;4803;717;5520;295583;61477;357060
2021.11_01-07-2022;Республика Ингушетия;45_75_days;SputnikV;12866;2008;14874;295583;61477;357060
2021.11_01-07-2022;Республика Ингушетия;75_90_days;AllVaccines;15932;2292;18224;295583;61477;357060
2021.11_01-07-2022;Республика Ингушетия;75_90_days;CoviVac;307;41;348;295583;61477;357060
2021.11_01-07-2022;Республика Ингушетия;75_90_days;EpiVacCorona;390;43;433;295583;61477;357060
2021.11_01-07-2022;Республика Ингушетия;75_90_days;SputnikLite;4661;648;5309;295583;61477;357060
2021.11_01-07-2022;Республика Ингушетия;75_90_days;SputnikV;10574;1560;12134;295583;61477;357060
2021.11_01-07-2022;Республика Ингушетия;90_105_days;AllVaccines;17763;2491;20254;295583;61477;357060
2021.11_01-07-2022;Республика Ингушетия;90_105_days;CoviVac;269;41;310;295583;61477;357060
2021.11_01-07-2022;Республика Ингушетия;90_105_days;EpiVacCorona;357;58;415;295583;61477;357060
2021.11_01-07-2022;Республика Ингушетия;90_105_days;SputnikLite;797;100;897;295583;61477;357060
2021.11_01-07-2022;Республика Ингушетия;90_105_days;SputnikV;16340;2292;18632;295583;61477;357060
2021.11_01-07-2022;Республика Калмыкия;105_165_days;AllVaccines;12831;4520;17351;150440;54890;205330
2021.11_01-07-2022;Республика Калмыкия;105_165_days;CoviVac;675;89;764;150440;54890;205330
2021.11_01-07-2022;Республика Калмыкия;105_165_days;EpiVacCorona;491;339;830;150440;54890;205330
2021.11_01-07-2022;Республика Калмыкия;105_165_days;SputnikLite;198;18;216;150440;54890;205330
2021.11_01-07-2022;Республика Калмыкия;105_165_days;SputnikV;11467;4074;15541;150440;54890;205330
2021.11_01-07-2022;Республика Калмыкия;165_195_days;AllVaccines;7322;5144;12466;150440;54890;205330
2021.11_01-07-2022;Республика Калмыкия;165_195_days;CoviVac;11;3;14;150440;54890;205330
2021.11_01-07-2022;Республика Калмыкия;165_195_days;EpiVacCorona;67;77;144;150440;54890;205330
2021.11_01-07-2022;Республика Калмыкия;165_195_days;SputnikLite;3;1;4;150440;54890;205330
2021.11_01-07-2022;Республика Калмыкия;165_195_days;SputnikV;7241;5063;12304;150440;54890;205330
2021.11_01-07-2022;Республика Калмыкия;21_45_days;AllVaccines;4855;3721;8576;150440;54890;205330
2021.11_01-07-2022;Республика Калмыкия;21_45_days;CoviVac;54;15;69;150440;54890;205330
2021.11_01-07-2022;Республика Калмыкия;21_45_days;SputnikLite;4299;3385;7684;150440;54890;205330
2021.11_01-07-2022;Республика Калмыкия;21_45_days;SputnikV;502;321;823;150440;54890;205330
2021.11_01-07-2022;Республика Калмыкия;45_75_days;AllVaccines;4342;2408;6750;150440;54890;205330
2021.11_01-07-2022;Республика Калмыкия;45_75_days;CoviVac;120;23;143;150440;54890;205330
2021.11_01-07-2022;Республика Калмыкия;45_75_days;EpiVacCorona;15;11;26;150440;54890;205330
2021.11_01-07-2022;Республика Калмыкия;45_75_days;SputnikLite;2647;1594;4241;150440;54890;205330
2021.11_01-07-2022;Республика Калмыкия;45_75_days;SputnikV;1560;780;2340;150440;54890;205330
2021.11_01-07-2022;Республика Калмыкия;75_90_days;AllVaccines;5613;1439;7052;150440;54890;205330
2021.11_01-07-2022;Республика Калмыкия;75_90_days;CoviVac;136;13;149;150440;54890;205330
2021.11_01-07-2022;Республика Калмыкия;75_90_days;EpiVacCorona;9;3;12;150440;54890;205330
2021.11_01-07-2022;Республика Калмыкия;75_90_days;SputnikLite;2536;653;3189;150440;54890;205330
2021.11_01-07-2022;Республика Калмыкия;75_90_days;SputnikV;2932;770;3702;150440;54890;205330
2021.11_01-07-2022;Республика Калмыкия;90_105_days;AllVaccines;5934;1294;7228;150440;54890;205330
2021.11_01-07-2022;Республика Калмыкия;90_105_days;CoviVac;168;40;208;150440;54890;205330
2021.11_01-07-2022;Республика Калмыкия;90_105_days;EpiVacCorona;26;4;30;150440;54890;205330
2021.11_01-07-2022;Республика Калмыкия;90_105_days;SputnikLite;1043;95;1138;150440;54890;205330
2021.11_01-07-2022;Республика Калмыкия;90_105_days;SputnikV;4697;1155;5852;150440;54890;205330
2021.11_01-07-2022;Республика Карелия;105_165_days;AllVaccines;37543;14575;52118;334874;149526;484400
2021.11_01-07-2022;Республика Карелия;105_165_days;CoviVac;1000;113;1113;334874;149526;484400
2021.11_01-07-2022;Республика Карелия;105_165_days;EpiVacCorona;375;302;677;334874;149526;484400
2021.11_01-07-2022;Республика Карелия;105_165_days;SputnikLite;417;60;477;334874;149526;484400
2021.11_01-07-2022;Республика Карелия;105_165_days;SputnikV;35751;14100;49851;334874;149526;484400
2021.11_01-07-2022;Республика Карелия;165_195_days;AllVaccines;10854;12165;23019;334874;149526;484400
2021.11_01-07-2022;Республика Карелия;165_195_days;EpiVacCorona;78;69;147;334874;149526;484400
2021.11_01-07-2022;Республика Карелия;165_195_days;SputnikV;10776;12096;22872;334874;149526;484400
2021.11_01-07-2022;Республика Карелия;21_45_days;AllVaccines;18043;9854;27897;334874;149526;484400
2021.11_01-07-2022;Республика Карелия;21_45_days;CoviVac;8;4;12;334874;149526;484400
2021.11_01-07-2022;Республика Карелия;21_45_days;EpiVacCorona;38;28;66;334874;149526;484400
2021.11_01-07-2022;Республика Карелия;21_45_days;SputnikLite;15065;7600;22665;334874;149526;484400
2021.11_01-07-2022;Республика Карелия;21_45_days;SputnikV;2932;2222;5154;334874;149526;484400
2021.11_01-07-2022;Республика Карелия;45_75_days;AllVaccines;16710;9980;26690;334874;149526;484400
2021.11_01-07-2022;Республика Карелия;45_75_days;CoviVac;40;6;46;334874;149526;484400
2021.11_01-07-2022;Республика Карелия;45_75_days;EpiVacCorona;50;37;87;334874;149526;484400
2021.11_01-07-2022;Республика Карелия;45_75_days;SputnikLite;8509;5648;14157;334874;149526;484400
2021.11_01-07-2022;Республика Карелия;45_75_days;SputnikV;8111;4289;12400;334874;149526;484400
2021.11_01-07-2022;Республика Карелия;75_90_days;AllVaccines;17588;4056;21644;334874;149526;484400
2021.11_01-07-2022;Республика Карелия;75_90_days;CoviVac;52;12;64;334874;149526;484400
2021.11_01-07-2022;Республика Карелия;75_90_days;EpiVacCorona;254;80;334;334874;149526;484400
2021.11_01-07-2022;Республика Карелия;75_90_days;SputnikLite;7070;1593;8663;334874;149526;484400
2021.11_01-07-2022;Республика Карелия;75_90_days;SputnikV;10212;2371;12583;334874;149526;484400
2021.11_01-07-2022;Республика Карелия;90_105_days;AllVaccines;27994;4744;32738;334874;149526;484400
2021.11_01-07-2022;Республика Карелия;90_105_days;CoviVac;240;22;262;334874;149526;484400
2021.11_01-07-2022;Республика Карелия;90_105_days;EpiVacCorona;137;29;166;334874;149526;484400
2021.11_01-07-2022;Республика Карелия;90_105_days;SputnikLite;7771;812;8583;334874;149526;484400
2021.11_01-07-2022;Республика Карелия;90_105_days;SputnikV;19846;3881;23727;334874;149526;484400
2021.11_01-07-2022;Республика Коми;105_165_days;AllVaccines;52656;17155;69811;465210;166370;631580
2021.11_01-07-2022;Республика Коми;105_165_days;CoviVac;1892;359;2251;465210;166370;631580
2021.11_01-07-2022;Республика Коми;105_165_days;EpiVacCorona;827;676;1503;465210;166370;631580
2021.11_01-07-2022;Республика Коми;105_165_days;SputnikLite;893;17;910;465210;166370;631580
2021.11_01-07-2022;Республика Коми;105_165_days;SputnikV;49044;16103;65147;465210;166370;631580
2021.11_01-07-2022;Республика Коми;165_195_days;AllVaccines;22812;16279;39091;465210;166370;631580
2021.11_01-07-2022;Республика Коми;165_195_days;EpiVacCorona;3170;2526;5696;465210;166370;631580
2021.11_01-07-2022;Республика Коми;165_195_days;SputnikV;19642;13753;33395;465210;166370;631580
2021.11_01-07-2022;Республика Коми;21_45_days;AllVaccines;12906;5677;18583;465210;166370;631580
2021.11_01-07-2022;Республика Коми;21_45_days;CoviVac;24;1;25;465210;166370;631580
2021.11_01-07-2022;Республика Коми;21_45_days;SputnikLite;9098;3951;13049;465210;166370;631580
2021.11_01-07-2022;Республика Коми;21_45_days;SputnikV;3784;1725;5509;465210;166370;631580
2021.11_01-07-2022;Республика Коми;45_75_days;AllVaccines;24348;6805;31153;465210;166370;631580
2021.11_01-07-2022;Республика Коми;45_75_days;CoviVac;59;12;71;465210;166370;631580
2021.11_01-07-2022;Республика Коми;45_75_days;SputnikLite;9806;3114;12920;465210;166370;631580
2021.11_01-07-2022;Республика Коми;45_75_days;SputnikV;14483;3679;18162;465210;166370;631580
2021.11_01-07-2022;Республика Коми;75_90_days;AllVaccines;25230;3557;28787;465210;166370;631580
2021.11_01-07-2022;Республика Коми;75_90_days;CoviVac;142;23;165;465210;166370;631580
2021.11_01-07-2022;Республика Коми;75_90_days;EpiVacCorona;21;6;27;465210;166370;631580
2021.11_01-07-2022;Республика Коми;75_90_days;SputnikLite;8764;935;9699;465210;166370;631580
2021.11_01-07-2022;Республика Коми;75_90_days;SputnikV;16303;2593;18896;465210;166370;631580
2021.11_01-07-2022;Республика Коми;90_105_days;AllVaccines;37331;5840;43171;465210;166370;631580
2021.11_01-07-2022;Республика Коми;90_105_days;CoviVac;420;33;453;465210;166370;631580
2021.11_01-07-2022;Республика Коми;90_105_days;EpiVacCorona;29;10;39;465210;166370;631580
2021.11_01-07-2022;Республика Коми;90_105_days;SputnikLite;9632;588;10220;465210;166370;631580
2021.11_01-07-2022;Республика Коми;90_105_days;SputnikV;27250;5209;32459;465210;166370;631580
2021.11_01-07-2022;Республика Крым;105_165_days;AllVaccines;125620;61659;187279;1036087;480146;1516233
2021.11_01-07-2022;Республика Крым;105_165_days;CoviVac;1772;517;2289;1036087;480146;1516233
2021.11_01-07-2022;Республика Крым;105_165_days;EpiVacCorona;7353;5150;12503;1036087;480146;1516233
2021.11_01-07-2022;Республика Крым;105_165_days;SputnikLite;17;2;19;1036087;480146;1516233
2021.11_01-07-2022;Республика Крым;105_165_days;SputnikV;116478;55990;172468;1036087;480146;1516233
2021.11_01-07-2022;Республика Крым;165_195_days;AllVaccines;44165;47795;91960;1036087;480146;1516233
2021.11_01-07-2022;Республика Крым;165_195_days;EpiVacCorona;1551;1577;3128;1036087;480146;1516233
2021.11_01-07-2022;Республика Крым;165_195_days;SputnikLite;1;0;1;1036087;480146;1516233
2021.11_01-07-2022;Республика Крым;165_195_days;SputnikV;42613;46218;88831;1036087;480146;1516233
2021.11_01-07-2022;Республика Крым;21_45_days;AllVaccines;33849;16844;50693;1036087;480146;1516233
2021.11_01-07-2022;Республика Крым;21_45_days;CoviVac;432;176;608;1036087;480146;1516233
2021.11_01-07-2022;Республика Крым;21_45_days;EpiVacCorona;274;150;424;1036087;480146;1516233
2021.11_01-07-2022;Республика Крым;21_45_days;SputnikLite;13379;11810;25189;1036087;480146;1516233
2021.11_01-07-2022;Республика Крым;21_45_days;SputnikV;19764;4708;24472;1036087;480146;1516233
2021.11_01-07-2022;Республика Крым;45_75_days;AllVaccines;36787;14593;51380;1036087;480146;1516233
2021.11_01-07-2022;Республика Крым;45_75_days;CoviVac;539;137;676;1036087;480146;1516233
2021.11_01-07-2022;Республика Крым;45_75_days;EpiVacCorona;576;350;926;1036087;480146;1516233
2021.11_01-07-2022;Республика Крым;45_75_days;SputnikLite;4674;7006;11680;1036087;480146;1516233
2021.11_01-07-2022;Республика Крым;45_75_days;SputnikV;30998;7100;38098;1036087;480146;1516233
2021.11_01-07-2022;Республика Крым;75_90_days;AllVaccines;29671;7564;37235;1036087;480146;1516233
2021.11_01-07-2022;Республика Крым;75_90_days;CoviVac;195;34;229;1036087;480146;1516233
2021.11_01-07-2022;Республика Крым;75_90_days;EpiVacCorona;857;443;1300;1036087;480146;1516233
2021.11_01-07-2022;Республика Крым;75_90_days;SputnikLite;1334;936;2270;1036087;480146;1516233
2021.11_01-07-2022;Республика Крым;75_90_days;SputnikV;27285;6151;33436;1036087;480146;1516233
2021.11_01-07-2022;Республика Крым;90_105_days;AllVaccines;34870;8920;43790;1036087;480146;1516233
2021.11_01-07-2022;Республика Крым;90_105_days;CoviVac;531;127;658;1036087;480146;1516233
2021.11_01-07-2022;Республика Крым;90_105_days;EpiVacCorona;422;135;557;1036087;480146;1516233
2021.11_01-07-2022;Республика Крым;90_105_days;SputnikLite;525;282;807;1036087;480146;1516233
2021.11_01-07-2022;Республика Крым;90_105_days;SputnikV;33392;8376;41768;1036087;480146;1516233
2021.11_01-07-2022;Республика Марий Эл;105_165_days;AllVaccines;34091;13102;47193;370626;156749;527375
2021.11_01-07-2022;Республика Марий Эл;105_165_days;CoviVac;825;200;1025;370626;156749;527375
2021.11_01-07-2022;Республика Марий Эл;105_165_days;EpiVacCorona;361;231;592;370626;156749;527375
2021.11_01-07-2022;Республика Марий Эл;105_165_days;SputnikLite;644;30;674;370626;156749;527375
2021.11_01-07-2022;Республика Марий Эл;105_165_days;SputnikV;32261;12641;44902;370626;156749;527375
2021.11_01-07-2022;Республика Марий Эл;165_195_days;AllVaccines;8976;7924;16900;370626;156749;527375
2021.11_01-07-2022;Республика Марий Эл;165_195_days;EpiVacCorona;133;69;202;370626;156749;527375
2021.11_01-07-2022;Республика Марий Эл;165_195_days;SputnikLite;0;1;1;370626;156749;527375
2021.11_01-07-2022;Республика Марий Эл;165_195_days;SputnikV;8843;7854;16697;370626;156749;527375
2021.11_01-07-2022;Республика Марий Эл;21_45_days;AllVaccines;25968;7433;33401;370626;156749;527375
2021.11_01-07-2022;Республика Марий Эл;21_45_days;CoviVac;11;3;14;370626;156749;527375
2021.11_01-07-2022;Республика Марий Эл;21_45_days;EpiVacCorona;12;5;17;370626;156749;527375
2021.11_01-07-2022;Республика Марий Эл;21_45_days;SputnikLite;23170;5648;28818;370626;156749;527375
2021.11_01-07-2022;Республика Марий Эл;21_45_days;SputnikV;2775;1777;4552;370626;156749;527375
2021.11_01-07-2022;Республика Марий Эл;45_75_days;AllVaccines;17330;5992;23322;370626;156749;527375
2021.11_01-07-2022;Республика Марий Эл;45_75_days;CoviVac;19;4;23;370626;156749;527375
2021.11_01-07-2022;Республика Марий Эл;45_75_days;EpiVacCorona;79;38;117;370626;156749;527375
2021.11_01-07-2022;Республика Марий Эл;45_75_days;SputnikLite;9185;2952;12137;370626;156749;527375
2021.11_01-07-2022;Республика Марий Эл;45_75_days;SputnikV;8047;2998;11045;370626;156749;527375
2021.11_01-07-2022;Республика Марий Эл;75_90_days;AllVaccines;26326;3757;30083;370626;156749;527375
2021.11_01-07-2022;Республика Марий Эл;75_90_days;CoviVac;44;6;50;370626;156749;527375
2021.11_01-07-2022;Республика Марий Эл;75_90_days;EpiVacCorona;337;173;510;370626;156749;527375
2021.11_01-07-2022;Республика Марий Эл;75_90_days;SputnikLite;13551;1148;14699;370626;156749;527375
2021.11_01-07-2022;Республика Марий Эл;75_90_days;SputnikV;12394;2430;14824;370626;156749;527375
2021.11_01-07-2022;Республика Марий Эл;90_105_days;AllVaccines;25612;3917;29529;370626;156749;527375
2021.11_01-07-2022;Республика Марий Эл;90_105_days;CoviVac;321;47;368;370626;156749;527375
2021.11_01-07-2022;Республика Марий Эл;90_105_days;EpiVacCorona;74;41;115;370626;156749;527375
2021.11_01-07-2022;Республика Марий Эл;90_105_days;SputnikLite;9681;341;10022;370626;156749;527375
2021.11_01-07-2022;Республика Марий Эл;90_105_days;SputnikV;15536;3488;19024;370626;156749;527375
2021.11_01-07-2022;Республика Мордовия;105_165_days;AllVaccines;73516;21652;95168;448319;198808;647127
2021.11_01-07-2022;Республика Мордовия;105_165_days;CoviVac;1067;155;1222;448319;198808;647127
2021.11_01-07-2022;Республика Мордовия;105_165_days;EpiVacCorona;2567;774;3341;448319;198808;647127
2021.11_01-07-2022;Республика Мордовия;105_165_days;SputnikLite;565;52;617;448319;198808;647127
2021.11_01-07-2022;Республика Мордовия;105_165_days;SputnikV;69317;20671;89988;448319;198808;647127
2021.11_01-07-2022;Республика Мордовия;165_195_days;AllVaccines;22273;14182;36455;448319;198808;647127
2021.11_01-07-2022;Республика Мордовия;165_195_days;EpiVacCorona;148;167;315;448319;198808;647127
2021.11_01-07-2022;Республика Мордовия;165_195_days;SputnikLite;0;1;1;448319;198808;647127
2021.11_01-07-2022;Республика Мордовия;165_195_days;SputnikV;22125;14014;36139;448319;198808;647127
2021.11_01-07-2022;Республика Мордовия;21_45_days;AllVaccines;23698;16738;40436;448319;198808;647127
2021.11_01-07-2022;Республика Мордовия;21_45_days;CoviVac;18;3;21;448319;198808;647127
2021.11_01-07-2022;Республика Мордовия;21_45_days;EpiVacCorona;58;42;100;448319;198808;647127
2021.11_01-07-2022;Республика Мордовия;21_45_days;SputnikLite;18318;10590;28908;448319;198808;647127
2021.11_01-07-2022;Республика Мордовия;21_45_days;SputnikV;5304;6103;11407;448319;198808;647127
2021.11_01-07-2022;Республика Мордовия;45_75_days;AllVaccines;22527;14429;36956;448319;198808;647127
2021.11_01-07-2022;Республика Мордовия;45_75_days;CoviVac;14;0;14;448319;198808;647127
2021.11_01-07-2022;Республика Мордовия;45_75_days;EpiVacCorona;86;70;156;448319;198808;647127
2021.11_01-07-2022;Республика Мордовия;45_75_days;SputnikLite;8580;5962;14542;448319;198808;647127
2021.11_01-07-2022;Республика Мордовия;45_75_days;SputnikV;13847;8397;22244;448319;198808;647127
2021.11_01-07-2022;Республика Мордовия;75_90_days;AllVaccines;27472;6764;34236;448319;198808;647127
2021.11_01-07-2022;Республика Мордовия;75_90_days;CoviVac;49;6;55;448319;198808;647127
2021.11_01-07-2022;Республика Мордовия;75_90_days;EpiVacCorona;283;74;357;448319;198808;647127
2021.11_01-07-2022;Республика Мордовия;75_90_days;SputnikLite;8534;2569;11103;448319;198808;647127
2021.11_01-07-2022;Республика Мордовия;75_90_days;SputnikV;18606;4115;22721;448319;198808;647127
2021.11_01-07-2022;Республика Мордовия;90_105_days;AllVaccines;29847;4987;34834;448319;198808;647127
2021.11_01-07-2022;Республика Мордовия;90_105_days;CoviVac;176;29;205;448319;198808;647127
2021.11_01-07-2022;Республика Мордовия;90_105_days;EpiVacCorona;205;49;254;448319;198808;647127
2021.11_01-07-2022;Республика Мордовия;90_105_days;SputnikLite;3562;552;4114;448319;198808;647127
2021.11_01-07-2022;Республика Мордовия;90_105_days;SputnikV;25904;4357;30261;448319;198808;647127
2021.11_01-07-2022;Республика Саха (Якутия);105_165_days;AllVaccines;97836;18381;116217;568643;148395;717038
2021.11_01-07-2022;Республика Саха (Якутия);105_165_days;CoviVac;1376;92;1468;568643;148395;717038
2021.11_01-07-2022;Республика Саха (Якутия);105_165_days;EpiVacCorona;25258;6069;31327;568643;148395;717038
2021.11_01-07-2022;Республика Саха (Якутия);105_165_days;SputnikLite;1146;77;1223;568643;148395;717038
2021.11_01-07-2022;Республика Саха (Якутия);105_165_days;SputnikV;70056;12143;82199;568643;148395;717038
2021.11_01-07-2022;Республика Саха (Якутия);165_195_days;AllVaccines;30679;12008;42687;568643;148395;717038
2021.11_01-07-2022;Республика Саха (Якутия);165_195_days;EpiVacCorona;7640;4023;11663;568643;148395;717038
2021.11_01-07-2022;Республика Саха (Якутия);165_195_days;SputnikLite;3;0;3;568643;148395;717038
2021.11_01-07-2022;Республика Саха (Якутия);165_195_days;SputnikV;23036;7985;31021;568643;148395;717038
2021.11_01-07-2022;Республика Саха (Якутия);21_45_days;AllVaccines;20501;5228;25729;568643;148395;717038
2021.11_01-07-2022;Республика Саха (Якутия);21_45_days;CoviVac;20;4;24;568643;148395;717038
2021.11_01-07-2022;Республика Саха (Якутия);21_45_days;EpiVacCorona;516;106;622;568643;148395;717038
2021.11_01-07-2022;Республика Саха (Якутия);21_45_days;SputnikLite;16009;4181;20190;568643;148395;717038
2021.11_01-07-2022;Республика Саха (Якутия);21_45_days;SputnikV;3956;937;4893;568643;148395;717038
2021.11_01-07-2022;Республика Саха (Якутия);45_75_days;AllVaccines;28286;6210;34496;568643;148395;717038
2021.11_01-07-2022;Республика Саха (Якутия);45_75_days;CoviVac;4;1;5;568643;148395;717038
2021.11_01-07-2022;Республика Саха (Якутия);45_75_days;EpiVacCorona;1378;265;1643;568643;148395;717038
2021.11_01-07-2022;Республика Саха (Якутия);45_75_days;SputnikLite;17929;3726;21655;568643;148395;717038
2021.11_01-07-2022;Республика Саха (Якутия);45_75_days;SputnikV;8975;2218;11193;568643;148395;717038
2021.11_01-07-2022;Республика Саха (Якутия);75_90_days;AllVaccines;27694;2740;30434;568643;148395;717038
2021.11_01-07-2022;Республика Саха (Якутия);75_90_days;CoviVac;9;0;9;568643;148395;717038
2021.11_01-07-2022;Республика Саха (Якутия);75_90_days;EpiVacCorona;4737;718;5455;568643;148395;717038
2021.11_01-07-2022;Республика Саха (Якутия);75_90_days;SputnikLite;16143;1168;17311;568643;148395;717038
2021.11_01-07-2022;Республика Саха (Якутия);75_90_days;SputnikV;6805;854;7659;568643;148395;717038
2021.11_01-07-2022;Республика Саха (Якутия);90_105_days;AllVaccines;35977;3439;39416;568643;148395;717038
2021.11_01-07-2022;Республика Саха (Якутия);90_105_days;CoviVac;11;1;12;568643;148395;717038
2021.11_01-07-2022;Республика Саха (Якутия);90_105_days;EpiVacCorona;11253;1827;13080;568643;148395;717038
2021.11_01-07-2022;Республика Саха (Якутия);90_105_days;SputnikLite;15669;665;16334;568643;148395;717038
2021.11_01-07-2022;Республика Саха (Якутия);90_105_days;SputnikV;9044;946;9990;568643;148395;717038
2021.11_01-07-2022;Республика Северная Осетия - Алания;105_165_days;AllVaccines;44334;8803;53137;385443;144230;529673
2021.11_01-07-2022;Республика Северная Осетия - Алания;105_165_days;CoviVac;562;175;737;385443;144230;529673
2021.11_01-07-2022;Республика Северная Осетия - Алания;105_165_days;EpiVacCorona;469;169;638;385443;144230;529673
2021.11_01-07-2022;Республика Северная Осетия - Алания;105_165_days;SputnikLite;271;77;348;385443;144230;529673
2021.11_01-07-2022;Республика Северная Осетия - Алания;105_165_days;SputnikV;43032;8382;51414;385443;144230;529673
2021.11_01-07-2022;Республика Северная Осетия - Алания;165_195_days;AllVaccines;9642;3072;12714;385443;144230;529673
2021.11_01-07-2022;Республика Северная Осетия - Алания;165_195_days;EpiVacCorona;5;3;8;385443;144230;529673
2021.11_01-07-2022;Республика Северная Осетия - Алания;165_195_days;SputnikV;9637;3069;12706;385443;144230;529673
2021.11_01-07-2022;Республика Северная Осетия - Алания;21_45_days;AllVaccines;8039;2247;10286;385443;144230;529673
2021.11_01-07-2022;Республика Северная Осетия - Алания;21_45_days;CoviVac;10;2;12;385443;144230;529673
2021.11_01-07-2022;Республика Северная Осетия - Алания;21_45_days;EpiVacCorona;144;29;173;385443;144230;529673
2021.11_01-07-2022;Республика Северная Осетия - Алания;21_45_days;SputnikLite;4285;1336;5621;385443;144230;529673
2021.11_01-07-2022;Республика Северная Осетия - Алания;21_45_days;SputnikV;3600;880;4480;385443;144230;529673
2021.11_01-07-2022;Республика Северная Осетия - Алания;45_75_days;AllVaccines;12267;2880;15147;385443;144230;529673
2021.11_01-07-2022;Республика Северная Осетия - Алания;45_75_days;CoviVac;9;0;9;385443;144230;529673
2021.11_01-07-2022;Республика Северная Осетия - Алания;45_75_days;EpiVacCorona;175;36;211;385443;144230;529673
2021.11_01-07-2022;Республика Северная Осетия - Алания;45_75_days;SputnikLite;3991;960;4951;385443;144230;529673
2021.11_01-07-2022;Республика Северная Осетия - Алания;45_75_days;SputnikV;8092;1884;9976;385443;144230;529673
2021.11_01-07-2022;Республика Северная Осетия - Алания;75_90_days;AllVaccines;10986;1897;12883;385443;144230;529673
2021.11_01-07-2022;Республика Северная Осетия - Алания;75_90_days;CoviVac;2;2;4;385443;144230;529673
2021.11_01-07-2022;Республика Северная Осетия - Алания;75_90_days;EpiVacCorona;184;20;204;385443;144230;529673
2021.11_01-07-2022;Республика Северная Осетия - Алания;75_90_days;SputnikLite;2117;356;2473;385443;144230;529673
2021.11_01-07-2022;Республика Северная Осетия - Алания;75_90_days;SputnikV;8683;1519;10202;385443;144230;529673
2021.11_01-07-2022;Республика Северная Осетия - Алания;90_105_days;AllVaccines;18821;3202;22023;385443;144230;529673
2021.11_01-07-2022;Республика Северная Осетия - Алания;90_105_days;CoviVac;8;5;13;385443;144230;529673
2021.11_01-07-2022;Республика Северная Осетия - Алания;90_105_days;EpiVacCorona;64;11;75;385443;144230;529673
2021.11_01-07-2022;Республика Северная Осетия - Алания;90_105_days;SputnikLite;1734;254;1988;385443;144230;529673
2021.11_01-07-2022;Республика Северная Осетия - Алания;90_105_days;SputnikV;17015;2932;19947;385443;144230;529673
2021.11_01-07-2022;Республика Татарстан;105_165_days;AllVaccines;312971;73573;386544;2180132;866477;3046609
2021.11_01-07-2022;Республика Татарстан;105_165_days;CoviVac;2982;530;3512;2180132;866477;3046609
2021.11_01-07-2022;Республика Татарстан;105_165_days;EpiVacCorona;14007;5238;19245;2180132;866477;3046609
2021.11_01-07-2022;Республика Татарстан;105_165_days;SputnikLite;2407;190;2597;2180132;866477;3046609
2021.11_01-07-2022;Республика Татарстан;105_165_days;SputnikV;293575;67615;361190;2180132;866477;3046609
2021.11_01-07-2022;Республика Татарстан;165_195_days;AllVaccines;69786;33624;103410;2180132;866477;3046609
2021.11_01-07-2022;Республика Татарстан;165_195_days;CoviVac;192;107;299;2180132;866477;3046609
2021.11_01-07-2022;Республика Татарстан;165_195_days;EpiVacCorona;2699;2014;4713;2180132;866477;3046609
2021.11_01-07-2022;Республика Татарстан;165_195_days;SputnikLite;1;2;3;2180132;866477;3046609
2021.11_01-07-2022;Республика Татарстан;165_195_days;SputnikV;66894;31501;98395;2180132;866477;3046609
2021.11_01-07-2022;Республика Татарстан;21_45_days;AllVaccines;104550;30610;135160;2180132;866477;3046609
2021.11_01-07-2022;Республика Татарстан;21_45_days;CoviVac;1634;359;1993;2180132;866477;3046609
2021.11_01-07-2022;Республика Татарстан;21_45_days;EpiVacCorona;1017;546;1563;2180132;866477;3046609
2021.11_01-07-2022;Республика Татарстан;21_45_days;SputnikLite;51347;15254;66601;2180132;866477;3046609
2021.11_01-07-2022;Республика Татарстан;21_45_days;SputnikV;50552;14451;65003;2180132;866477;3046609
2021.11_01-07-2022;Республика Татарстан;45_75_days;AllVaccines;102113;29330;131443;2180132;866477;3046609
2021.11_01-07-2022;Республика Татарстан;45_75_days;CoviVac;2958;443;3401;2180132;866477;3046609
2021.11_01-07-2022;Республика Татарстан;45_75_days;EpiVacCorona;1601;831;2432;2180132;866477;3046609
2021.11_01-07-2022;Республика Татарстан;45_75_days;SputnikLite;20334;8743;29077;2180132;866477;3046609
2021.11_01-07-2022;Республика Татарстан;45_75_days;SputnikV;77220;19313;96533;2180132;866477;3046609
2021.11_01-07-2022;Республика Татарстан;75_90_days;AllVaccines;88702;15194;103896;2180132;866477;3046609
2021.11_01-07-2022;Республика Татарстан;75_90_days;CoviVac;2200;248;2448;2180132;866477;3046609
2021.11_01-07-2022;Республика Татарстан;75_90_days;EpiVacCorona;3375;1075;4450;2180132;866477;3046609
2021.11_01-07-2022;Республика Татарстан;75_90_days;SputnikLite;11436;1630;13066;2180132;866477;3046609
2021.11_01-07-2022;Республика Татарстан;75_90_days;SputnikV;71691;12241;83932;2180132;866477;3046609
2021.11_01-07-2022;Республика Татарстан;90_105_days;AllVaccines;110693;17217;127910;2180132;866477;3046609
2021.11_01-07-2022;Республика Татарстан;90_105_days;CoviVac;2680;424;3104;2180132;866477;3046609
2021.11_01-07-2022;Республика Татарстан;90_105_days;EpiVacCorona;1366;395;1761;2180132;866477;3046609
2021.11_01-07-2022;Республика Татарстан;90_105_days;SputnikLite;11238;840;12078;2180132;866477;3046609
2021.11_01-07-2022;Республика Татарстан;90_105_days;SputnikV;95409;15558;110967;2180132;866477;3046609
2021.11_01-07-2022;Республика Тыва;105_165_days;AllVaccines;28696;4756;33452;176122;31028;207150
2021.11_01-07-2022;Республика Тыва;105_165_days;CoviVac;1207;40;1247;176122;31028;207150
2021.11_01-07-2022;Республика Тыва;105_165_days;EpiVacCorona;1451;443;1894;176122;31028;207150
2021.11_01-07-2022;Республика Тыва;105_165_days;SputnikLite;1611;82;1693;176122;31028;207150
2021.11_01-07-2022;Республика Тыва;105_165_days;SputnikV;24427;4191;28618;176122;31028;207150
2021.11_01-07-2022;Республика Тыва;165_195_days;AllVaccines;14636;3311;17947;176122;31028;207150
2021.11_01-07-2022;Республика Тыва;165_195_days;CoviVac;676;16;692;176122;31028;207150
2021.11_01-07-2022;Республика Тыва;165_195_days;EpiVacCorona;1432;355;1787;176122;31028;207150
2021.11_01-07-2022;Республика Тыва;165_195_days;SputnikLite;3;177;180;176122;31028;207150
2021.11_01-07-2022;Республика Тыва;165_195_days;SputnikV;12525;2763;15288;176122;31028;207150
2021.11_01-07-2022;Республика Тыва;21_45_days;AllVaccines;11129;2973;14102;176122;31028;207150
2021.11_01-07-2022;Республика Тыва;21_45_days;CoviVac;16;1;17;176122;31028;207150
2021.11_01-07-2022;Республика Тыва;21_45_days;EpiVacCorona;24;4;28;176122;31028;207150
2021.11_01-07-2022;Республика Тыва;21_45_days;SputnikLite;9915;2699;12614;176122;31028;207150
2021.11_01-07-2022;Республика Тыва;21_45_days;SputnikV;1174;269;1443;176122;31028;207150
2021.11_01-07-2022;Республика Тыва;45_75_days;AllVaccines;7527;1213;8740;176122;31028;207150
2021.11_01-07-2022;Республика Тыва;45_75_days;CoviVac;20;1;21;176122;31028;207150
2021.11_01-07-2022;Республика Тыва;45_75_days;EpiVacCorona;26;7;33;176122;31028;207150
2021.11_01-07-2022;Республика Тыва;45_75_days;SputnikLite;5317;667;5984;176122;31028;207150
2021.11_01-07-2022;Республика Тыва;45_75_days;SputnikV;2164;538;2702;176122;31028;207150
2021.11_01-07-2022;Республика Тыва;75_90_days;AllVaccines;10535;904;11439;176122;31028;207150
2021.11_01-07-2022;Республика Тыва;75_90_days;CoviVac;39;1;40;176122;31028;207150
2021.11_01-07-2022;Республика Тыва;75_90_days;EpiVacCorona;28;5;33;176122;31028;207150
2021.11_01-07-2022;Республика Тыва;75_90_days;SputnikLite;5415;327;5742;176122;31028;207150
2021.11_01-07-2022;Республика Тыва;75_90_days;SputnikV;5053;571;5624;176122;31028;207150
2021.11_01-07-2022;Республика Тыва;90_105_days;AllVaccines;11017;974;11991;176122;31028;207150
2021.11_01-07-2022;Республика Тыва;90_105_days;CoviVac;192;11;203;176122;31028;207150
2021.11_01-07-2022;Республика Тыва;90_105_days;EpiVacCorona;23;5;28;176122;31028;207150
2021.11_01-07-2022;Республика Тыва;90_105_days;SputnikLite;4383;180;4563;176122;31028;207150
2021.11_01-07-2022;Республика Тыва;90_105_days;SputnikV;6419;778;7197;176122;31028;207150
2021.11_01-07-2022;Республика Хакасия;105_165_days;AllVaccines;40530;12808;53338;291439;112190;403629
2021.11_01-07-2022;Республика Хакасия;105_165_days;CoviVac;1347;327;1674;291439;112190;403629
2021.11_01-07-2022;Республика Хакасия;105_165_days;EpiVacCorona;352;155;507;291439;112190;403629
2021.11_01-07-2022;Республика Хакасия;105_165_days;SputnikLite;1;1;2;291439;112190;403629
2021.11_01-07-2022;Республика Хакасия;105_165_days;SputnikV;38830;12325;51155;291439;112190;403629
2021.11_01-07-2022;Республика Хакасия;165_195_days;AllVaccines;9915;7515;17430;291439;112190;403629
2021.11_01-07-2022;Республика Хакасия;165_195_days;EpiVacCorona;215;71;286;291439;112190;403629
2021.11_01-07-2022;Республика Хакасия;165_195_days;SputnikV;9700;7444;17144;291439;112190;403629
2021.11_01-07-2022;Республика Хакасия;21_45_days;AllVaccines;8280;4172;12452;291439;112190;403629
2021.11_01-07-2022;Республика Хакасия;21_45_days;CoviVac;105;49;154;291439;112190;403629
2021.11_01-07-2022;Республика Хакасия;21_45_days;EpiVacCorona;21;6;27;291439;112190;403629
2021.11_01-07-2022;Республика Хакасия;21_45_days;SputnikLite;5783;3142;8925;291439;112190;403629
2021.11_01-07-2022;Республика Хакасия;21_45_days;SputnikV;2371;975;3346;291439;112190;403629
2021.11_01-07-2022;Республика Хакасия;45_75_days;AllVaccines;12923;4469;17392;291439;112190;403629
2021.11_01-07-2022;Республика Хакасия;45_75_days;CoviVac;249;81;330;291439;112190;403629
2021.11_01-07-2022;Республика Хакасия;45_75_days;EpiVacCorona;151;64;215;291439;112190;403629
2021.11_01-07-2022;Республика Хакасия;45_75_days;SputnikLite;4153;1842;5995;291439;112190;403629
2021.11_01-07-2022;Республика Хакасия;45_75_days;SputnikV;8370;2482;10852;291439;112190;403629
2021.11_01-07-2022;Республика Хакасия;75_90_days;AllVaccines;19026;3184;22210;291439;112190;403629
2021.11_01-07-2022;Республика Хакасия;75_90_days;CoviVac;57;7;64;291439;112190;403629
2021.11_01-07-2022;Республика Хакасия;75_90_days;EpiVacCorona;275;58;333;291439;112190;403629
2021.11_01-07-2022;Республика Хакасия;75_90_days;SputnikLite;3671;487;4158;291439;112190;403629
2021.11_01-07-2022;Республика Хакасия;75_90_days;SputnikV;15023;2632;17655;291439;112190;403629
2021.11_01-07-2022;Республика Хакасия;90_105_days;AllVaccines;22067;4269;26336;291439;112190;403629
2021.11_01-07-2022;Республика Хакасия;90_105_days;CoviVac;373;86;459;291439;112190;403629
2021.11_01-07-2022;Республика Хакасия;90_105_days;EpiVacCorona;119;31;150;291439;112190;403629
2021.11_01-07-2022;Республика Хакасия;90_105_days;SputnikLite;866;131;997;291439;112190;403629
2021.11_01-07-2022;Республика Хакасия;90_105_days;SputnikV;20709;4021;24730;291439;112190;403629
2021.11_01-07-2022;Ростовская область;105_165_days;AllVaccines;355816;115476;471292;2367942;1020468;3388410
2021.11_01-07-2022;Ростовская область;105_165_days;CoviVac;7259;1582;8841;2367942;1020468;3388410
2021.11_01-07-2022;Ростовская область;105_165_days;EpiVacCorona;36523;19061;55584;2367942;1020468;3388410
2021.11_01-07-2022;Ростовская область;105_165_days;SputnikLite;3162;550;3712;2367942;1020468;3388410
2021.11_01-07-2022;Ростовская область;105_165_days;SputnikV;308872;94283;403155;2367942;1020468;3388410
2021.11_01-07-2022;Ростовская область;165_195_days;AllVaccines;84732;67981;152713;2367942;1020468;3388410
2021.11_01-07-2022;Ростовская область;165_195_days;CoviVac;7;9;16;2367942;1020468;3388410
2021.11_01-07-2022;Ростовская область;165_195_days;EpiVacCorona;3619;2998;6617;2367942;1020468;3388410
2021.11_01-07-2022;Ростовская область;165_195_days;SputnikLite;105;120;225;2367942;1020468;3388410
2021.11_01-07-2022;Ростовская область;165_195_days;SputnikV;81001;64854;145855;2367942;1020468;3388410
2021.11_01-07-2022;Ростовская область;21_45_days;AllVaccines;64919;32513;97432;2367942;1020468;3388410
2021.11_01-07-2022;Ростовская область;21_45_days;CoviVac;778;310;1088;2367942;1020468;3388410
2021.11_01-07-2022;Ростовская область;21_45_days;EpiVacCorona;765;379;1144;2367942;1020468;3388410
2021.11_01-07-2022;Ростовская область;21_45_days;SputnikLite;28816;18401;47217;2367942;1020468;3388410
2021.11_01-07-2022;Ростовская область;21_45_days;SputnikV;34560;13423;47983;2367942;1020468;3388410
2021.11_01-07-2022;Ростовская область;45_75_days;AllVaccines;162185;51117;213302;2367942;1020468;3388410
2021.11_01-07-2022;Ростовская область;45_75_days;CoviVac;1125;303;1428;2367942;1020468;3388410
2021.11_01-07-2022;Ростовская область;45_75_days;EpiVacCorona;2564;972;3536;2367942;1020468;3388410
2021.11_01-07-2022;Ростовская область;45_75_days;SputnikLite;25367;14161;39528;2367942;1020468;3388410
2021.11_01-07-2022;Ростовская область;45_75_days;SputnikV;133129;35681;168810;2367942;1020468;3388410
2021.11_01-07-2022;Ростовская область;75_90_days;AllVaccines;170779;33037;203816;2367942;1020468;3388410
2021.11_01-07-2022;Ростовская область;75_90_days;CoviVac;1820;327;2147;2367942;1020468;3388410
2021.11_01-07-2022;Ростовская область;75_90_days;EpiVacCorona;4065;1183;5248;2367942;1020468;3388410
2021.11_01-07-2022;Ростовская область;75_90_days;SputnikLite;21004;4347;25351;2367942;1020468;3388410
2021.11_01-07-2022;Ростовская область;75_90_days;SputnikV;143890;27180;171070;2367942;1020468;3388410
2021.11_01-07-2022;Ростовская область;90_105_days;AllVaccines;221206;34675;255881;2367942;1020468;3388410
2021.11_01-07-2022;Ростовская область;90_105_days;CoviVac;2217;389;2606;2367942;1020468;3388410
2021.11_01-07-2022;Ростовская область;90_105_days;EpiVacCorona;837;195;1032;2367942;1020468;3388410
2021.11_01-07-2022;Ростовская область;90_105_days;SputnikLite;21110;2904;24014;2367942;1020468;3388410
2021.11_01-07-2022;Ростовская область;90_105_days;SputnikV;197042;31187;228229;2367942;1020468;3388410
2021.11_01-07-2022;Рязанская область;105_165_days;AllVaccines;61024;25021;86045;600731;301318;902049
2021.11_01-07-2022;Рязанская область;105_165_days;CoviVac;769;158;927;600731;301318;902049
2021.11_01-07-2022;Рязанская область;105_165_days;EpiVacCorona;1046;1384;2430;600731;301318;902049
2021.11_01-07-2022;Рязанская область;105_165_days;SputnikLite;72;51;123;600731;301318;902049
2021.11_01-07-2022;Рязанская область;105_165_days;SputnikV;59137;23428;82565;600731;301318;902049
2021.11_01-07-2022;Рязанская область;165_195_days;AllVaccines;13346;15919;29265;600731;301318;902049
2021.11_01-07-2022;Рязанская область;165_195_days;EpiVacCorona;10;4;14;600731;301318;902049
2021.11_01-07-2022;Рязанская область;165_195_days;SputnikLite;2;1;3;600731;301318;902049
2021.11_01-07-2022;Рязанская область;165_195_days;SputnikV;13334;15914;29248;600731;301318;902049
2021.11_01-07-2022;Рязанская область;21_45_days;AllVaccines;22022;11189;33211;600731;301318;902049
2021.11_01-07-2022;Рязанская область;21_45_days;CoviVac;100;23;123;600731;301318;902049
2021.11_01-07-2022;Рязанская область;21_45_days;EpiVacCorona;143;72;215;600731;301318;902049
2021.11_01-07-2022;Рязанская область;21_45_days;SputnikLite;14778;8638;23416;600731;301318;902049
2021.11_01-07-2022;Рязанская область;21_45_days;SputnikV;7001;2456;9457;600731;301318;902049
2021.11_01-07-2022;Рязанская область;45_75_days;AllVaccines;28423;13993;42416;600731;301318;902049
2021.11_01-07-2022;Рязанская область;45_75_days;CoviVac;460;95;555;600731;301318;902049
2021.11_01-07-2022;Рязанская область;45_75_days;EpiVacCorona;270;123;393;600731;301318;902049
2021.11_01-07-2022;Рязанская область;45_75_days;SputnikLite;8087;7352;15439;600731;301318;902049
2021.11_01-07-2022;Рязанская область;45_75_days;SputnikV;19606;6423;26029;600731;301318;902049
2021.11_01-07-2022;Рязанская область;75_90_days;AllVaccines;22121;6723;28844;600731;301318;902049
2021.11_01-07-2022;Рязанская область;75_90_days;CoviVac;90;13;103;600731;301318;902049
2021.11_01-07-2022;Рязанская область;75_90_days;EpiVacCorona;787;306;1093;600731;301318;902049
2021.11_01-07-2022;Рязанская область;75_90_days;SputnikLite;3896;2047;5943;600731;301318;902049
2021.11_01-07-2022;Рязанская область;75_90_days;SputnikV;17348;4357;21705;600731;301318;902049
2021.11_01-07-2022;Рязанская область;90_105_days;AllVaccines;24693;5371;30064;600731;301318;902049
2021.11_01-07-2022;Рязанская область;90_105_days;CoviVac;379;48;427;600731;301318;902049
2021.11_01-07-2022;Рязанская область;90_105_days;EpiVacCorona;273;110;383;600731;301318;902049
2021.11_01-07-2022;Рязанская область;90_105_days;SputnikLite;1514;432;1946;600731;301318;902049
2021.11_01-07-2022;Рязанская область;90_105_days;SputnikV;22527;4781;27308;600731;301318;902049
2021.11_01-07-2022;Самарская область;105_165_days;AllVaccines;248212;75196;323408;1769846;769791;2539637
2021.11_01-07-2022;Самарская область;105_165_days;CoviVac;5626;1036;6662;1769846;769791;2539637
2021.11_01-07-2022;Самарская область;105_165_days;EpiVacCorona;16425;7623;24048;1769846;769791;2539637
2021.11_01-07-2022;Самарская область;105_165_days;SputnikLite;6625;566;7191;1769846;769791;2539637
2021.11_01-07-2022;Самарская область;105_165_days;SputnikV;219536;65971;285507;1769846;769791;2539637
2021.11_01-07-2022;Самарская область;165_195_days;AllVaccines;59851;53472;113323;1769846;769791;2539637
2021.11_01-07-2022;Самарская область;165_195_days;CoviVac;1182;617;1799;1769846;769791;2539637
2021.11_01-07-2022;Самарская область;165_195_days;EpiVacCorona;1958;2690;4648;1769846;769791;2539637
2021.11_01-07-2022;Самарская область;165_195_days;SputnikLite;0;1;1;1769846;769791;2539637
2021.11_01-07-2022;Самарская область;165_195_days;SputnikV;56711;50164;106875;1769846;769791;2539637
2021.11_01-07-2022;Самарская область;21_45_days;AllVaccines;84621;38587;123208;1769846;769791;2539637
2021.11_01-07-2022;Самарская область;21_45_days;CoviVac;722;210;932;1769846;769791;2539637
2021.11_01-07-2022;Самарская область;21_45_days;EpiVacCorona;287;615;902;1769846;769791;2539637
2021.11_01-07-2022;Самарская область;21_45_days;SputnikLite;57162;28534;85696;1769846;769791;2539637
2021.11_01-07-2022;Самарская область;21_45_days;SputnikV;26450;9228;35678;1769846;769791;2539637
2021.11_01-07-2022;Самарская область;45_75_days;AllVaccines;103499;34822;138321;1769846;769791;2539637
2021.11_01-07-2022;Самарская область;45_75_days;CoviVac;1787;432;2219;1769846;769791;2539637
2021.11_01-07-2022;Самарская область;45_75_days;EpiVacCorona;1035;552;1587;1769846;769791;2539637
2021.11_01-07-2022;Самарская область;45_75_days;SputnikLite;40368;17499;57867;1769846;769791;2539637
2021.11_01-07-2022;Самарская область;45_75_days;SputnikV;60309;16339;76648;1769846;769791;2539637
2021.11_01-07-2022;Самарская область;75_90_days;AllVaccines;126333;20565;146898;1769846;769791;2539637
2021.11_01-07-2022;Самарская область;75_90_days;CoviVac;1043;126;1169;1769846;769791;2539637
2021.11_01-07-2022;Самарская область;75_90_days;EpiVacCorona;3429;815;4244;1769846;769791;2539637
2021.11_01-07-2022;Самарская область;75_90_days;SputnikLite;32765;5974;38739;1769846;769791;2539637
2021.11_01-07-2022;Самарская область;75_90_days;SputnikV;89096;13650;102746;1769846;769791;2539637
2021.11_01-07-2022;Самарская область;90_105_days;AllVaccines;126914;18905;145819;1769846;769791;2539637
2021.11_01-07-2022;Самарская область;90_105_days;CoviVac;2344;417;2761;1769846;769791;2539637
2021.11_01-07-2022;Самарская область;90_105_days;EpiVacCorona;2521;446;2967;1769846;769791;2539637
2021.11_01-07-2022;Самарская область;90_105_days;SputnikLite;26939;2846;29785;1769846;769791;2539637
2021.11_01-07-2022;Самарская область;90_105_days;SputnikV;95110;15196;110306;1769846;769791;2539637
2021.11_01-07-2022;Саратовская область;105_165_days;AllVaccines;175477;64752;240229;1348454;599954;1948408
2021.11_01-07-2022;Саратовская область;105_165_days;CoviVac;3969;672;4641;1348454;599954;1948408
2021.11_01-07-2022;Саратовская область;105_165_days;EpiVacCorona;2702;1922;4624;1348454;599954;1948408
2021.11_01-07-2022;Саратовская область;105_165_days;SputnikLite;71;22;93;1348454;599954;1948408
2021.11_01-07-2022;Саратовская область;105_165_days;SputnikV;168735;62136;230871;1348454;599954;1948408
2021.11_01-07-2022;Саратовская область;165_195_days;AllVaccines;35599;35442;71041;1348454;599954;1948408
2021.11_01-07-2022;Саратовская область;165_195_days;EpiVacCorona;921;930;1851;1348454;599954;1948408
2021.11_01-07-2022;Саратовская область;165_195_days;SputnikLite;29;9;38;1348454;599954;1948408
2021.11_01-07-2022;Саратовская область;165_195_days;SputnikV;34649;34503;69152;1348454;599954;1948408
2021.11_01-07-2022;Саратовская область;21_45_days;AllVaccines;50050;23878;73928;1348454;599954;1948408
2021.11_01-07-2022;Саратовская область;21_45_days;CoviVac;684;163;847;1348454;599954;1948408
2021.11_01-07-2022;Саратовская область;21_45_days;EpiVacCorona;284;164;448;1348454;599954;1948408
2021.11_01-07-2022;Саратовская область;21_45_days;SputnikLite;32800;14402;47202;1348454;599954;1948408
2021.11_01-07-2022;Саратовская область;21_45_days;SputnikV;16282;9149;25431;1348454;599954;1948408
2021.11_01-07-2022;Саратовская область;45_75_days;AllVaccines;52378;24127;76505;1348454;599954;1948408
2021.11_01-07-2022;Саратовская область;45_75_days;CoviVac;1323;286;1609;1348454;599954;1948408
2021.11_01-07-2022;Саратовская область;45_75_days;EpiVacCorona;851;584;1435;1348454;599954;1948408
2021.11_01-07-2022;Саратовская область;45_75_days;SputnikLite;17194;10916;28110;1348454;599954;1948408
2021.11_01-07-2022;Саратовская область;45_75_days;SputnikV;33010;12341;45351;1348454;599954;1948408
2021.11_01-07-2022;Саратовская область;75_90_days;AllVaccines;52219;12709;64928;1348454;599954;1948408
2021.11_01-07-2022;Саратовская область;75_90_days;CoviVac;255;31;286;1348454;599954;1948408
2021.11_01-07-2022;Саратовская область;75_90_days;EpiVacCorona;1038;561;1599;1348454;599954;1948408
2021.11_01-07-2022;Саратовская область;75_90_days;SputnikLite;11008;3300;14308;1348454;599954;1948408
2021.11_01-07-2022;Саратовская область;75_90_days;SputnikV;39918;8817;48735;1348454;599954;1948408
2021.11_01-07-2022;Саратовская область;90_105_days;AllVaccines;63055;13316;76371;1348454;599954;1948408
2021.11_01-07-2022;Саратовская область;90_105_days;CoviVac;1021;125;1146;1348454;599954;1948408
2021.11_01-07-2022;Саратовская область;90_105_days;EpiVacCorona;418;180;598;1348454;599954;1948408
2021.11_01-07-2022;Саратовская область;90_105_days;SputnikLite;8228;1597;9825;1348454;599954;1948408
2021.11_01-07-2022;Саратовская область;90_105_days;SputnikV;53388;11414;64802;1348454;599954;1948408
2021.11_01-07-2022;Сахалинская область;105_165_days;AllVaccines;44147;11916;56063;276677;101794;378471
2021.11_01-07-2022;Сахалинская область;105_165_days;CoviVac;1720;375;2095;276677;101794;378471
2021.11_01-07-2022;Сахалинская область;105_165_days;EpiVacCorona;620;160;780;276677;101794;378471
2021.11_01-07-2022;Сахалинская область;105_165_days;SputnikLite;351;10;361;276677;101794;378471
2021.11_01-07-2022;Сахалинская область;105_165_days;SputnikV;41456;11371;52827;276677;101794;378471
2021.11_01-07-2022;Сахалинская область;165_195_days;AllVaccines;12749;7234;19983;276677;101794;378471
2021.11_01-07-2022;Сахалинская область;165_195_days;EpiVacCorona;18;3;21;276677;101794;378471
2021.11_01-07-2022;Сахалинская область;165_195_days;SputnikV;12731;7231;19962;276677;101794;378471
2021.11_01-07-2022;Сахалинская область;21_45_days;AllVaccines;5144;4171;9315;276677;101794;378471
2021.11_01-07-2022;Сахалинская область;21_45_days;CoviVac;5;3;8;276677;101794;378471
2021.11_01-07-2022;Сахалинская область;21_45_days;EpiVacCorona;49;21;70;276677;101794;378471
2021.11_01-07-2022;Сахалинская область;21_45_days;SputnikLite;2604;3431;6035;276677;101794;378471
2021.11_01-07-2022;Сахалинская область;21_45_days;SputnikV;2486;716;3202;276677;101794;378471
2021.11_01-07-2022;Сахалинская область;45_75_days;AllVaccines;9692;2359;12051;276677;101794;378471
2021.11_01-07-2022;Сахалинская область;45_75_days;CoviVac;44;8;52;276677;101794;378471
2021.11_01-07-2022;Сахалинская область;45_75_days;EpiVacCorona;98;26;124;276677;101794;378471
2021.11_01-07-2022;Сахалинская область;45_75_days;SputnikLite;2301;729;3030;276677;101794;378471
2021.11_01-07-2022;Сахалинская область;45_75_days;SputnikV;7249;1596;8845;276677;101794;378471
2021.11_01-07-2022;Сахалинская область;75_90_days;AllVaccines;11258;1802;13060;276677;101794;378471
2021.11_01-07-2022;Сахалинская область;75_90_days;CoviVac;53;6;59;276677;101794;378471
2021.11_01-07-2022;Сахалинская область;75_90_days;EpiVacCorona;6;1;7;276677;101794;378471
2021.11_01-07-2022;Сахалинская область;75_90_days;SputnikLite;2495;353;2848;276677;101794;378471
2021.11_01-07-2022;Сахалинская область;75_90_days;SputnikV;8704;1442;10146;276677;101794;378471
2021.11_01-07-2022;Сахалинская область;90_105_days;AllVaccines;16938;2898;19836;276677;101794;378471
2021.11_01-07-2022;Сахалинская область;90_105_days;CoviVac;90;19;109;276677;101794;378471
2021.11_01-07-2022;Сахалинская область;90_105_days;EpiVacCorona;26;3;29;276677;101794;378471
2021.11_01-07-2022;Сахалинская область;90_105_days;SputnikLite;2729;182;2911;276677;101794;378471
2021.11_01-07-2022;Сахалинская область;90_105_days;SputnikV;14093;2694;16787;276677;101794;378471
2021.11_01-07-2022;Свердловская область;105_165_days;AllVaccines;244466;89107;333573;2364046;987486;3351532
2021.11_01-07-2022;Свердловская область;105_165_days;CoviVac;7271;943;8214;2364046;987486;3351532
2021.11_01-07-2022;Свердловская область;105_165_days;EpiVacCorona;14107;7660;21767;2364046;987486;3351532
2021.11_01-07-2022;Свердловская область;105_165_days;SputnikLite;3009;318;3327;2364046;987486;3351532
2021.11_01-07-2022;Свердловская область;105_165_days;SputnikV;220079;80186;300265;2364046;987486;3351532
2021.11_01-07-2022;Свердловская область;165_195_days;AllVaccines;80710;69847;150557;2364046;987486;3351532
2021.11_01-07-2022;Свердловская область;165_195_days;CoviVac;2;1;3;2364046;987486;3351532
2021.11_01-07-2022;Свердловская область;165_195_days;EpiVacCorona;3712;2063;5775;2364046;987486;3351532
2021.11_01-07-2022;Свердловская область;165_195_days;SputnikLite;6;0;6;2364046;987486;3351532
2021.11_01-07-2022;Свердловская область;165_195_days;SputnikV;76990;67783;144773;2364046;987486;3351532
2021.11_01-07-2022;Свердловская область;21_45_days;AllVaccines;127239;42940;170179;2364046;987486;3351532
2021.11_01-07-2022;Свердловская область;21_45_days;CoviVac;1786;457;2243;2364046;987486;3351532
2021.11_01-07-2022;Свердловская область;21_45_days;EpiVacCorona;327;147;474;2364046;987486;3351532
2021.11_01-07-2022;Свердловская область;21_45_days;SputnikLite;93014;29376;122390;2364046;987486;3351532
2021.11_01-07-2022;Свердловская область;21_45_days;SputnikV;32112;12960;45072;2364046;987486;3351532
2021.11_01-07-2022;Свердловская область;45_75_days;AllVaccines;102673;46740;149413;2364046;987486;3351532
2021.11_01-07-2022;Свердловская область;45_75_days;CoviVac;1009;188;1197;2364046;987486;3351532
2021.11_01-07-2022;Свердловская область;45_75_days;EpiVacCorona;1536;683;2219;2364046;987486;3351532
2021.11_01-07-2022;Свердловская область;45_75_days;SputnikLite;45032;19048;64080;2364046;987486;3351532
2021.11_01-07-2022;Свердловская область;45_75_days;SputnikV;55096;26821;81917;2364046;987486;3351532
2021.11_01-07-2022;Свердловская область;75_90_days;AllVaccines;95522;20927;116449;2364046;987486;3351532
2021.11_01-07-2022;Свердловская область;75_90_days;CoviVac;403;85;488;2364046;987486;3351532
2021.11_01-07-2022;Свердловская область;75_90_days;EpiVacCorona;4951;2180;7131;2364046;987486;3351532
2021.11_01-07-2022;Свердловская область;75_90_days;SputnikLite;41415;5536;46951;2364046;987486;3351532
2021.11_01-07-2022;Свердловская область;75_90_days;SputnikV;48753;13126;61879;2364046;987486;3351532
2021.11_01-07-2022;Свердловская область;90_105_days;AllVaccines;151279;28624;179903;2364046;987486;3351532
2021.11_01-07-2022;Свердловская область;90_105_days;CoviVac;1581;259;1840;2364046;987486;3351532
2021.11_01-07-2022;Свердловская область;90_105_days;EpiVacCorona;2183;581;2764;2364046;987486;3351532
2021.11_01-07-2022;Свердловская область;90_105_days;SputnikLite;48647;4061;52708;2364046;987486;3351532
2021.11_01-07-2022;Свердловская область;90_105_days;SputnikV;98868;23723;122591;2364046;987486;3351532
2021.11_01-07-2022;Смоленская область;105_165_days;AllVaccines;62899;22660;85559;521379;238479;759858
2021.11_01-07-2022;Смоленская область;105_165_days;CoviVac;1574;198;1772;521379;238479;759858
2021.11_01-07-2022;Смоленская область;105_165_days;EpiVacCorona;576;498;1074;521379;238479;759858
2021.11_01-07-2022;Смоленская область;105_165_days;SputnikLite;42;7;49;521379;238479;759858
2021.11_01-07-2022;Смоленская область;105_165_days;SputnikV;60707;21957;82664;521379;238479;759858
2021.11_01-07-2022;Смоленская область;165_195_days;AllVaccines;10813;12268;23081;521379;238479;759858
2021.11_01-07-2022;Смоленская область;165_195_days;CoviVac;1770;219;1989;521379;238479;759858
2021.11_01-07-2022;Смоленская область;165_195_days;EpiVacCorona;182;300;482;521379;238479;759858
2021.11_01-07-2022;Смоленская область;165_195_days;SputnikV;8861;11749;20610;521379;238479;759858
2021.11_01-07-2022;Смоленская область;21_45_days;AllVaccines;17749;8227;25976;521379;238479;759858
2021.11_01-07-2022;Смоленская область;21_45_days;CoviVac;37;8;45;521379;238479;759858
2021.11_01-07-2022;Смоленская область;21_45_days;EpiVacCorona;159;58;217;521379;238479;759858
2021.11_01-07-2022;Смоленская область;21_45_days;SputnikLite;12230;6078;18308;521379;238479;759858
2021.11_01-07-2022;Смоленская область;21_45_days;SputnikV;5323;2083;7406;521379;238479;759858
2021.11_01-07-2022;Смоленская область;45_75_days;AllVaccines;22613;9046;31659;521379;238479;759858
2021.11_01-07-2022;Смоленская область;45_75_days;CoviVac;103;10;113;521379;238479;759858
2021.11_01-07-2022;Смоленская область;45_75_days;EpiVacCorona;349;144;493;521379;238479;759858
2021.11_01-07-2022;Смоленская область;45_75_days;SputnikLite;5670;4464;10134;521379;238479;759858
2021.11_01-07-2022;Смоленская область;45_75_days;SputnikV;16491;4428;20919;521379;238479;759858
2021.11_01-07-2022;Смоленская область;75_90_days;AllVaccines;29615;6048;35663;521379;238479;759858
2021.11_01-07-2022;Смоленская область;75_90_days;CoviVac;169;18;187;521379;238479;759858
2021.11_01-07-2022;Смоленская область;75_90_days;EpiVacCorona;760;200;960;521379;238479;759858
2021.11_01-07-2022;Смоленская область;75_90_days;SputnikLite;4091;966;5057;521379;238479;759858
2021.11_01-07-2022;Смоленская область;75_90_days;SputnikV;24595;4864;29459;521379;238479;759858
2021.11_01-07-2022;Смоленская область;90_105_days;AllVaccines;36833;7154;43987;521379;238479;759858
2021.11_01-07-2022;Смоленская область;90_105_days;CoviVac;482;65;547;521379;238479;759858
2021.11_01-07-2022;Смоленская область;90_105_days;EpiVacCorona;45;16;61;521379;238479;759858
2021.11_01-07-2022;Смоленская область;90_105_days;SputnikLite;3265;422;3687;521379;238479;759858
2021.11_01-07-2022;Смоленская область;90_105_days;SputnikV;33041;6651;39692;521379;238479;759858
2021.11_01-07-2022;Ставропольский край;105_165_days;AllVaccines;174444;52636;227080;1590669;616030;2206699
2021.11_01-07-2022;Ставропольский край;105_165_days;CoviVac;3680;688;4368;1590669;616030;2206699
2021.11_01-07-2022;Ставропольский край;105_165_days;EpiVacCorona;13813;6783;20596;1590669;616030;2206699
2021.11_01-07-2022;Ставропольский край;105_165_days;SputnikLite;1339;210;1549;1590669;616030;2206699
2021.11_01-07-2022;Ставропольский край;105_165_days;SputnikV;155612;44955;200567;1590669;616030;2206699
2021.11_01-07-2022;Ставропольский край;165_195_days;AllVaccines;46587;32365;78952;1590669;616030;2206699
2021.11_01-07-2022;Ставропольский край;165_195_days;CoviVac;674;328;1002;1590669;616030;2206699
2021.11_01-07-2022;Ставропольский край;165_195_days;EpiVacCorona;2097;1704;3801;1590669;616030;2206699
2021.11_01-07-2022;Ставропольский край;165_195_days;SputnikLite;1;1;2;1590669;616030;2206699
2021.11_01-07-2022;Ставропольский край;165_195_days;SputnikV;43815;30332;74147;1590669;616030;2206699
2021.11_01-07-2022;Ставропольский край;21_45_days;AllVaccines;36743;22716;59459;1590669;616030;2206699
2021.11_01-07-2022;Ставропольский край;21_45_days;CoviVac;384;147;531;1590669;616030;2206699
2021.11_01-07-2022;Ставропольский край;21_45_days;EpiVacCorona;225;133;358;1590669;616030;2206699
2021.11_01-07-2022;Ставропольский край;21_45_days;SputnikLite;23103;14672;37775;1590669;616030;2206699
2021.11_01-07-2022;Ставропольский край;21_45_days;SputnikV;13031;7764;20795;1590669;616030;2206699
2021.11_01-07-2022;Ставропольский край;45_75_days;AllVaccines;55454;24676;80130;1590669;616030;2206699
2021.11_01-07-2022;Ставропольский край;45_75_days;CoviVac;522;167;689;1590669;616030;2206699
2021.11_01-07-2022;Ставропольский край;45_75_days;EpiVacCorona;580;378;958;1590669;616030;2206699
2021.11_01-07-2022;Ставропольский край;45_75_days;SputnikLite;19141;14000;33141;1590669;616030;2206699
2021.11_01-07-2022;Ставропольский край;45_75_days;SputnikV;35211;10131;45342;1590669;616030;2206699
2021.11_01-07-2022;Ставропольский край;75_90_days;AllVaccines;57647;11658;69305;1590669;616030;2206699
2021.11_01-07-2022;Ставропольский край;75_90_days;CoviVac;766;136;902;1590669;616030;2206699
2021.11_01-07-2022;Ставропольский край;75_90_days;EpiVacCorona;1430;516;1946;1590669;616030;2206699
2021.11_01-07-2022;Ставропольский край;75_90_days;SputnikLite;12610;3402;16012;1590669;616030;2206699
2021.11_01-07-2022;Ставропольский край;75_90_days;SputnikV;42841;7604;50445;1590669;616030;2206699
2021.11_01-07-2022;Ставропольский край;90_105_days;AllVaccines;85448;14616;100064;1590669;616030;2206699
2021.11_01-07-2022;Ставропольский край;90_105_days;CoviVac;1108;208;1316;1590669;616030;2206699
2021.11_01-07-2022;Ставропольский край;90_105_days;EpiVacCorona;846;227;1073;1590669;616030;2206699
2021.11_01-07-2022;Ставропольский край;90_105_days;SputnikLite;10526;1593;12119;1590669;616030;2206699
2021.11_01-07-2022;Ставропольский край;90_105_days;SputnikV;72968;12588;85556;1590669;616030;2206699
2021.11_01-07-2022;Тамбовская область;105_165_days;AllVaccines;78381;24820;103201;545785;279936;825721
2021.11_01-07-2022;Тамбовская область;105_165_days;CoviVac;1210;110;1320;545785;279936;825721
2021.11_01-07-2022;Тамбовская область;105_165_days;EpiVacCorona;947;852;1799;545785;279936;825721
2021.11_01-07-2022;Тамбовская область;105_165_days;SputnikLite;3778;276;4054;545785;279936;825721
2021.11_01-07-2022;Тамбовская область;105_165_days;SputnikV;72446;23582;96028;545785;279936;825721
2021.11_01-07-2022;Тамбовская область;165_195_days;AllVaccines;15542;15393;30935;545785;279936;825721
2021.11_01-07-2022;Тамбовская область;165_195_days;CoviVac;1;0;1;545785;279936;825721
2021.11_01-07-2022;Тамбовская область;165_195_days;EpiVacCorona;252;326;578;545785;279936;825721
2021.11_01-07-2022;Тамбовская область;165_195_days;SputnikLite;1;183;184;545785;279936;825721
2021.11_01-07-2022;Тамбовская область;165_195_days;SputnikV;15288;14884;30172;545785;279936;825721
2021.11_01-07-2022;Тамбовская область;21_45_days;AllVaccines;21829;12559;34388;545785;279936;825721
2021.11_01-07-2022;Тамбовская область;21_45_days;CoviVac;16;1;17;545785;279936;825721
2021.11_01-07-2022;Тамбовская область;21_45_days;EpiVacCorona;38;78;116;545785;279936;825721
2021.11_01-07-2022;Тамбовская область;21_45_days;SputnikLite;17470;8410;25880;545785;279936;825721
2021.11_01-07-2022;Тамбовская область;21_45_days;SputnikV;4305;4070;8375;545785;279936;825721
2021.11_01-07-2022;Тамбовская область;45_75_days;AllVaccines;29917;20654;50571;545785;279936;825721
2021.11_01-07-2022;Тамбовская область;45_75_days;CoviVac;14;2;16;545785;279936;825721
2021.11_01-07-2022;Тамбовская область;45_75_days;EpiVacCorona;58;107;165;545785;279936;825721
2021.11_01-07-2022;Тамбовская область;45_75_days;SputnikLite;18097;9646;27743;545785;279936;825721
2021.11_01-07-2022;Тамбовская область;45_75_days;SputnikV;11748;10899;22647;545785;279936;825721
2021.11_01-07-2022;Тамбовская область;75_90_days;AllVaccines;37466;9327;46793;545785;279936;825721
2021.11_01-07-2022;Тамбовская область;75_90_days;CoviVac;28;2;30;545785;279936;825721
2021.11_01-07-2022;Тамбовская область;75_90_days;EpiVacCorona;702;359;1061;545785;279936;825721
2021.11_01-07-2022;Тамбовская область;75_90_days;SputnikLite;18711;4019;22730;545785;279936;825721
2021.11_01-07-2022;Тамбовская область;75_90_days;SputnikV;18025;4947;22972;545785;279936;825721
2021.11_01-07-2022;Тамбовская область;90_105_days;AllVaccines;44130;6076;50206;545785;279936;825721
2021.11_01-07-2022;Тамбовская область;90_105_days;CoviVac;149;22;171;545785;279936;825721
2021.11_01-07-2022;Тамбовская область;90_105_days;EpiVacCorona;274;195;469;545785;279936;825721
2021.11_01-07-2022;Тамбовская область;90_105_days;SputnikLite;15391;968;16359;545785;279936;825721
2021.11_01-07-2022;Тамбовская область;90_105_days;SputnikV;28316;4891;33207;545785;279936;825721
2021.11_01-07-2022;Тверская область;105_165_days;AllVaccines;86756;30095;116851;681519;330234;1011753
2021.11_01-07-2022;Тверская область;105_165_days;CoviVac;1334;340;1674;681519;330234;1011753
2021.11_01-07-2022;Тверская область;105_165_days;EpiVacCorona;1259;1068;2327;681519;330234;1011753
2021.11_01-07-2022;Тверская область;105_165_days;SputnikLite;181;30;211;681519;330234;1011753
2021.11_01-07-2022;Тверская область;105_165_days;SputnikV;83982;28657;112639;681519;330234;1011753
2021.11_01-07-2022;Тверская область;165_195_days;AllVaccines;12249;14036;26285;681519;330234;1011753
2021.11_01-07-2022;Тверская область;165_195_days;CoviVac;219;79;298;681519;330234;1011753
2021.11_01-07-2022;Тверская область;165_195_days;EpiVacCorona;59;24;83;681519;330234;1011753
2021.11_01-07-2022;Тверская область;165_195_days;SputnikV;11971;13933;25904;681519;330234;1011753
2021.11_01-07-2022;Тверская область;21_45_days;AllVaccines;17406;15389;32795;681519;330234;1011753
2021.11_01-07-2022;Тверская область;21_45_days;CoviVac;170;45;215;681519;330234;1011753
2021.11_01-07-2022;Тверская область;21_45_days;EpiVacCorona;204;111;315;681519;330234;1011753
2021.11_01-07-2022;Тверская область;21_45_days;SputnikLite;10713;11655;22368;681519;330234;1011753
2021.11_01-07-2022;Тверская область;21_45_days;SputnikV;6319;3578;9897;681519;330234;1011753
2021.11_01-07-2022;Тверская область;45_75_days;AllVaccines;28440;17024;45464;681519;330234;1011753
2021.11_01-07-2022;Тверская область;45_75_days;CoviVac;554;107;661;681519;330234;1011753
2021.11_01-07-2022;Тверская область;45_75_days;EpiVacCorona;720;281;1001;681519;330234;1011753
2021.11_01-07-2022;Тверская область;45_75_days;SputnikLite;7031;7804;14835;681519;330234;1011753
2021.11_01-07-2022;Тверская область;45_75_days;SputnikV;20135;8832;28967;681519;330234;1011753
2021.11_01-07-2022;Тверская область;75_90_days;AllVaccines;32103;9760;41863;681519;330234;1011753
2021.11_01-07-2022;Тверская область;75_90_days;CoviVac;353;46;399;681519;330234;1011753
2021.11_01-07-2022;Тверская область;75_90_days;EpiVacCorona;1206;482;1688;681519;330234;1011753
2021.11_01-07-2022;Тверская область;75_90_days;SputnikLite;3589;1434;5023;681519;330234;1011753
2021.11_01-07-2022;Тверская область;75_90_days;SputnikV;26955;7798;34753;681519;330234;1011753
2021.11_01-07-2022;Тверская область;90_105_days;AllVaccines;48978;11101;60079;681519;330234;1011753
2021.11_01-07-2022;Тверская область;90_105_days;CoviVac;611;98;709;681519;330234;1011753
2021.11_01-07-2022;Тверская область;90_105_days;EpiVacCorona;439;102;541;681519;330234;1011753
2021.11_01-07-2022;Тверская область;90_105_days;SputnikLite;2073;418;2491;681519;330234;1011753
2021.11_01-07-2022;Тверская область;90_105_days;SputnikV;45855;10483;56338;681519;330234;1011753
2021.11_01-07-2022;Томская область;105_165_days;AllVaccines;74160;29677;103837;621613;222482;844095
2021.11_01-07-2022;Томская область;105_165_days;CoviVac;1050;111;1161;621613;222482;844095
2021.11_01-07-2022;Томская область;105_165_days;EpiVacCorona;9479;5345;14824;621613;222482;844095
2021.11_01-07-2022;Томская область;105_165_days;SputnikLite;215;26;241;621613;222482;844095
2021.11_01-07-2022;Томская область;105_165_days;SputnikV;63416;24195;87611;621613;222482;844095
2021.11_01-07-2022;Томская область;165_195_days;AllVaccines;19228;14642;33870;621613;222482;844095
2021.11_01-07-2022;Томская область;165_195_days;CoviVac;1;0;1;621613;222482;844095
2021.11_01-07-2022;Томская область;165_195_days;EpiVacCorona;1331;1060;2391;621613;222482;844095
2021.11_01-07-2022;Томская область;165_195_days;SputnikV;17896;13582;31478;621613;222482;844095
2021.11_01-07-2022;Томская область;21_45_days;AllVaccines;16259;9265;25524;621613;222482;844095
2021.11_01-07-2022;Томская область;21_45_days;CoviVac;42;7;49;621613;222482;844095
2021.11_01-07-2022;Томская область;21_45_days;EpiVacCorona;82;29;111;621613;222482;844095
2021.11_01-07-2022;Томская область;21_45_days;SputnikLite;10903;7371;18274;621613;222482;844095
2021.11_01-07-2022;Томская область;21_45_days;SputnikV;5232;1858;7090;621613;222482;844095
2021.11_01-07-2022;Томская область;45_75_days;AllVaccines;19419;8690;28109;621613;222482;844095
2021.11_01-07-2022;Томская область;45_75_days;CoviVac;159;16;175;621613;222482;844095
2021.11_01-07-2022;Томская область;45_75_days;EpiVacCorona;286;84;370;621613;222482;844095
2021.11_01-07-2022;Томская область;45_75_days;SputnikLite;5475;4558;10033;621613;222482;844095
2021.11_01-07-2022;Томская область;45_75_days;SputnikV;13499;4032;17531;621613;222482;844095
2021.11_01-07-2022;Томская область;75_90_days;AllVaccines;18553;4603;23156;621613;222482;844095
2021.11_01-07-2022;Томская область;75_90_days;CoviVac;107;6;113;621613;222482;844095
2021.11_01-07-2022;Томская область;75_90_days;EpiVacCorona;732;168;900;621613;222482;844095
2021.11_01-07-2022;Томская область;75_90_days;SputnikLite;3349;836;4185;621613;222482;844095
2021.11_01-07-2022;Томская область;75_90_days;SputnikV;14365;3593;17958;621613;222482;844095
2021.11_01-07-2022;Томская область;90_105_days;AllVaccines;27644;7201;34845;621613;222482;844095
2021.11_01-07-2022;Томская область;90_105_days;CoviVac;327;30;357;621613;222482;844095
2021.11_01-07-2022;Томская область;90_105_days;EpiVacCorona;373;118;491;621613;222482;844095
2021.11_01-07-2022;Томская область;90_105_days;SputnikLite;2766;348;3114;621613;222482;844095
2021.11_01-07-2022;Томская область;90_105_days;SputnikV;24178;6705;30883;621613;222482;844095
2021.11_01-07-2022;Тульская область;105_165_days;AllVaccines;183542;46161;229703;804510;401385;1205895
2021.11_01-07-2022;Тульская область;105_165_days;CoviVac;944;156;1100;804510;401385;1205895
2021.11_01-07-2022;Тульская область;105_165_days;EpiVacCorona;2150;1207;3357;804510;401385;1205895
2021.11_01-07-2022;Тульская область;105_165_days;SputnikLite;60;4;64;804510;401385;1205895
2021.11_01-07-2022;Тульская область;105_165_days;SputnikV;180388;44794;225182;804510;401385;1205895
2021.11_01-07-2022;Тульская область;165_195_days;AllVaccines;26811;19681;46492;804510;401385;1205895
2021.11_01-07-2022;Тульская область;165_195_days;CoviVac;905;248;1153;804510;401385;1205895
2021.11_01-07-2022;Тульская область;165_195_days;EpiVacCorona;113;281;394;804510;401385;1205895
2021.11_01-07-2022;Тульская область;165_195_days;SputnikV;25793;19152;44945;804510;401385;1205895
2021.11_01-07-2022;Тульская область;21_45_days;AllVaccines;19601;13721;33322;804510;401385;1205895
2021.11_01-07-2022;Тульская область;21_45_days;CoviVac;275;111;386;804510;401385;1205895
2021.11_01-07-2022;Тульская область;21_45_days;EpiVacCorona;314;239;553;804510;401385;1205895
2021.11_01-07-2022;Тульская область;21_45_days;SputnikLite;11729;8916;20645;804510;401385;1205895
2021.11_01-07-2022;Тульская область;21_45_days;SputnikV;7283;4455;11738;804510;401385;1205895
2021.11_01-07-2022;Тульская область;45_75_days;AllVaccines;28943;13590;42533;804510;401385;1205895
2021.11_01-07-2022;Тульская область;45_75_days;CoviVac;150;35;185;804510;401385;1205895
2021.11_01-07-2022;Тульская область;45_75_days;EpiVacCorona;507;316;823;804510;401385;1205895
2021.11_01-07-2022;Тульская область;45_75_days;SputnikLite;7772;4768;12540;804510;401385;1205895
2021.11_01-07-2022;Тульская область;45_75_days;SputnikV;20514;8471;28985;804510;401385;1205895
2021.11_01-07-2022;Тульская область;75_90_days;AllVaccines;36131;9337;45468;804510;401385;1205895
2021.11_01-07-2022;Тульская область;75_90_days;CoviVac;79;15;94;804510;401385;1205895
2021.11_01-07-2022;Тульская область;75_90_days;EpiVacCorona;625;268;893;804510;401385;1205895
2021.11_01-07-2022;Тульская область;75_90_days;SputnikLite;4786;1147;5933;804510;401385;1205895
2021.11_01-07-2022;Тульская область;75_90_days;SputnikV;30641;7907;38548;804510;401385;1205895
2021.11_01-07-2022;Тульская область;90_105_days;AllVaccines;79946;15985;95931;804510;401385;1205895
2021.11_01-07-2022;Тульская область;90_105_days;CoviVac;452;64;516;804510;401385;1205895
2021.11_01-07-2022;Тульская область;90_105_days;EpiVacCorona;262;125;387;804510;401385;1205895
2021.11_01-07-2022;Тульская область;90_105_days;SputnikLite;3541;380;3921;804510;401385;1205895
2021.11_01-07-2022;Тульская область;90_105_days;SputnikV;75691;15416;91107;804510;401385;1205895
2021.11_01-07-2022;Тюменская область;105_165_days;AllVaccines;173241;57521;230762;870789;301209;1171998
2021.11_01-07-2022;Тюменская область;105_165_days;CoviVac;641;184;825;870789;301209;1171998
2021.11_01-07-2022;Тюменская область;105_165_days;EpiVacCorona;15187;6252;21439;870789;301209;1171998
2021.11_01-07-2022;Тюменская область;105_165_days;SputnikLite;2456;423;2879;870789;301209;1171998
2021.11_01-07-2022;Тюменская область;105_165_days;SputnikV;154957;50662;205619;870789;301209;1171998
2021.11_01-07-2022;Тюменская область;165_195_days;AllVaccines;44454;39668;84122;870789;301209;1171998
2021.11_01-07-2022;Тюменская область;165_195_days;CoviVac;1;0;1;870789;301209;1171998
2021.11_01-07-2022;Тюменская область;165_195_days;EpiVacCorona;2909;2848;5757;870789;301209;1171998
2021.11_01-07-2022;Тюменская область;165_195_days;SputnikLite;1;1;2;870789;301209;1171998
2021.11_01-07-2022;Тюменская область;165_195_days;SputnikV;41543;36819;78362;870789;301209;1171998
2021.11_01-07-2022;Тюменская область;21_45_days;AllVaccines;37953;13681;51634;870789;301209;1171998
2021.11_01-07-2022;Тюменская область;21_45_days;CoviVac;72;18;90;870789;301209;1171998
2021.11_01-07-2022;Тюменская область;21_45_days;EpiVacCorona;166;99;265;870789;301209;1171998
2021.11_01-07-2022;Тюменская область;21_45_days;SputnikLite;28968;10855;39823;870789;301209;1171998
2021.11_01-07-2022;Тюменская область;21_45_days;SputnikV;8747;2709;11456;870789;301209;1171998
2021.11_01-07-2022;Тюменская область;45_75_days;AllVaccines;35150;13618;48768;870789;301209;1171998
2021.11_01-07-2022;Тюменская область;45_75_days;CoviVac;99;26;125;870789;301209;1171998
2021.11_01-07-2022;Тюменская область;45_75_days;EpiVacCorona;355;210;565;870789;301209;1171998
2021.11_01-07-2022;Тюменская область;45_75_days;SputnikLite;16980;7451;24431;870789;301209;1171998
2021.11_01-07-2022;Тюменская область;45_75_days;SputnikV;17716;5931;23647;870789;301209;1171998
2021.11_01-07-2022;Тюменская область;75_90_days;AllVaccines;45076;9758;54834;870789;301209;1171998
2021.11_01-07-2022;Тюменская область;75_90_days;CoviVac;102;18;120;870789;301209;1171998
2021.11_01-07-2022;Тюменская область;75_90_days;EpiVacCorona;437;190;627;870789;301209;1171998
2021.11_01-07-2022;Тюменская область;75_90_days;SputnikLite;13366;2912;16278;870789;301209;1171998
2021.11_01-07-2022;Тюменская область;75_90_days;SputnikV;31171;6638;37809;870789;301209;1171998
2021.11_01-07-2022;Тюменская область;90_105_days;AllVaccines;67217;13338;80555;870789;301209;1171998
2021.11_01-07-2022;Тюменская область;90_105_days;CoviVac;295;59;354;870789;301209;1171998
2021.11_01-07-2022;Тюменская область;90_105_days;EpiVacCorona;1096;258;1354;870789;301209;1171998
2021.11_01-07-2022;Тюменская область;90_105_days;SputnikLite;14352;2715;17067;870789;301209;1171998
2021.11_01-07-2022;Тюменская область;90_105_days;SputnikV;51474;10306;61780;870789;301209;1171998
2021.11_01-07-2022;Удмуртская Республика;105_165_days;AllVaccines;89465;41775;131240;818861;336450;1155311
2021.11_01-07-2022;Удмуртская Республика;105_165_days;CoviVac;155;17;172;818861;336450;1155311
2021.11_01-07-2022;Удмуртская Республика;105_165_days;EpiVacCorona;13919;12392;26311;818861;336450;1155311
2021.11_01-07-2022;Удмуртская Республика;105_165_days;SputnikLite;9;2;11;818861;336450;1155311
2021.11_01-07-2022;Удмуртская Республика;105_165_days;SputnikV;75382;29364;104746;818861;336450;1155311
2021.11_01-07-2022;Удмуртская Республика;165_195_days;AllVaccines;18033;21225;39258;818861;336450;1155311
2021.11_01-07-2022;Удмуртская Республика;165_195_days;CoviVac;588;83;671;818861;336450;1155311
2021.11_01-07-2022;Удмуртская Республика;165_195_days;EpiVacCorona;1170;2067;3237;818861;336450;1155311
2021.11_01-07-2022;Удмуртская Республика;165_195_days;SputnikLite;1;1;2;818861;336450;1155311
2021.11_01-07-2022;Удмуртская Республика;165_195_days;SputnikV;16274;19074;35348;818861;336450;1155311
2021.11_01-07-2022;Удмуртская Республика;21_45_days;AllVaccines;48612;16160;64772;818861;336450;1155311
2021.11_01-07-2022;Удмуртская Республика;21_45_days;CoviVac;31;2;33;818861;336450;1155311
2021.11_01-07-2022;Удмуртская Республика;21_45_days;EpiVacCorona;1376;1009;2385;818861;336450;1155311
2021.11_01-07-2022;Удмуртская Республика;21_45_days;SputnikLite;38523;11100;49623;818861;336450;1155311
2021.11_01-07-2022;Удмуртская Республика;21_45_days;SputnikV;8682;4049;12731;818861;336450;1155311
2021.11_01-07-2022;Удмуртская Республика;45_75_days;AllVaccines;33890;15853;49743;818861;336450;1155311
2021.11_01-07-2022;Удмуртская Республика;45_75_days;CoviVac;59;7;66;818861;336450;1155311
2021.11_01-07-2022;Удмуртская Республика;45_75_days;EpiVacCorona;3577;2363;5940;818861;336450;1155311
2021.11_01-07-2022;Удмуртская Республика;45_75_days;SputnikLite;13503;7625;21128;818861;336450;1155311
2021.11_01-07-2022;Удмуртская Республика;45_75_days;SputnikV;16751;5858;22609;818861;336450;1155311
2021.11_01-07-2022;Удмуртская Республика;75_90_days;AllVaccines;34036;8542;42578;818861;336450;1155311
2021.11_01-07-2022;Удмуртская Республика;75_90_days;CoviVac;80;12;92;818861;336450;1155311
2021.11_01-07-2022;Удмуртская Республика;75_90_days;EpiVacCorona;2611;1408;4019;818861;336450;1155311
2021.11_01-07-2022;Удмуртская Республика;75_90_days;SputnikLite;11879;1615;13494;818861;336450;1155311
2021.11_01-07-2022;Удмуртская Республика;75_90_days;SputnikV;19466;5507;24973;818861;336450;1155311
2021.11_01-07-2022;Удмуртская Республика;90_105_days;AllVaccines;49479;10851;60330;818861;336450;1155311
2021.11_01-07-2022;Удмуртская Республика;90_105_days;CoviVac;472;56;528;818861;336450;1155311
2021.11_01-07-2022;Удмуртская Республика;90_105_days;EpiVacCorona;129;54;183;818861;336450;1155311
2021.11_01-07-2022;Удмуртская Республика;90_105_days;SputnikLite;12106;501;12607;818861;336450;1155311
2021.11_01-07-2022;Удмуртская Республика;90_105_days;SputnikV;36772;10240;47012;818861;336450;1155311
2021.11_01-07-2022;Ульяновская область;105_165_days;AllVaccines;88880;27608;116488;672149;320065;992214
2021.11_01-07-2022;Ульяновская область;105_165_days;CoviVac;577;94;671;672149;320065;992214
2021.11_01-07-2022;Ульяновская область;105_165_days;EpiVacCorona;7567;2404;9971;672149;320065;992214
2021.11_01-07-2022;Ульяновская область;105_165_days;SputnikLite;88;13;101;672149;320065;992214
2021.11_01-07-2022;Ульяновская область;105_165_days;SputnikV;80648;25097;105745;672149;320065;992214
2021.11_01-07-2022;Ульяновская область;165_195_days;AllVaccines;18230;18448;36678;672149;320065;992214
2021.11_01-07-2022;Ульяновская область;165_195_days;CoviVac;995;461;1456;672149;320065;992214
2021.11_01-07-2022;Ульяновская область;165_195_days;EpiVacCorona;794;606;1400;672149;320065;992214
2021.11_01-07-2022;Ульяновская область;165_195_days;SputnikV;16441;17381;33822;672149;320065;992214
2021.11_01-07-2022;Ульяновская область;21_45_days;AllVaccines;26252;14830;41082;672149;320065;992214
2021.11_01-07-2022;Ульяновская область;21_45_days;CoviVac;11;4;15;672149;320065;992214
2021.11_01-07-2022;Ульяновская область;21_45_days;EpiVacCorona;150;52;202;672149;320065;992214
2021.11_01-07-2022;Ульяновская область;21_45_days;SputnikLite;16861;11465;28326;672149;320065;992214
2021.11_01-07-2022;Ульяновская область;21_45_days;SputnikV;9230;3309;12539;672149;320065;992214
2021.11_01-07-2022;Ульяновская область;45_75_days;AllVaccines;35611;13593;49204;672149;320065;992214
2021.11_01-07-2022;Ульяновская область;45_75_days;CoviVac;65;16;81;672149;320065;992214
2021.11_01-07-2022;Ульяновская область;45_75_days;EpiVacCorona;614;170;784;672149;320065;992214
2021.11_01-07-2022;Ульяновская область;45_75_days;SputnikLite;11307;7001;18308;672149;320065;992214
2021.11_01-07-2022;Ульяновская область;45_75_days;SputnikV;23625;6406;30031;672149;320065;992214
2021.11_01-07-2022;Ульяновская область;75_90_days;AllVaccines;31289;7245;38534;672149;320065;992214
2021.11_01-07-2022;Ульяновская область;75_90_days;CoviVac;76;8;84;672149;320065;992214
2021.11_01-07-2022;Ульяновская область;75_90_days;EpiVacCorona;962;237;1199;672149;320065;992214
2021.11_01-07-2022;Ульяновская область;75_90_days;SputnikLite;8330;1998;10328;672149;320065;992214
2021.11_01-07-2022;Ульяновская область;75_90_days;SputnikV;21921;5002;26923;672149;320065;992214
2021.11_01-07-2022;Ульяновская область;90_105_days;AllVaccines;33465;6378;39843;672149;320065;992214
2021.11_01-07-2022;Ульяновская область;90_105_days;CoviVac;209;24;233;672149;320065;992214
2021.11_01-07-2022;Ульяновская область;90_105_days;EpiVacCorona;547;136;683;672149;320065;992214
2021.11_01-07-2022;Ульяновская область;90_105_days;SputnikLite;5317;721;6038;672149;320065;992214
2021.11_01-07-2022;Ульяновская область;90_105_days;SputnikV;27392;5497;32889;672149;320065;992214
2021.11_01-07-2022;Хабаровский край;105_165_days;AllVaccines;80875;26807;107682;757169;265178;1022347
2021.11_01-07-2022;Хабаровский край;105_165_days;CoviVac;642;129;771;757169;265178;1022347
2021.11_01-07-2022;Хабаровский край;105_165_days;EpiVacCorona;623;286;909;757169;265178;1022347
2021.11_01-07-2022;Хабаровский край;105_165_days;SputnikLite;211;44;255;757169;265178;1022347
2021.11_01-07-2022;Хабаровский край;105_165_days;SputnikV;79399;26348;105747;757169;265178;1022347
2021.11_01-07-2022;Хабаровский край;165_195_days;AllVaccines;22811;13990;36801;757169;265178;1022347
2021.11_01-07-2022;Хабаровский край;165_195_days;EpiVacCorona;37;17;54;757169;265178;1022347
2021.11_01-07-2022;Хабаровский край;165_195_days;SputnikLite;8;0;8;757169;265178;1022347
2021.11_01-07-2022;Хабаровский край;165_195_days;SputnikV;22766;13973;36739;757169;265178;1022347
2021.11_01-07-2022;Хабаровский край;21_45_days;AllVaccines;15209;7789;22998;757169;265178;1022347
2021.11_01-07-2022;Хабаровский край;21_45_days;CoviVac;10;6;16;757169;265178;1022347
2021.11_01-07-2022;Хабаровский край;21_45_days;SputnikLite;8954;5369;14323;757169;265178;1022347
2021.11_01-07-2022;Хабаровский край;21_45_days;SputnikV;6245;2414;8659;757169;265178;1022347
2021.11_01-07-2022;Хабаровский край;45_75_days;AllVaccines;26759;10198;36957;757169;265178;1022347
2021.11_01-07-2022;Хабаровский край;45_75_days;CoviVac;40;4;44;757169;265178;1022347
2021.11_01-07-2022;Хабаровский край;45_75_days;EpiVacCorona;7;4;11;757169;265178;1022347
2021.11_01-07-2022;Хабаровский край;45_75_days;SputnikLite;9507;4368;13875;757169;265178;1022347
2021.11_01-07-2022;Хабаровский край;45_75_days;SputnikV;17205;5822;23027;757169;265178;1022347
2021.11_01-07-2022;Хабаровский край;75_90_days;AllVaccines;36190;6218;42408;757169;265178;1022347
2021.11_01-07-2022;Хабаровский край;75_90_days;CoviVac;84;13;97;757169;265178;1022347
2021.11_01-07-2022;Хабаровский край;75_90_days;EpiVacCorona;5;4;9;757169;265178;1022347
2021.11_01-07-2022;Хабаровский край;75_90_days;SputnikLite;10814;1642;12456;757169;265178;1022347
2021.11_01-07-2022;Хабаровский край;75_90_days;SputnikV;25287;4559;29846;757169;265178;1022347
2021.11_01-07-2022;Хабаровский край;90_105_days;AllVaccines;40104;7609;47713;757169;265178;1022347
2021.11_01-07-2022;Хабаровский край;90_105_days;CoviVac;294;18;312;757169;265178;1022347
2021.11_01-07-2022;Хабаровский край;90_105_days;EpiVacCorona;19;37;56;757169;265178;1022347
2021.11_01-07-2022;Хабаровский край;90_105_days;SputnikLite;5318;518;5836;757169;265178;1022347
2021.11_01-07-2022;Хабаровский край;90_105_days;SputnikV;34473;7036;41509;757169;265178;1022347
2021.11_01-07-2022;Ханты-Мансийский автономный округ - Югра;105_165_days;AllVaccines;187730;28909;216639;1019471;240107;1259578
2021.11_01-07-2022;Ханты-Мансийский автономный округ - Югра;105_165_days;CoviVac;803;128;931;1019471;240107;1259578
2021.11_01-07-2022;Ханты-Мансийский автономный округ - Югра;105_165_days;EpiVacCorona;5398;1084;6482;1019471;240107;1259578
2021.11_01-07-2022;Ханты-Мансийский автономный округ - Югра;105_165_days;SputnikLite;220;17;237;1019471;240107;1259578
2021.11_01-07-2022;Ханты-Мансийский автономный округ - Югра;105_165_days;SputnikV;181309;27680;208989;1019471;240107;1259578
2021.11_01-07-2022;Ханты-Мансийский автономный округ - Югра;165_195_days;AllVaccines;65104;20246;85350;1019471;240107;1259578
2021.11_01-07-2022;Ханты-Мансийский автономный округ - Югра;165_195_days;EpiVacCorona;3152;2773;5925;1019471;240107;1259578
2021.11_01-07-2022;Ханты-Мансийский автономный округ - Югра;165_195_days;SputnikLite;1;0;1;1019471;240107;1259578
2021.11_01-07-2022;Ханты-Мансийский автономный округ - Югра;165_195_days;SputnikV;61951;17473;79424;1019471;240107;1259578
2021.11_01-07-2022;Ханты-Мансийский автономный округ - Югра;21_45_days;AllVaccines;47008;9921;56929;1019471;240107;1259578
2021.11_01-07-2022;Ханты-Мансийский автономный округ - Югра;21_45_days;CoviVac;313;63;376;1019471;240107;1259578
2021.11_01-07-2022;Ханты-Мансийский автономный округ - Югра;21_45_days;EpiVacCorona;136;34;170;1019471;240107;1259578
2021.11_01-07-2022;Ханты-Мансийский автономный округ - Югра;21_45_days;SputnikLite;33313;7511;40824;1019471;240107;1259578
2021.11_01-07-2022;Ханты-Мансийский автономный округ - Югра;21_45_days;SputnikV;13246;2313;15559;1019471;240107;1259578
2021.11_01-07-2022;Ханты-Мансийский автономный округ - Югра;45_75_days;AllVaccines;46397;8221;54618;1019471;240107;1259578
2021.11_01-07-2022;Ханты-Мансийский автономный округ - Югра;45_75_days;CoviVac;90;17;107;1019471;240107;1259578
2021.11_01-07-2022;Ханты-Мансийский автономный округ - Югра;45_75_days;EpiVacCorona;685;153;838;1019471;240107;1259578
2021.11_01-07-2022;Ханты-Мансийский автономный округ - Югра;45_75_days;SputnikLite;17646;3744;21390;1019471;240107;1259578
2021.11_01-07-2022;Ханты-Мансийский автономный округ - Югра;45_75_days;SputnikV;27976;4307;32283;1019471;240107;1259578
2021.11_01-07-2022;Ханты-Мансийский автономный округ - Югра;75_90_days;AllVaccines;38947;4514;43461;1019471;240107;1259578
2021.11_01-07-2022;Ханты-Мансийский автономный округ - Югра;75_90_days;CoviVac;81;12;93;1019471;240107;1259578
2021.11_01-07-2022;Ханты-Мансийский автономный округ - Югра;75_90_days;EpiVacCorona;602;129;731;1019471;240107;1259578
2021.11_01-07-2022;Ханты-Мансийский автономный округ - Югра;75_90_days;SputnikLite;9042;1158;10200;1019471;240107;1259578
2021.11_01-07-2022;Ханты-Мансийский автономный округ - Югра;75_90_days;SputnikV;29222;3215;32437;1019471;240107;1259578
2021.11_01-07-2022;Ханты-Мансийский автономный округ - Югра;90_105_days;AllVaccines;50370;5681;56051;1019471;240107;1259578
2021.11_01-07-2022;Ханты-Мансийский автономный округ - Югра;90_105_days;CoviVac;379;58;437;1019471;240107;1259578
2021.11_01-07-2022;Ханты-Мансийский автономный округ - Югра;90_105_days;EpiVacCorona;366;57;423;1019471;240107;1259578
2021.11_01-07-2022;Ханты-Мансийский автономный округ - Югра;90_105_days;SputnikLite;4363;314;4677;1019471;240107;1259578
2021.11_01-07-2022;Ханты-Мансийский автономный округ - Югра;90_105_days;SputnikV;45262;5252;50514;1019471;240107;1259578
2021.11_01-07-2022;Челябинская область;105_165_days;AllVaccines;201262;74265;275527;1901705;795956;2697661
2021.11_01-07-2022;Челябинская область;105_165_days;CoviVac;3263;895;4158;1901705;795956;2697661
2021.11_01-07-2022;Челябинская область;105_165_days;EpiVacCorona;10846;5183;16029;1901705;795956;2697661
2021.11_01-07-2022;Челябинская область;105_165_days;SputnikLite;2267;191;2458;1901705;795956;2697661
2021.11_01-07-2022;Челябинская область;105_165_days;SputnikV;184886;67996;252882;1901705;795956;2697661
2021.11_01-07-2022;Челябинская область;165_195_days;AllVaccines;49413;44732;94145;1901705;795956;2697661
2021.11_01-07-2022;Челябинская область;165_195_days;CoviVac;0;1;1;1901705;795956;2697661
2021.11_01-07-2022;Челябинская область;165_195_days;EpiVacCorona;1734;1864;3598;1901705;795956;2697661
2021.11_01-07-2022;Челябинская область;165_195_days;SputnikLite;4;0;4;1901705;795956;2697661
2021.11_01-07-2022;Челябинская область;165_195_days;SputnikV;47675;42867;90542;1901705;795956;2697661
2021.11_01-07-2022;Челябинская область;21_45_days;AllVaccines;88229;32084;120313;1901705;795956;2697661
2021.11_01-07-2022;Челябинская область;21_45_days;CoviVac;1134;440;1574;1901705;795956;2697661
2021.11_01-07-2022;Челябинская область;21_45_days;EpiVacCorona;412;263;675;1901705;795956;2697661
2021.11_01-07-2022;Челябинская область;21_45_days;SputnikLite;59497;20282;79779;1901705;795956;2697661
2021.11_01-07-2022;Челябинская область;21_45_days;SputnikV;27186;11099;38285;1901705;795956;2697661
2021.11_01-07-2022;Челябинская область;45_75_days;AllVaccines;81466;32442;113908;1901705;795956;2697661
2021.11_01-07-2022;Челябинская область;45_75_days;CoviVac;2464;557;3021;1901705;795956;2697661
2021.11_01-07-2022;Челябинская область;45_75_days;EpiVacCorona;1988;1025;3013;1901705;795956;2697661
2021.11_01-07-2022;Челябинская область;45_75_days;SputnikLite;31477;14477;45954;1901705;795956;2697661
2021.11_01-07-2022;Челябинская область;45_75_days;SputnikV;45537;16383;61920;1901705;795956;2697661
2021.11_01-07-2022;Челябинская область;75_90_days;AllVaccines;71720;16283;88003;1901705;795956;2697661
2021.11_01-07-2022;Челябинская область;75_90_days;CoviVac;690;104;794;1901705;795956;2697661
2021.11_01-07-2022;Челябинская область;75_90_days;EpiVacCorona;3344;1539;4883;1901705;795956;2697661
2021.11_01-07-2022;Челябинская область;75_90_days;SputnikLite;22086;3365;25451;1901705;795956;2697661
2021.11_01-07-2022;Челябинская область;75_90_days;SputnikV;45600;11275;56875;1901705;795956;2697661
2021.11_01-07-2022;Челябинская область;90_105_days;AllVaccines;94982;18942;113924;1901705;795956;2697661
2021.11_01-07-2022;Челябинская область;90_105_days;CoviVac;347;90;437;1901705;795956;2697661
2021.11_01-07-2022;Челябинская область;90_105_days;EpiVacCorona;882;339;1221;1901705;795956;2697661
2021.11_01-07-2022;Челябинская область;90_105_days;SputnikLite;21812;1634;23446;1901705;795956;2697661
2021.11_01-07-2022;Челябинская область;90_105_days;SputnikV;71941;16879;88820;1901705;795956;2697661
2021.11_01-07-2022;Чеченская Республика;105_165_days;AllVaccines;243845;39959;283804;809759;137234;946993
2021.11_01-07-2022;Чеченская Республика;105_165_days;CoviVac;3720;809;4529;809759;137234;946993
2021.11_01-07-2022;Чеченская Республика;105_165_days;EpiVacCorona;6597;1110;7707;809759;137234;946993
2021.11_01-07-2022;Чеченская Республика;105_165_days;SputnikLite;14;2;16;809759;137234;946993
2021.11_01-07-2022;Чеченская Республика;105_165_days;SputnikV;233514;38038;271552;809759;137234;946993
2021.11_01-07-2022;Чеченская Республика;165_195_days;AllVaccines;17351;1878;19229;809759;137234;946993
2021.11_01-07-2022;Чеченская Республика;165_195_days;CoviVac;4;0;4;809759;137234;946993
2021.11_01-07-2022;Чеченская Республика;165_195_days;EpiVacCorona;553;88;641;809759;137234;946993
2021.11_01-07-2022;Чеченская Республика;165_195_days;SputnikV;16794;1790;18584;809759;137234;946993
2021.11_01-07-2022;Чеченская Республика;21_45_days;AllVaccines;27801;5889;33690;809759;137234;946993
2021.11_01-07-2022;Чеченская Республика;21_45_days;CoviVac;390;98;488;809759;137234;946993
2021.11_01-07-2022;Чеченская Республика;21_45_days;EpiVacCorona;569;148;717;809759;137234;946993
2021.11_01-07-2022;Чеченская Республика;21_45_days;SputnikLite;5901;646;6547;809759;137234;946993
2021.11_01-07-2022;Чеченская Республика;21_45_days;SputnikV;20941;4997;25938;809759;137234;946993
2021.11_01-07-2022;Чеченская Республика;45_75_days;AllVaccines;31925;8542;40467;809759;137234;946993
2021.11_01-07-2022;Чеченская Республика;45_75_days;CoviVac;118;44;162;809759;137234;946993
2021.11_01-07-2022;Чеченская Республика;45_75_days;EpiVacCorona;192;49;241;809759;137234;946993
2021.11_01-07-2022;Чеченская Республика;45_75_days;SputnikLite;1663;349;2012;809759;137234;946993
2021.11_01-07-2022;Чеченская Республика;45_75_days;SputnikV;29952;8100;38052;809759;137234;946993
2021.11_01-07-2022;Чеченская Республика;75_90_days;AllVaccines;39405;10158;49563;809759;137234;946993
2021.11_01-07-2022;Чеченская Республика;75_90_days;CoviVac;110;35;145;809759;137234;946993
2021.11_01-07-2022;Чеченская Республика;75_90_days;EpiVacCorona;108;29;137;809759;137234;946993
2021.11_01-07-2022;Чеченская Республика;75_90_days;SputnikLite;29;4;33;809759;137234;946993
2021.11_01-07-2022;Чеченская Республика;75_90_days;SputnikV;39158;10090;49248;809759;137234;946993
2021.11_01-07-2022;Чеченская Республика;90_105_days;AllVaccines;95155;20594;115749;809759;137234;946993
2021.11_01-07-2022;Чеченская Республика;90_105_days;CoviVac;195;56;251;809759;137234;946993
2021.11_01-07-2022;Чеченская Республика;90_105_days;EpiVacCorona;175;33;208;809759;137234;946993
2021.11_01-07-2022;Чеченская Республика;90_105_days;SputnikLite;21;2;23;809759;137234;946993
2021.11_01-07-2022;Чеченская Республика;90_105_days;SputnikV;94764;20503;115267;809759;137234;946993
2021.11_01-07-2022;Чувашская Республика;105_165_days;AllVaccines;80839;30322;111161;674689;275580;950269
2021.11_01-07-2022;Чувашская Республика;105_165_days;CoviVac;931;172;1103;674689;275580;950269
2021.11_01-07-2022;Чувашская Республика;105_165_days;EpiVacCorona;7121;2223;9344;674689;275580;950269
2021.11_01-07-2022;Чувашская Республика;105_165_days;SputnikLite;388;56;444;674689;275580;950269
2021.11_01-07-2022;Чувашская Республика;105_165_days;SputnikV;72399;27871;100270;674689;275580;950269
2021.11_01-07-2022;Чувашская Республика;165_195_days;AllVaccines;16285;18687;34972;674689;275580;950269
2021.11_01-07-2022;Чувашская Республика;165_195_days;EpiVacCorona;194;194;388;674689;275580;950269
2021.11_01-07-2022;Чувашская Республика;165_195_days;SputnikV;16091;18493;34584;674689;275580;950269
2021.11_01-07-2022;Чувашская Республика;21_45_days;AllVaccines;38710;11120;49830;674689;275580;950269
2021.11_01-07-2022;Чувашская Республика;21_45_days;CoviVac;222;59;281;674689;275580;950269
2021.11_01-07-2022;Чувашская Республика;21_45_days;EpiVacCorona;149;60;209;674689;275580;950269
2021.11_01-07-2022;Чувашская Республика;21_45_days;SputnikLite;32111;8839;40950;674689;275580;950269
2021.11_01-07-2022;Чувашская Республика;21_45_days;SputnikV;6228;2162;8390;674689;275580;950269
2021.11_01-07-2022;Чувашская Республика;45_75_days;AllVaccines;26087;11630;37717;674689;275580;950269
2021.11_01-07-2022;Чувашская Республика;45_75_days;CoviVac;177;33;210;674689;275580;950269
2021.11_01-07-2022;Чувашская Республика;45_75_days;EpiVacCorona;264;119;383;674689;275580;950269
2021.11_01-07-2022;Чувашская Республика;45_75_days;SputnikLite;11529;5638;17167;674689;275580;950269
2021.11_01-07-2022;Чувашская Республика;45_75_days;SputnikV;14117;5840;19957;674689;275580;950269
2021.11_01-07-2022;Чувашская Республика;75_90_days;AllVaccines;24176;5347;29523;674689;275580;950269
2021.11_01-07-2022;Чувашская Республика;75_90_days;CoviVac;66;5;71;674689;275580;950269
2021.11_01-07-2022;Чувашская Республика;75_90_days;EpiVacCorona;751;209;960;674689;275580;950269
2021.11_01-07-2022;Чувашская Республика;75_90_days;SputnikLite;6110;1586;7696;674689;275580;950269
2021.11_01-07-2022;Чувашская Республика;75_90_days;SputnikV;17249;3547;20796;674689;275580;950269
2021.11_01-07-2022;Чувашская Республика;90_105_days;AllVaccines;37479;7125;44604;674689;275580;950269
2021.11_01-07-2022;Чувашская Республика;90_105_days;CoviVac;208;12;220;674689;275580;950269
2021.11_01-07-2022;Чувашская Республика;90_105_days;EpiVacCorona;973;200;1173;674689;275580;950269
2021.11_01-07-2022;Чувашская Республика;90_105_days;SputnikLite;4061;551;4612;674689;275580;950269
2021.11_01-07-2022;Чувашская Республика;90_105_days;SputnikV;32237;6362;38599;674689;275580;950269
2021.11_01-07-2022;Чукотский автономный округ;105_165_days;AllVaccines;5054;787;5841;30806;6299;37105
2021.11_01-07-2022;Чукотский автономный округ;105_165_days;CoviVac;536;49;585;30806;6299;37105
2021.11_01-07-2022;Чукотский автономный округ;105_165_days;EpiVacCorona;268;96;364;30806;6299;37105
2021.11_01-07-2022;Чукотский автономный округ;105_165_days;SputnikLite;65;1;66;30806;6299;37105
2021.11_01-07-2022;Чукотский автономный округ;105_165_days;SputnikV;4185;641;4826;30806;6299;37105
2021.11_01-07-2022;Чукотский автономный округ;165_195_days;AllVaccines;2659;475;3134;30806;6299;37105
2021.11_01-07-2022;Чукотский автономный округ;165_195_days;EpiVacCorona;295;71;366;30806;6299;37105
2021.11_01-07-2022;Чукотский автономный округ;165_195_days;SputnikV;2364;404;2768;30806;6299;37105
2021.11_01-07-2022;Чукотский автономный округ;21_45_days;AllVaccines;2664;450;3114;30806;6299;37105
2021.11_01-07-2022;Чукотский автономный округ;21_45_days;CoviVac;79;13;92;30806;6299;37105
2021.11_01-07-2022;Чукотский автономный округ;21_45_days;SputnikLite;2435;404;2839;30806;6299;37105
2021.11_01-07-2022;Чукотский автономный округ;21_45_days;SputnikV;150;33;183;30806;6299;37105
2021.11_01-07-2022;Чукотский автономный округ;45_75_days;AllVaccines;1751;298;2049;30806;6299;37105
2021.11_01-07-2022;Чукотский автономный округ;45_75_days;CoviVac;212;13;225;30806;6299;37105
2021.11_01-07-2022;Чукотский автономный округ;45_75_days;SputnikLite;1087;199;1286;30806;6299;37105
2021.11_01-07-2022;Чукотский автономный округ;45_75_days;SputnikV;452;86;538;30806;6299;37105
2021.11_01-07-2022;Чукотский автономный округ;75_90_days;AllVaccines;935;107;1042;30806;6299;37105
2021.11_01-07-2022;Чукотский автономный округ;75_90_days;CoviVac;239;18;257;30806;6299;37105
2021.11_01-07-2022;Чукотский автономный округ;75_90_days;EpiVacCorona;1;1;2;30806;6299;37105
2021.11_01-07-2022;Чукотский автономный округ;75_90_days;SputnikLite;348;31;379;30806;6299;37105
2021.11_01-07-2022;Чукотский автономный округ;75_90_days;SputnikV;347;57;404;30806;6299;37105
2021.11_01-07-2022;Чукотский автономный округ;90_105_days;AllVaccines;1529;168;1697;30806;6299;37105
2021.11_01-07-2022;Чукотский автономный округ;90_105_days;CoviVac;254;23;277;30806;6299;37105
2021.11_01-07-2022;Чукотский автономный округ;90_105_days;EpiVacCorona;2;0;2;30806;6299;37105
2021.11_01-07-2022;Чукотский автономный округ;90_105_days;SputnikLite;178;21;199;30806;6299;37105
2021.11_01-07-2022;Чукотский автономный округ;90_105_days;SputnikV;1095;124;1219;30806;6299;37105
2021.11_01-07-2022;Ямало-Ненецкий автономный округ;105_165_days;AllVaccines;49538;4347;53885;346064;56429;402493
2021.11_01-07-2022;Ямало-Ненецкий автономный округ;105_165_days;CoviVac;761;113;874;346064;56429;402493
2021.11_01-07-2022;Ямало-Ненецкий автономный округ;105_165_days;EpiVacCorona;831;146;977;346064;56429;402493
2021.11_01-07-2022;Ямало-Ненецкий автономный округ;105_165_days;SputnikLite;239;15;254;346064;56429;402493
2021.11_01-07-2022;Ямало-Ненецкий автономный округ;105_165_days;SputnikV;47707;4073;51780;346064;56429;402493
2021.11_01-07-2022;Ямало-Ненецкий автономный округ;165_195_days;AllVaccines;26447;4278;30725;346064;56429;402493
2021.11_01-07-2022;Ямало-Ненецкий автономный округ;165_195_days;EpiVacCorona;4601;1003;5604;346064;56429;402493
2021.11_01-07-2022;Ямало-Ненецкий автономный округ;165_195_days;SputnikLite;1;1;2;346064;56429;402493
2021.11_01-07-2022;Ямало-Ненецкий автономный округ;165_195_days;SputnikV;21845;3274;25119;346064;56429;402493
2021.11_01-07-2022;Ямало-Ненецкий автономный округ;21_45_days;AllVaccines;18501;2221;20722;346064;56429;402493
2021.11_01-07-2022;Ямало-Ненецкий автономный округ;21_45_days;CoviVac;19;2;21;346064;56429;402493
2021.11_01-07-2022;Ямало-Ненецкий автономный округ;21_45_days;EpiVacCorona;46;1;47;346064;56429;402493
2021.11_01-07-2022;Ямало-Ненецкий автономный округ;21_45_days;SputnikLite;15965;1945;17910;346064;56429;402493
2021.11_01-07-2022;Ямало-Ненецкий автономный округ;21_45_days;SputnikV;2471;273;2744;346064;56429;402493
2021.11_01-07-2022;Ямало-Ненецкий автономный округ;45_75_days;AllVaccines;16099;1662;17761;346064;56429;402493
2021.11_01-07-2022;Ямало-Ненецкий автономный округ;45_75_days;CoviVac;66;2;68;346064;56429;402493
2021.11_01-07-2022;Ямало-Ненецкий автономный округ;45_75_days;EpiVacCorona;1;0;1;346064;56429;402493
2021.11_01-07-2022;Ямало-Ненецкий автономный округ;45_75_days;SputnikLite;10563;1098;11661;346064;56429;402493
2021.11_01-07-2022;Ямало-Ненецкий автономный округ;45_75_days;SputnikV;5469;562;6031;346064;56429;402493
2021.11_01-07-2022;Ямало-Ненецкий автономный округ;75_90_days;AllVaccines;15688;1077;16765;346064;56429;402493
2021.11_01-07-2022;Ямало-Ненецкий автономный округ;75_90_days;CoviVac;166;10;176;346064;56429;402493
2021.11_01-07-2022;Ямало-Ненецкий автономный округ;75_90_days;EpiVacCorona;27;8;35;346064;56429;402493
2021.11_01-07-2022;Ямало-Ненецкий автономный округ;75_90_days;SputnikLite;6992;484;7476;346064;56429;402493
2021.11_01-07-2022;Ямало-Ненецкий автономный округ;75_90_days;SputnikV;8503;575;9078;346064;56429;402493
2021.11_01-07-2022;Ямало-Ненецкий автономный округ;90_105_days;AllVaccines;16883;1117;18000;346064;56429;402493
2021.11_01-07-2022;Ямало-Ненецкий автономный округ;90_105_days;CoviVac;295;30;325;346064;56429;402493
2021.11_01-07-2022;Ямало-Ненецкий автономный округ;90_105_days;EpiVacCorona;59;2;61;346064;56429;402493
2021.11_01-07-2022;Ямало-Ненецкий автономный округ;90_105_days;SputnikLite;4293;188;4481;346064;56429;402493
2021.11_01-07-2022;Ямало-Ненецкий автономный округ;90_105_days;SputnikV;12236;897;13133;346064;56429;402493
2021.11_01-07-2022;Ярославская область;105_165_days;AllVaccines;69105;25227;94332;682586;317712;1000298
2021.11_01-07-2022;Ярославская область;105_165_days;CoviVac;1384;423;1807;682586;317712;1000298
2021.11_01-07-2022;Ярославская область;105_165_days;EpiVacCorona;4142;1829;5971;682586;317712;1000298
2021.11_01-07-2022;Ярославская область;105_165_days;SputnikLite;957;108;1065;682586;317712;1000298
2021.11_01-07-2022;Ярославская область;105_165_days;SputnikV;62622;22867;85489;682586;317712;1000298
2021.11_01-07-2022;Ярославская область;165_195_days;AllVaccines;15104;17439;32543;682586;317712;1000298
2021.11_01-07-2022;Ярославская область;165_195_days;CoviVac;2;0;2;682586;317712;1000298
2021.11_01-07-2022;Ярославская область;165_195_days;EpiVacCorona;50;31;81;682586;317712;1000298
2021.11_01-07-2022;Ярославская область;165_195_days;SputnikLite;1;0;1;682586;317712;1000298
2021.11_01-07-2022;Ярославская область;165_195_days;SputnikV;15051;17408;32459;682586;317712;1000298
2021.11_01-07-2022;Ярославская область;21_45_days;AllVaccines;23524;12605;36129;682586;317712;1000298
2021.11_01-07-2022;Ярославская область;21_45_days;CoviVac;50;7;57;682586;317712;1000298
2021.11_01-07-2022;Ярославская область;21_45_days;EpiVacCorona;122;49;171;682586;317712;1000298
2021.11_01-07-2022;Ярославская область;21_45_days;SputnikLite;15734;8458;24192;682586;317712;1000298
2021.11_01-07-2022;Ярославская область;21_45_days;SputnikV;7618;4091;11709;682586;317712;1000298
2021.11_01-07-2022;Ярославская область;45_75_days;AllVaccines;30164;13786;43950;682586;317712;1000298
2021.11_01-07-2022;Ярославская область;45_75_days;CoviVac;114;8;122;682586;317712;1000298
2021.11_01-07-2022;Ярославская область;45_75_days;EpiVacCorona;549;203;752;682586;317712;1000298
2021.11_01-07-2022;Ярославская область;45_75_days;SputnikLite;12175;6223;18398;682586;317712;1000298
2021.11_01-07-2022;Ярославская область;45_75_days;SputnikV;17326;7352;24678;682586;317712;1000298
2021.11_01-07-2022;Ярославская область;75_90_days;AllVaccines;40610;7976;48586;682586;317712;1000298
2021.11_01-07-2022;Ярославская область;75_90_days;CoviVac;272;26;298;682586;317712;1000298
2021.11_01-07-2022;Ярославская область;75_90_days;EpiVacCorona;1965;475;2440;682586;317712;1000298
2021.11_01-07-2022;Ярославская область;75_90_days;SputnikLite;13905;2162;16067;682586;317712;1000298
2021.11_01-07-2022;Ярославская область;75_90_days;SputnikV;24468;5313;29781;682586;317712;1000298
2021.11_01-07-2022;Ярославская область;90_105_days;AllVaccines;48835;8532;57367;682586;317712;1000298
2021.11_01-07-2022;Ярославская область;90_105_days;CoviVac;630;81;711;682586;317712;1000298
2021.11_01-07-2022;Ярославская область;90_105_days;EpiVacCorona;1017;207;1224;682586;317712;1000298
2021.11_01-07-2022;Ярославская область;90_105_days;SputnikLite;15436;1263;16699;682586;317712;1000298
2021.11_01-07-2022;Ярославская область;90_105_days;SputnikV;31752;6981;38733;682586;317712;1000298
2021.11_01-07-2022;г. Москва;105_165_days;AllVaccines;1737995;282013;2020008;7299088;3167729;10466817
2021.11_01-07-2022;г. Москва;105_165_days;CoviVac;48502;2986;51488;7299088;3167729;10466817
2021.11_01-07-2022;г. Москва;105_165_days;EpiVacCorona;84812;33401;118213;7299088;3167729;10466817
2021.11_01-07-2022;г. Москва;105_165_days;SputnikLite;221786;9464;231250;7299088;3167729;10466817
2021.11_01-07-2022;г. Москва;105_165_days;SputnikV;1382895;236162;1619057;7299088;3167729;10466817
2021.11_01-07-2022;г. Москва;165_195_days;AllVaccines;185943;118485;304428;7299088;3167729;10466817
2021.11_01-07-2022;г. Москва;165_195_days;CoviVac;1173;289;1462;7299088;3167729;10466817
2021.11_01-07-2022;г. Москва;165_195_days;EpiVacCorona;954;1008;1962;7299088;3167729;10466817
2021.11_01-07-2022;г. Москва;165_195_days;SputnikLite;8;3;11;7299088;3167729;10466817
2021.11_01-07-2022;г. Москва;165_195_days;SputnikV;183808;117185;300993;7299088;3167729;10466817
2021.11_01-07-2022;г. Москва;21_45_days;AllVaccines;163885;128934;292819;7299088;3167729;10466817
2021.11_01-07-2022;г. Москва;21_45_days;CoviVac;3574;719;4293;7299088;3167729;10466817
2021.11_01-07-2022;г. Москва;21_45_days;EpiVacCorona;1052;783;1835;7299088;3167729;10466817
2021.11_01-07-2022;г. Москва;21_45_days;SputnikLite;79811;80059;159870;7299088;3167729;10466817
2021.11_01-07-2022;г. Москва;21_45_days;SputnikV;79448;47373;126821;7299088;3167729;10466817
2021.11_01-07-2022;г. Москва;45_75_days;AllVaccines;223903;141387;365290;7299088;3167729;10466817
2021.11_01-07-2022;г. Москва;45_75_days;CoviVac;9353;1197;10550;7299088;3167729;10466817
2021.11_01-07-2022;г. Москва;45_75_days;EpiVacCorona;1390;866;2256;7299088;3167729;10466817
2021.11_01-07-2022;г. Москва;45_75_days;SputnikLite;55730;65714;121444;7299088;3167729;10466817
2021.11_01-07-2022;г. Москва;45_75_days;SputnikV;157430;73610;231040;7299088;3167729;10466817
2021.11_01-07-2022;г. Москва;75_90_days;AllVaccines;213700;63830;277530;7299088;3167729;10466817
2021.11_01-07-2022;г. Москва;75_90_days;CoviVac;8525;803;9328;7299088;3167729;10466817
2021.11_01-07-2022;г. Москва;75_90_days;EpiVacCorona;1191;419;1610;7299088;3167729;10466817
2021.11_01-07-2022;г. Москва;75_90_days;SputnikLite;28673;9857;38530;7299088;3167729;10466817
2021.11_01-07-2022;г. Москва;75_90_days;SputnikV;175311;52751;228062;7299088;3167729;10466817
2021.11_01-07-2022;г. Москва;90_105_days;AllVaccines;576713;83635;660348;7299088;3167729;10466817
2021.11_01-07-2022;г. Москва;90_105_days;CoviVac;10413;909;11322;7299088;3167729;10466817
2021.11_01-07-2022;г. Москва;90_105_days;EpiVacCorona;2657;577;3234;7299088;3167729;10466817
2021.11_01-07-2022;г. Москва;90_105_days;SputnikLite;37160;2753;39913;7299088;3167729;10466817
2021.11_01-07-2022;г. Москва;90_105_days;SputnikV;526483;79396;605879;7299088;3167729;10466817
2021.11_01-07-2022;г. Санкт-Петербург;105_165_days;AllVaccines;351975;93022;444997;3114778;1306302;4421080
2021.11_01-07-2022;г. Санкт-Петербург;105_165_days;CoviVac;18448;1011;19459;3114778;1306302;4421080
2021.11_01-07-2022;г. Санкт-Петербург;105_165_days;EpiVacCorona;7843;6603;14446;3114778;1306302;4421080
2021.11_01-07-2022;г. Санкт-Петербург;105_165_days;SputnikLite;4072;159;4231;3114778;1306302;4421080
2021.11_01-07-2022;г. Санкт-Петербург;105_165_days;SputnikV;321612;85249;406861;3114778;1306302;4421080
2021.11_01-07-2022;г. Санкт-Петербург;165_195_days;AllVaccines;81589;59575;141164;3114778;1306302;4421080
2021.11_01-07-2022;г. Санкт-Петербург;165_195_days;CoviVac;35;5;40;3114778;1306302;4421080
2021.11_01-07-2022;г. Санкт-Петербург;165_195_days;EpiVacCorona;5053;6136;11189;3114778;1306302;4421080
2021.11_01-07-2022;г. Санкт-Петербург;165_195_days;SputnikLite;7;22;29;3114778;1306302;4421080
2021.11_01-07-2022;г. Санкт-Петербург;165_195_days;SputnikV;76494;53412;129906;3114778;1306302;4421080
2021.11_01-07-2022;г. Санкт-Петербург;21_45_days;AllVaccines;155186;59836;215022;3114778;1306302;4421080
2021.11_01-07-2022;г. Санкт-Петербург;21_45_days;CoviVac;3812;263;4075;3114778;1306302;4421080
2021.11_01-07-2022;г. Санкт-Петербург;21_45_days;EpiVacCorona;119;70;189;3114778;1306302;4421080
2021.11_01-07-2022;г. Санкт-Петербург;21_45_days;SputnikLite;102211;39819;142030;3114778;1306302;4421080
2021.11_01-07-2022;г. Санкт-Петербург;21_45_days;SputnikV;49044;19684;68728;3114778;1306302;4421080
2021.11_01-07-2022;г. Санкт-Петербург;45_75_days;AllVaccines;195981;69889;265870;3114778;1306302;4421080
2021.11_01-07-2022;г. Санкт-Петербург;45_75_days;CoviVac;7348;375;7723;3114778;1306302;4421080
2021.11_01-07-2022;г. Санкт-Петербург;45_75_days;EpiVacCorona;628;293;921;3114778;1306302;4421080
2021.11_01-07-2022;г. Санкт-Петербург;45_75_days;SputnikLite;98734;32045;130779;3114778;1306302;4421080
2021.11_01-07-2022;г. Санкт-Петербург;45_75_days;SputnikV;89271;37176;126447;3114778;1306302;4421080
2021.11_01-07-2022;г. Санкт-Петербург;75_90_days;AllVaccines;156168;32652;188820;3114778;1306302;4421080
2021.11_01-07-2022;г. Санкт-Петербург;75_90_days;CoviVac;1959;87;2046;3114778;1306302;4421080
2021.11_01-07-2022;г. Санкт-Петербург;75_90_days;EpiVacCorona;622;257;879;3114778;1306302;4421080
2021.11_01-07-2022;г. Санкт-Петербург;75_90_days;SputnikLite;64216;7558;71774;3114778;1306302;4421080
2021.11_01-07-2022;г. Санкт-Петербург;75_90_days;SputnikV;89371;24750;114121;3114778;1306302;4421080
2021.11_01-07-2022;г. Санкт-Петербург;90_105_days;AllVaccines;234619;34281;268900;3114778;1306302;4421080
2021.11_01-07-2022;г. Санкт-Петербург;90_105_days;CoviVac;4052;170;4222;3114778;1306302;4421080
2021.11_01-07-2022;г. Санкт-Петербург;90_105_days;EpiVacCorona;644;240;884;3114778;1306302;4421080
2021.11_01-07-2022;г. Санкт-Петербург;90_105_days;SputnikLite;65150;1783;66933;3114778;1306302;4421080
2021.11_01-07-2022;г. Санкт-Петербург;90_105_days;SputnikV;164773;32088;196861;3114778;1306302;4421080
2021.11_01-07-2022;г. Севастополь;105_165_days;AllVaccines;33877;15260;49137;293051;116400;409451
2021.11_01-07-2022;г. Севастополь;105_165_days;CoviVac;741;248;989;293051;116400;409451
2021.11_01-07-2022;г. Севастополь;105_165_days;EpiVacCorona;1959;1515;3474;293051;116400;409451
2021.11_01-07-2022;г. Севастополь;105_165_days;SputnikLite;45;24;69;293051;116400;409451
2021.11_01-07-2022;г. Севастополь;105_165_days;SputnikV;31132;13473;44605;293051;116400;409451
2021.11_01-07-2022;г. Севастополь;165_195_days;AllVaccines;14658;14309;28967;293051;116400;409451
2021.11_01-07-2022;г. Севастополь;165_195_days;EpiVacCorona;2621;3351;5972;293051;116400;409451
2021.11_01-07-2022;г. Севастополь;165_195_days;SputnikV;12037;10958;22995;293051;116400;409451
2021.11_01-07-2022;г. Севастополь;21_45_days;AllVaccines;11329;5462;16791;293051;116400;409451
2021.11_01-07-2022;г. Севастополь;21_45_days;CoviVac;42;11;53;293051;116400;409451
2021.11_01-07-2022;г. Севастополь;21_45_days;EpiVacCorona;138;55;193;293051;116400;409451
2021.11_01-07-2022;г. Севастополь;21_45_days;SputnikLite;6524;4274;10798;293051;116400;409451
2021.11_01-07-2022;г. Севастополь;21_45_days;SputnikV;4625;1122;5747;293051;116400;409451
2021.11_01-07-2022;г. Севастополь;45_75_days;AllVaccines;7859;3531;11390;293051;116400;409451
2021.11_01-07-2022;г. Севастополь;45_75_days;CoviVac;68;19;87;293051;116400;409451
2021.11_01-07-2022;г. Севастополь;45_75_days;EpiVacCorona;196;110;306;293051;116400;409451
2021.11_01-07-2022;г. Севастополь;45_75_days;SputnikLite;1372;1783;3155;293051;116400;409451
2021.11_01-07-2022;г. Севастополь;45_75_days;SputnikV;6223;1619;7842;293051;116400;409451
2021.11_01-07-2022;г. Севастополь;75_90_days;AllVaccines;5819;1554;7373;293051;116400;409451
2021.11_01-07-2022;г. Севастополь;75_90_days;CoviVac;71;11;82;293051;116400;409451
2021.11_01-07-2022;г. Севастополь;75_90_days;EpiVacCorona;196;109;305;293051;116400;409451
2021.11_01-07-2022;г. Севастополь;75_90_days;SputnikLite;336;185;521;293051;116400;409451
2021.11_01-07-2022;г. Севастополь;75_90_days;SputnikV;5216;1249;6465;293051;116400;409451
2021.11_01-07-2022;г. Севастополь;90_105_days;AllVaccines;9952;2711;12663;293051;116400;409451
2021.11_01-07-2022;г. Севастополь;90_105_days;CoviVac;222;65;287;293051;116400;409451
2021.11_01-07-2022;г. Севастополь;90_105_days;EpiVacCorona;182;111;293;293051;116400;409451
2021.11_01-07-2022;г. Севастополь;90_105_days;SputnikLite;229;128;357;293051;116400;409451
2021.11_01-07-2022;г. Севастополь;90_105_days;SputnikV;9319;2407;11726;293051;116400;409451
2021.12_13-10-2022;Алтайский край;105_165_days;AllVaccines;203072;50679;253751;1240936;570412;1811348
2021.12_13-10-2022;Алтайский край;105_165_days;CoviVac;2596;232;2828;1240936;570412;1811348
2021.12_13-10-2022;Алтайский край;105_165_days;EpiVacCorona;4140;897;5037;1240936;570412;1811348
2021.12_13-10-2022;Алтайский край;105_165_days;SputnikLite;58279;15429;73708;1240936;570412;1811348
2021.12_13-10-2022;Алтайский край;105_165_days;SputnikV;138057;34121;172178;1240936;570412;1811348
2021.12_13-10-2022;Алтайский край;165_195_days;AllVaccines;98482;34718;133200;1240936;570412;1811348
2021.12_13-10-2022;Алтайский край;165_195_days;CoviVac;447;120;567;1240936;570412;1811348
2021.12_13-10-2022;Алтайский край;165_195_days;EpiVacCorona;1296;409;1705;1240936;570412;1811348
2021.12_13-10-2022;Алтайский край;165_195_days;SputnikLite;1167;101;1268;1240936;570412;1811348
2021.12_13-10-2022;Алтайский край;165_195_days;SputnikV;95572;34088;129660;1240936;570412;1811348
2021.12_13-10-2022;Алтайский край;21_45_days;AllVaccines;97156;60689;157845;1240936;570412;1811348
2021.12_13-10-2022;Алтайский край;21_45_days;CoviVac;1251;230;1481;1240936;570412;1811348
2021.12_13-10-2022;Алтайский край;21_45_days;EpiVacCorona;4653;2067;6720;1240936;570412;1811348
2021.12_13-10-2022;Алтайский край;21_45_days;SputnikLite;25925;22214;48139;1240936;570412;1811348
2021.12_13-10-2022;Алтайский край;21_45_days;SputnikV;65327;36178;101505;1240936;570412;1811348
2021.12_13-10-2022;Алтайский край;45_75_days;AllVaccines;92588;54350;146938;1240936;570412;1811348
2021.12_13-10-2022;Алтайский край;45_75_days;CoviVac;2011;438;2449;1240936;570412;1811348
2021.12_13-10-2022;Алтайский край;45_75_days;EpiVacCorona;7592;3850;11442;1240936;570412;1811348
2021.12_13-10-2022;Алтайский край;45_75_days;SputnikLite;34854;22201;57055;1240936;570412;1811348
2021.12_13-10-2022;Алтайский край;45_75_days;SputnikV;48131;27861;75992;1240936;570412;1811348
2021.12_13-10-2022;Алтайский край;75_90_days;AllVaccines;29051;17726;46777;1240936;570412;1811348
2021.12_13-10-2022;Алтайский край;75_90_days;CoviVac;133;36;169;1240936;570412;1811348
2021.12_13-10-2022;Алтайский край;75_90_days;EpiVacCorona;234;124;358;1240936;570412;1811348
2021.12_13-10-2022;Алтайский край;75_90_days;SputnikLite;22133;12798;34931;1240936;570412;1811348
2021.12_13-10-2022;Алтайский край;75_90_days;SputnikV;6551;4768;11319;1240936;570412;1811348
2021.12_13-10-2022;Алтайский край;90_105_days;AllVaccines;15193;10477;25670;1240936;570412;1811348
2021.12_13-10-2022;Алтайский край;90_105_days;CoviVac;125;37;162;1240936;570412;1811348
2021.12_13-10-2022;Алтайский край;90_105_days;EpiVacCorona;151;73;224;1240936;570412;1811348
2021.12_13-10-2022;Алтайский край;90_105_days;SputnikLite;8291;6999;15290;1240936;570412;1811348
2021.12_13-10-2022;Алтайский край;90_105_days;SputnikV;6626;3368;9994;1240936;570412;1811348
2021.12_13-10-2022;Амурская область;105_165_days;AllVaccines;89123;16446;105569;444961;159780;604741
2021.12_13-10-2022;Амурская область;105_165_days;CoviVac;324;99;423;444961;159780;604741
2021.12_13-10-2022;Амурская область;105_165_days;EpiVacCorona;1112;296;1408;444961;159780;604741
2021.12_13-10-2022;Амурская область;105_165_days;SputnikLite;29164;7019;36183;444961;159780;604741
2021.12_13-10-2022;Амурская область;105_165_days;SputnikV;58523;9032;67555;444961;159780;604741
2021.12_13-10-2022;Амурская область;165_195_days;AllVaccines;49988;10363;60351;444961;159780;604741
2021.12_13-10-2022;Амурская область;165_195_days;CoviVac;277;8;285;444961;159780;604741
2021.12_13-10-2022;Амурская область;165_195_days;EpiVacCorona;225;84;309;444961;159780;604741
2021.12_13-10-2022;Амурская область;165_195_days;SputnikLite;3276;17;3293;444961;159780;604741
2021.12_13-10-2022;Амурская область;165_195_days;SputnikV;46210;10254;56464;444961;159780;604741
2021.12_13-10-2022;Амурская область;21_45_days;AllVaccines;41364;13892;55256;444961;159780;604741
2021.12_13-10-2022;Амурская область;21_45_days;CoviVac;308;105;413;444961;159780;604741
2021.12_13-10-2022;Амурская область;21_45_days;EpiVacCorona;3034;1114;4148;444961;159780;604741
2021.12_13-10-2022;Амурская область;21_45_days;SputnikLite;9466;5197;14663;444961;159780;604741
2021.12_13-10-2022;Амурская область;21_45_days;SputnikV;28556;7476;36032;444961;159780;604741
2021.12_13-10-2022;Амурская область;45_75_days;AllVaccines;45348;18483;63831;444961;159780;604741
2021.12_13-10-2022;Амурская область;45_75_days;CoviVac;1229;337;1566;444961;159780;604741
2021.12_13-10-2022;Амурская область;45_75_days;EpiVacCorona;3315;1436;4751;444961;159780;604741
2021.12_13-10-2022;Амурская область;45_75_days;SputnikLite;16469;8784;25253;444961;159780;604741
2021.12_13-10-2022;Амурская область;45_75_days;SputnikV;24335;7926;32261;444961;159780;604741
2021.12_13-10-2022;Амурская область;75_90_days;AllVaccines;12190;5184;17374;444961;159780;604741
2021.12_13-10-2022;Амурская область;75_90_days;CoviVac;163;58;221;444961;159780;604741
2021.12_13-10-2022;Амурская область;75_90_days;EpiVacCorona;120;46;166;444961;159780;604741
2021.12_13-10-2022;Амурская область;75_90_days;SputnikLite;8143;3779;11922;444961;159780;604741
2021.12_13-10-2022;Амурская область;75_90_days;SputnikV;3764;1301;5065;444961;159780;604741
2021.12_13-10-2022;Амурская область;90_105_days;AllVaccines;8356;3750;12106;444961;159780;604741
2021.12_13-10-2022;Амурская область;90_105_days;CoviVac;107;37;144;444961;159780;604741
2021.12_13-10-2022;Амурская область;90_105_days;EpiVacCorona;31;19;50;444961;159780;604741
2021.12_13-10-2022;Амурская область;90_105_days;SputnikLite;5020;2886;7906;444961;159780;604741
2021.12_13-10-2022;Амурская область;90_105_days;SputnikV;3198;808;4006;444961;159780;604741
2021.12_13-10-2022;Архангельская область;105_165_days;AllVaccines;106308;29995;136303;595439;264499;859938
2021.12_13-10-2022;Архангельская область;105_165_days;CoviVac;624;71;695;595439;264499;859938
2021.12_13-10-2022;Архангельская область;105_165_days;EpiVacCorona;2664;807;3471;595439;264499;859938
2021.12_13-10-2022;Архангельская область;105_165_days;SputnikLite;25435;8313;33748;595439;264499;859938
2021.12_13-10-2022;Архангельская область;105_165_days;SputnikV;77585;20804;98389;595439;264499;859938
2021.12_13-10-2022;Архангельская область;165_195_days;AllVaccines;42080;13654;55734;595439;264499;859938
2021.12_13-10-2022;Архангельская область;165_195_days;CoviVac;584;60;644;595439;264499;859938
2021.12_13-10-2022;Архангельская область;165_195_days;EpiVacCorona;1105;202;1307;595439;264499;859938
2021.12_13-10-2022;Архангельская область;165_195_days;SputnikLite;1918;138;2056;595439;264499;859938
2021.12_13-10-2022;Архангельская область;165_195_days;SputnikV;38473;13254;51727;595439;264499;859938
2021.12_13-10-2022;Архангельская область;21_45_days;AllVaccines;44337;31096;75433;595439;264499;859938
2021.12_13-10-2022;Архангельская область;21_45_days;CoviVac;740;102;842;595439;264499;859938
2021.12_13-10-2022;Архангельская область;21_45_days;EpiVacCorona;2550;1311;3861;595439;264499;859938
2021.12_13-10-2022;Архангельская область;21_45_days;SputnikLite;13291;12298;25589;595439;264499;859938
2021.12_13-10-2022;Архангельская область;21_45_days;SputnikV;27756;17385;45141;595439;264499;859938
2021.12_13-10-2022;Архангельская область;45_75_days;AllVaccines;53264;26914;80178;595439;264499;859938
2021.12_13-10-2022;Архангельская область;45_75_days;CoviVac;1011;192;1203;595439;264499;859938
2021.12_13-10-2022;Архангельская область;45_75_days;EpiVacCorona;3462;1359;4821;595439;264499;859938
2021.12_13-10-2022;Архангельская область;45_75_days;SputnikLite;19532;12197;31729;595439;264499;859938
2021.12_13-10-2022;Архангельская область;45_75_days;SputnikV;29259;13166;42425;595439;264499;859938
2021.12_13-10-2022;Архангельская область;75_90_days;AllVaccines;27164;10703;37867;595439;264499;859938
2021.12_13-10-2022;Архангельская область;75_90_days;CoviVac;163;36;199;595439;264499;859938
2021.12_13-10-2022;Архангельская область;75_90_days;EpiVacCorona;125;30;155;595439;264499;859938
2021.12_13-10-2022;Архангельская область;75_90_days;SputnikLite;22274;8330;30604;595439;264499;859938
2021.12_13-10-2022;Архангельская область;75_90_days;SputnikV;4602;2307;6909;595439;264499;859938
2021.12_13-10-2022;Архангельская область;90_105_days;AllVaccines;13331;6432;19763;595439;264499;859938
2021.12_13-10-2022;Архангельская область;90_105_days;CoviVac;89;25;114;595439;264499;859938
2021.12_13-10-2022;Архангельская область;90_105_days;EpiVacCorona;71;26;97;595439;264499;859938
2021.12_13-10-2022;Архангельская область;90_105_days;SputnikLite;9415;4742;14157;595439;264499;859938
2021.12_13-10-2022;Архангельская область;90_105_days;SputnikV;3756;1639;5395;595439;264499;859938
2021.12_13-10-2022;Астраханская область;105_165_days;AllVaccines;86725;18029;104754;550968;219749;770717
2021.12_13-10-2022;Астраханская область;105_165_days;CoviVac;423;121;544;550968;219749;770717
2021.12_13-10-2022;Астраханская область;105_165_days;EpiVacCorona;1167;460;1627;550968;219749;770717
2021.12_13-10-2022;Астраханская область;105_165_days;SputnikLite;14155;4230;18385;550968;219749;770717
2021.12_13-10-2022;Астраханская область;105_165_days;SputnikV;70980;13218;84198;550968;219749;770717
2021.12_13-10-2022;Астраханская область;165_195_days;AllVaccines;70290;13345;83635;550968;219749;770717
2021.12_13-10-2022;Астраханская область;165_195_days;CoviVac;294;58;352;550968;219749;770717
2021.12_13-10-2022;Астраханская область;165_195_days;EpiVacCorona;3126;626;3752;550968;219749;770717
2021.12_13-10-2022;Астраханская область;165_195_days;SputnikLite;172;9;181;550968;219749;770717
2021.12_13-10-2022;Астраханская область;165_195_days;SputnikV;66698;12652;79350;550968;219749;770717
2021.12_13-10-2022;Астраханская область;21_45_days;AllVaccines;40780;14924;55704;550968;219749;770717
2021.12_13-10-2022;Астраханская область;21_45_days;CoviVac;645;216;861;550968;219749;770717
2021.12_13-10-2022;Астраханская область;21_45_days;EpiVacCorona;2644;956;3600;550968;219749;770717
2021.12_13-10-2022;Астраханская область;21_45_days;SputnikLite;11819;5756;17575;550968;219749;770717
2021.12_13-10-2022;Астраханская область;21_45_days;SputnikV;25672;7996;33668;550968;219749;770717
2021.12_13-10-2022;Астраханская область;45_75_days;AllVaccines;47028;17728;64756;550968;219749;770717
2021.12_13-10-2022;Астраханская область;45_75_days;CoviVac;517;224;741;550968;219749;770717
2021.12_13-10-2022;Астраханская область;45_75_days;EpiVacCorona;2100;747;2847;550968;219749;770717
2021.12_13-10-2022;Астраханская область;45_75_days;SputnikLite;17539;8672;26211;550968;219749;770717
2021.12_13-10-2022;Астраханская область;45_75_days;SputnikV;26872;8085;34957;550968;219749;770717
2021.12_13-10-2022;Астраханская область;75_90_days;AllVaccines;19015;6667;25682;550968;219749;770717
2021.12_13-10-2022;Астраханская область;75_90_days;CoviVac;98;58;156;550968;219749;770717
2021.12_13-10-2022;Астраханская область;75_90_days;EpiVacCorona;189;85;274;550968;219749;770717
2021.12_13-10-2022;Астраханская область;75_90_days;SputnikLite;13964;5248;19212;550968;219749;770717
2021.12_13-10-2022;Астраханская область;75_90_days;SputnikV;4764;1276;6040;550968;219749;770717
2021.12_13-10-2022;Астраханская область;90_105_days;AllVaccines;8131;3375;11506;550968;219749;770717
2021.12_13-10-2022;Астраханская область;90_105_days;CoviVac;103;38;141;550968;219749;770717
2021.12_13-10-2022;Астраханская область;90_105_days;EpiVacCorona;132;74;206;550968;219749;770717
2021.12_13-10-2022;Астраханская область;90_105_days;SputnikLite;3878;2138;6016;550968;219749;770717
2021.12_13-10-2022;Астраханская область;90_105_days;SputnikV;4018;1125;5143;550968;219749;770717
2021.12_13-10-2022;Белгородская область;105_165_days;AllVaccines;146161;44752;190913;867731;383871;1251602
2021.12_13-10-2022;Белгородская область;105_165_days;CoviVac;2531;548;3079;867731;383871;1251602
2021.12_13-10-2022;Белгородская область;105_165_days;EpiVacCorona;3089;1275;4364;867731;383871;1251602
2021.12_13-10-2022;Белгородская область;105_165_days;SputnikLite;25636;12563;38199;867731;383871;1251602
2021.12_13-10-2022;Белгородская область;105_165_days;SputnikV;114905;30366;145271;867731;383871;1251602
2021.12_13-10-2022;Белгородская область;165_195_days;AllVaccines;159748;31894;191642;867731;383871;1251602
2021.12_13-10-2022;Белгородская область;165_195_days;CoviVac;167;25;192;867731;383871;1251602
2021.12_13-10-2022;Белгородская область;165_195_days;EpiVacCorona;15235;3580;18815;867731;383871;1251602
2021.12_13-10-2022;Белгородская область;165_195_days;SputnikLite;1084;161;1245;867731;383871;1251602
2021.12_13-10-2022;Белгородская область;165_195_days;SputnikV;143262;28128;171390;867731;383871;1251602
2021.12_13-10-2022;Белгородская область;21_45_days;AllVaccines;91994;38928;130922;867731;383871;1251602
2021.12_13-10-2022;Белгородская область;21_45_days;CoviVac;500;191;691;867731;383871;1251602
2021.12_13-10-2022;Белгородская область;21_45_days;EpiVacCorona;732;346;1078;867731;383871;1251602
2021.12_13-10-2022;Белгородская область;21_45_days;SputnikLite;34591;19472;54063;867731;383871;1251602
2021.12_13-10-2022;Белгородская область;21_45_days;SputnikV;56171;18919;75090;867731;383871;1251602
2021.12_13-10-2022;Белгородская область;45_75_days;AllVaccines;93762;48807;142569;867731;383871;1251602
2021.12_13-10-2022;Белгородская область;45_75_days;CoviVac;994;378;1372;867731;383871;1251602
2021.12_13-10-2022;Белгородская область;45_75_days;EpiVacCorona;1417;677;2094;867731;383871;1251602
2021.12_13-10-2022;Белгородская область;45_75_days;SputnikLite;43913;27341;71254;867731;383871;1251602
2021.12_13-10-2022;Белгородская область;45_75_days;SputnikV;47438;20411;67849;867731;383871;1251602
2021.12_13-10-2022;Белгородская область;75_90_days;AllVaccines;34892;22405;57297;867731;383871;1251602
2021.12_13-10-2022;Белгородская область;75_90_days;CoviVac;203;84;287;867731;383871;1251602
2021.12_13-10-2022;Белгородская область;75_90_days;EpiVacCorona;193;92;285;867731;383871;1251602
2021.12_13-10-2022;Белгородская область;75_90_days;SputnikLite;27897;18702;46599;867731;383871;1251602
2021.12_13-10-2022;Белгородская область;75_90_days;SputnikV;6599;3527;10126;867731;383871;1251602
2021.12_13-10-2022;Белгородская область;90_105_days;AllVaccines;16591;12383;28974;867731;383871;1251602
2021.12_13-10-2022;Белгородская область;90_105_days;CoviVac;221;77;298;867731;383871;1251602
2021.12_13-10-2022;Белгородская область;90_105_days;EpiVacCorona;105;54;159;867731;383871;1251602
2021.12_13-10-2022;Белгородская область;90_105_days;SputnikLite;10295;9281;19576;867731;383871;1251602
2021.12_13-10-2022;Белгородская область;90_105_days;SputnikV;5970;2971;8941;867731;383871;1251602
2021.12_13-10-2022;Брянская область;105_165_days;AllVaccines;94577;24745;119322;659625;298625;958250
2021.12_13-10-2022;Брянская область;105_165_days;CoviVac;656;166;822;659625;298625;958250
2021.12_13-10-2022;Брянская область;105_165_days;EpiVacCorona;1071;361;1432;659625;298625;958250
2021.12_13-10-2022;Брянская область;105_165_days;SputnikLite;22033;7154;29187;659625;298625;958250
2021.12_13-10-2022;Брянская область;105_165_days;SputnikV;70817;17064;87881;659625;298625;958250
2021.12_13-10-2022;Брянская область;165_195_days;AllVaccines;72057;19378;91435;659625;298625;958250
2021.12_13-10-2022;Брянская область;165_195_days;CoviVac;397;86;483;659625;298625;958250
2021.12_13-10-2022;Брянская область;165_195_days;EpiVacCorona;60;24;84;659625;298625;958250
2021.12_13-10-2022;Брянская область;165_195_days;SputnikLite;8;2;10;659625;298625;958250
2021.12_13-10-2022;Брянская область;165_195_days;SputnikV;71592;19266;90858;659625;298625;958250
2021.12_13-10-2022;Брянская область;21_45_days;AllVaccines;46661;28215;74876;659625;298625;958250
2021.12_13-10-2022;Брянская область;21_45_days;CoviVac;1044;279;1323;659625;298625;958250
2021.12_13-10-2022;Брянская область;21_45_days;EpiVacCorona;3830;1870;5700;659625;298625;958250
2021.12_13-10-2022;Брянская область;21_45_days;SputnikLite;11604;10188;21792;659625;298625;958250
2021.12_13-10-2022;Брянская область;21_45_days;SputnikV;30183;15878;46061;659625;298625;958250
2021.12_13-10-2022;Брянская область;45_75_days;AllVaccines;50790;31485;82275;659625;298625;958250
2021.12_13-10-2022;Брянская область;45_75_days;CoviVac;1247;355;1602;659625;298625;958250
2021.12_13-10-2022;Брянская область;45_75_days;EpiVacCorona;4117;1792;5909;659625;298625;958250
2021.12_13-10-2022;Брянская область;45_75_days;SputnikLite;15552;12081;27633;659625;298625;958250
2021.12_13-10-2022;Брянская область;45_75_days;SputnikV;29874;17257;47131;659625;298625;958250
2021.12_13-10-2022;Брянская область;75_90_days;AllVaccines;21543;10742;32285;659625;298625;958250
2021.12_13-10-2022;Брянская область;75_90_days;CoviVac;76;22;98;659625;298625;958250
2021.12_13-10-2022;Брянская область;75_90_days;EpiVacCorona;148;103;251;659625;298625;958250
2021.12_13-10-2022;Брянская область;75_90_days;SputnikLite;11286;7624;18910;659625;298625;958250
2021.12_13-10-2022;Брянская область;75_90_days;SputnikV;10033;2993;13026;659625;298625;958250
2021.12_13-10-2022;Брянская область;90_105_days;AllVaccines;14619;7430;22049;659625;298625;958250
2021.12_13-10-2022;Брянская область;90_105_days;CoviVac;100;23;123;659625;298625;958250
2021.12_13-10-2022;Брянская область;90_105_days;EpiVacCorona;53;17;70;659625;298625;958250
2021.12_13-10-2022;Брянская область;90_105_days;SputnikLite;9388;5776;15164;659625;298625;958250
2021.12_13-10-2022;Брянская область;90_105_days;SputnikV;5078;1614;6692;659625;298625;958250
2021.12_13-10-2022;Владимирская область;105_165_days;AllVaccines;109537;33147;142684;739166;354521;1093687
2021.12_13-10-2022;Владимирская область;105_165_days;CoviVac;1286;251;1537;739166;354521;1093687
2021.12_13-10-2022;Владимирская область;105_165_days;EpiVacCorona;1979;642;2621;739166;354521;1093687
2021.12_13-10-2022;Владимирская область;105_165_days;SputnikLite;39604;13646;53250;739166;354521;1093687
2021.12_13-10-2022;Владимирская область;105_165_days;SputnikV;66668;18608;85276;739166;354521;1093687
2021.12_13-10-2022;Владимирская область;165_195_days;AllVaccines;46403;13147;59550;739166;354521;1093687
2021.12_13-10-2022;Владимирская область;165_195_days;CoviVac;1020;202;1222;739166;354521;1093687
2021.12_13-10-2022;Владимирская область;165_195_days;EpiVacCorona;323;182;505;739166;354521;1093687
2021.12_13-10-2022;Владимирская область;165_195_days;SputnikLite;667;66;733;739166;354521;1093687
2021.12_13-10-2022;Владимирская область;165_195_days;SputnikV;44393;12697;57090;739166;354521;1093687
2021.12_13-10-2022;Владимирская область;21_45_days;AllVaccines;58309;29231;87540;739166;354521;1093687
2021.12_13-10-2022;Владимирская область;21_45_days;CoviVac;723;209;932;739166;354521;1093687
2021.12_13-10-2022;Владимирская область;21_45_days;EpiVacCorona;3799;2154;5953;739166;354521;1093687
2021.12_13-10-2022;Владимирская область;21_45_days;SputnikLite;15398;11103;26501;739166;354521;1093687
2021.12_13-10-2022;Владимирская область;21_45_days;SputnikV;38389;15765;54154;739166;354521;1093687
2021.12_13-10-2022;Владимирская область;45_75_days;AllVaccines;68070;35360;103430;739166;354521;1093687
2021.12_13-10-2022;Владимирская область;45_75_days;CoviVac;1688;381;2069;739166;354521;1093687
2021.12_13-10-2022;Владимирская область;45_75_days;EpiVacCorona;3341;1660;5001;739166;354521;1093687
2021.12_13-10-2022;Владимирская область;45_75_days;SputnikLite;30635;18915;49550;739166;354521;1093687
2021.12_13-10-2022;Владимирская область;45_75_days;SputnikV;32406;14404;46810;739166;354521;1093687
2021.12_13-10-2022;Владимирская область;75_90_days;AllVaccines;19044;11461;30505;739166;354521;1093687
2021.12_13-10-2022;Владимирская область;75_90_days;CoviVac;34;13;47;739166;354521;1093687
2021.12_13-10-2022;Владимирская область;75_90_days;EpiVacCorona;162;88;250;739166;354521;1093687
2021.12_13-10-2022;Владимирская область;75_90_days;SputnikLite;14164;8755;22919;739166;354521;1093687
2021.12_13-10-2022;Владимирская область;75_90_days;SputnikV;4684;2605;7289;739166;354521;1093687
2021.12_13-10-2022;Владимирская область;90_105_days;AllVaccines;9706;6636;16342;739166;354521;1093687
2021.12_13-10-2022;Владимирская область;90_105_days;CoviVac;47;8;55;739166;354521;1093687
2021.12_13-10-2022;Владимирская область;90_105_days;EpiVacCorona;81;58;139;739166;354521;1093687
2021.12_13-10-2022;Владимирская область;90_105_days;SputnikLite;5293;4717;10010;739166;354521;1093687
2021.12_13-10-2022;Владимирская область;90_105_days;SputnikV;4285;1853;6138;739166;354521;1093687
2021.12_13-10-2022;Волгоградская область;105_165_days;AllVaccines;262474;58010;320484;1387837;615020;2002857
2021.12_13-10-2022;Волгоградская область;105_165_days;CoviVac;3898;504;4402;1387837;615020;2002857
2021.12_13-10-2022;Волгоградская область;105_165_days;EpiVacCorona;5786;1608;7394;1387837;615020;2002857
2021.12_13-10-2022;Волгоградская область;105_165_days;SputnikLite;69288;19766;89054;1387837;615020;2002857
2021.12_13-10-2022;Волгоградская область;105_165_days;SputnikV;183502;36132;219634;1387837;615020;2002857
2021.12_13-10-2022;Волгоградская область;165_195_days;AllVaccines;149065;36455;185520;1387837;615020;2002857
2021.12_13-10-2022;Волгоградская область;165_195_days;CoviVac;5629;711;6340;1387837;615020;2002857
2021.12_13-10-2022;Волгоградская область;165_195_days;EpiVacCorona;3627;1344;4971;1387837;615020;2002857
2021.12_13-10-2022;Волгоградская область;165_195_days;SputnikLite;1021;192;1213;1387837;615020;2002857
2021.12_13-10-2022;Волгоградская область;165_195_days;SputnikV;138788;34208;172996;1387837;615020;2002857
2021.12_13-10-2022;Волгоградская область;21_45_days;AllVaccines;116942;67923;184865;1387837;615020;2002857
2021.12_13-10-2022;Волгоградская область;21_45_days;CoviVac;690;206;896;1387837;615020;2002857
2021.12_13-10-2022;Волгоградская область;21_45_days;EpiVacCorona;2504;1231;3735;1387837;615020;2002857
2021.12_13-10-2022;Волгоградская область;21_45_days;SputnikLite;36739;25476;62215;1387837;615020;2002857
2021.12_13-10-2022;Волгоградская область;21_45_days;SputnikV;77009;41010;118019;1387837;615020;2002857
2021.12_13-10-2022;Волгоградская область;45_75_days;AllVaccines;128621;67851;196472;1387837;615020;2002857
2021.12_13-10-2022;Волгоградская область;45_75_days;CoviVac;636;189;825;1387837;615020;2002857
2021.12_13-10-2022;Волгоградская область;45_75_days;EpiVacCorona;3618;1581;5199;1387837;615020;2002857
2021.12_13-10-2022;Волгоградская область;45_75_days;SputnikLite;27028;17598;44626;1387837;615020;2002857
2021.12_13-10-2022;Волгоградская область;45_75_days;SputnikV;97339;48483;145822;1387837;615020;2002857
2021.12_13-10-2022;Волгоградская область;75_90_days;AllVaccines;33958;18721;52679;1387837;615020;2002857
2021.12_13-10-2022;Волгоградская область;75_90_days;CoviVac;210;107;317;1387837;615020;2002857
2021.12_13-10-2022;Волгоградская область;75_90_days;EpiVacCorona;542;242;784;1387837;615020;2002857
2021.12_13-10-2022;Волгоградская область;75_90_days;SputnikLite;22463;12984;35447;1387837;615020;2002857
2021.12_13-10-2022;Волгоградская область;75_90_days;SputnikV;10743;5388;16131;1387837;615020;2002857
2021.12_13-10-2022;Волгоградская область;90_105_days;AllVaccines;22831;13612;36443;1387837;615020;2002857
2021.12_13-10-2022;Волгоградская область;90_105_days;CoviVac;284;82;366;1387837;615020;2002857
2021.12_13-10-2022;Волгоградская область;90_105_days;EpiVacCorona;291;83;374;1387837;615020;2002857
2021.12_13-10-2022;Волгоградская область;90_105_days;SputnikLite;12941;9264;22205;1387837;615020;2002857
2021.12_13-10-2022;Волгоградская область;90_105_days;SputnikV;9315;4183;13498;1387837;615020;2002857
2021.12_13-10-2022;Вологодская область;105_165_days;AllVaccines;85785;26439;112224;628100;275171;903271
2021.12_13-10-2022;Вологодская область;105_165_days;CoviVac;516;55;571;628100;275171;903271
2021.12_13-10-2022;Вологодская область;105_165_days;EpiVacCorona;717;504;1221;628100;275171;903271
2021.12_13-10-2022;Вологодская область;105_165_days;SputnikLite;40957;9311;50268;628100;275171;903271
2021.12_13-10-2022;Вологодская область;105_165_days;SputnikV;43595;16569;60164;628100;275171;903271
2021.12_13-10-2022;Вологодская область;165_195_days;AllVaccines;41915;12593;54508;628100;275171;903271
2021.12_13-10-2022;Вологодская область;165_195_days;CoviVac;166;27;193;628100;275171;903271
2021.12_13-10-2022;Вологодская область;165_195_days;EpiVacCorona;58;54;112;628100;275171;903271
2021.12_13-10-2022;Вологодская область;165_195_days;SputnikLite;1750;44;1794;628100;275171;903271
2021.12_13-10-2022;Вологодская область;165_195_days;SputnikV;39941;12468;52409;628100;275171;903271
2021.12_13-10-2022;Вологодская область;21_45_days;AllVaccines;65569;31054;96623;628100;275171;903271
2021.12_13-10-2022;Вологодская область;21_45_days;CoviVac;1591;258;1849;628100;275171;903271
2021.12_13-10-2022;Вологодская область;21_45_days;EpiVacCorona;2662;957;3619;628100;275171;903271
2021.12_13-10-2022;Вологодская область;21_45_days;SputnikLite;13137;11095;24232;628100;275171;903271
2021.12_13-10-2022;Вологодская область;21_45_days;SputnikV;48179;18744;66923;628100;275171;903271
2021.12_13-10-2022;Вологодская область;45_75_days;AllVaccines;46999;27228;74227;628100;275171;903271
2021.12_13-10-2022;Вологодская область;45_75_days;CoviVac;1581;256;1837;628100;275171;903271
2021.12_13-10-2022;Вологодская область;45_75_days;EpiVacCorona;1883;872;2755;628100;275171;903271
2021.12_13-10-2022;Вологодская область;45_75_days;SputnikLite;13952;8644;22596;628100;275171;903271
2021.12_13-10-2022;Вологодская область;45_75_days;SputnikV;29583;17456;47039;628100;275171;903271
2021.12_13-10-2022;Вологодская область;75_90_days;AllVaccines;27941;10103;38044;628100;275171;903271
2021.12_13-10-2022;Вологодская область;75_90_days;CoviVac;18;0;18;628100;275171;903271
2021.12_13-10-2022;Вологодская область;75_90_days;EpiVacCorona;57;37;94;628100;275171;903271
2021.12_13-10-2022;Вологодская область;75_90_days;SputnikLite;24751;7316;32067;628100;275171;903271
2021.12_13-10-2022;Вологодская область;75_90_days;SputnikV;3115;2750;5865;628100;275171;903271
2021.12_13-10-2022;Вологодская область;90_105_days;AllVaccines;21929;7303;29232;628100;275171;903271
2021.12_13-10-2022;Вологодская область;90_105_days;CoviVac;5;1;6;628100;275171;903271
2021.12_13-10-2022;Вологодская область;90_105_days;EpiVacCorona;24;13;37;628100;275171;903271
2021.12_13-10-2022;Вологодская область;90_105_days;SputnikLite;19718;5616;25334;628100;275171;903271
2021.12_13-10-2022;Вологодская область;90_105_days;SputnikV;2182;1673;3855;628100;275171;903271
2021.12_13-10-2022;Воронежская область;105_165_days;AllVaccines;179267;61550;240817;1293123;602333;1895456
2021.12_13-10-2022;Воронежская область;105_165_days;CoviVac;3608;958;4566;1293123;602333;1895456
2021.12_13-10-2022;Воронежская область;105_165_days;EpiVacCorona;4090;1802;5892;1293123;602333;1895456
2021.12_13-10-2022;Воронежская область;105_165_days;SputnikLite;50998;27811;78809;1293123;602333;1895456
2021.12_13-10-2022;Воронежская область;105_165_days;SputnikV;120571;30979;151550;1293123;602333;1895456
2021.12_13-10-2022;Воронежская область;165_195_days;AllVaccines;115438;26729;142167;1293123;602333;1895456
2021.12_13-10-2022;Воронежская область;165_195_days;CoviVac;1682;359;2041;1293123;602333;1895456
2021.12_13-10-2022;Воронежская область;165_195_days;EpiVacCorona;1409;473;1882;1293123;602333;1895456
2021.12_13-10-2022;Воронежская область;165_195_days;SputnikLite;715;150;865;1293123;602333;1895456
2021.12_13-10-2022;Воронежская область;165_195_days;SputnikV;111632;25747;137379;1293123;602333;1895456
2021.12_13-10-2022;Воронежская область;21_45_days;AllVaccines;102569;49732;152301;1293123;602333;1895456
2021.12_13-10-2022;Воронежская область;21_45_days;CoviVac;459;121;580;1293123;602333;1895456
2021.12_13-10-2022;Воронежская область;21_45_days;EpiVacCorona;4541;2235;6776;1293123;602333;1895456
2021.12_13-10-2022;Воронежская область;21_45_days;SputnikLite;24652;20157;44809;1293123;602333;1895456
2021.12_13-10-2022;Воронежская область;21_45_days;SputnikV;72917;27219;100136;1293123;602333;1895456
2021.12_13-10-2022;Воронежская область;45_75_days;AllVaccines;168733;63095;231828;1293123;602333;1895456
2021.12_13-10-2022;Воронежская область;45_75_days;CoviVac;995;300;1295;1293123;602333;1895456
2021.12_13-10-2022;Воронежская область;45_75_days;EpiVacCorona;5702;2137;7839;1293123;602333;1895456
2021.12_13-10-2022;Воронежская область;45_75_days;SputnikLite;32914;25498;58412;1293123;602333;1895456
2021.12_13-10-2022;Воронежская область;45_75_days;SputnikV;129122;35160;164282;1293123;602333;1895456
2021.12_13-10-2022;Воронежская область;75_90_days;AllVaccines;49513;24128;73641;1293123;602333;1895456
2021.12_13-10-2022;Воронежская область;75_90_days;CoviVac;605;222;827;1293123;602333;1895456
2021.12_13-10-2022;Воронежская область;75_90_days;EpiVacCorona;525;220;745;1293123;602333;1895456
2021.12_13-10-2022;Воронежская область;75_90_days;SputnikLite;34195;17248;51443;1293123;602333;1895456
2021.12_13-10-2022;Воронежская область;75_90_days;SputnikV;14188;6438;20626;1293123;602333;1895456
2021.12_13-10-2022;Воронежская область;90_105_days;AllVaccines;32298;16287;48585;1293123;602333;1895456
2021.12_13-10-2022;Воронежская область;90_105_days;CoviVac;561;179;740;1293123;602333;1895456
2021.12_13-10-2022;Воронежская область;90_105_days;EpiVacCorona;122;83;205;1293123;602333;1895456
2021.12_13-10-2022;Воронежская область;90_105_days;SputnikLite;22712;10742;33454;1293123;602333;1895456
2021.12_13-10-2022;Воронежская область;90_105_days;SputnikV;8903;5283;14186;1293123;602333;1895456
2021.12_13-10-2022;Еврейская автономная область;105_165_days;AllVaccines;7715;2191;9906;88207;31969;120176
2021.12_13-10-2022;Еврейская автономная область;105_165_days;CoviVac;66;4;70;88207;31969;120176
2021.12_13-10-2022;Еврейская автономная область;105_165_days;EpiVacCorona;476;98;574;88207;31969;120176
2021.12_13-10-2022;Еврейская автономная область;105_165_days;SputnikLite;692;547;1239;88207;31969;120176
2021.12_13-10-2022;Еврейская автономная область;105_165_days;SputnikV;6481;1542;8023;88207;31969;120176
2021.12_13-10-2022;Еврейская автономная область;165_195_days;AllVaccines;8079;2417;10496;88207;31969;120176
2021.12_13-10-2022;Еврейская автономная область;165_195_days;CoviVac;564;76;640;88207;31969;120176
2021.12_13-10-2022;Еврейская автономная область;165_195_days;EpiVacCorona;1852;630;2482;88207;31969;120176
2021.12_13-10-2022;Еврейская автономная область;165_195_days;SputnikV;5663;1711;7374;88207;31969;120176
2021.12_13-10-2022;Еврейская автономная область;21_45_days;AllVaccines;11321;3232;14553;88207;31969;120176
2021.12_13-10-2022;Еврейская автономная область;21_45_days;CoviVac;167;23;190;88207;31969;120176
2021.12_13-10-2022;Еврейская автономная область;21_45_days;EpiVacCorona;449;85;534;88207;31969;120176
2021.12_13-10-2022;Еврейская автономная область;21_45_days;SputnikLite;2048;1148;3196;88207;31969;120176
2021.12_13-10-2022;Еврейская автономная область;21_45_days;SputnikV;8657;1976;10633;88207;31969;120176
2021.12_13-10-2022;Еврейская автономная область;45_75_days;AllVaccines;6949;2249;9198;88207;31969;120176
2021.12_13-10-2022;Еврейская автономная область;45_75_days;CoviVac;6;1;7;88207;31969;120176
2021.12_13-10-2022;Еврейская автономная область;45_75_days;EpiVacCorona;1121;157;1278;88207;31969;120176
2021.12_13-10-2022;Еврейская автономная область;45_75_days;SputnikLite;2034;1092;3126;88207;31969;120176
2021.12_13-10-2022;Еврейская автономная область;45_75_days;SputnikV;3788;999;4787;88207;31969;120176
2021.12_13-10-2022;Еврейская автономная область;75_90_days;AllVaccines;1530;880;2410;88207;31969;120176
2021.12_13-10-2022;Еврейская автономная область;75_90_days;CoviVac;2;0;2;88207;31969;120176
2021.12_13-10-2022;Еврейская автономная область;75_90_days;EpiVacCorona;61;20;81;88207;31969;120176
2021.12_13-10-2022;Еврейская автономная область;75_90_days;SputnikLite;1162;725;1887;88207;31969;120176
2021.12_13-10-2022;Еврейская автономная область;75_90_days;SputnikV;305;135;440;88207;31969;120176
2021.12_13-10-2022;Еврейская автономная область;90_105_days;AllVaccines;914;584;1498;88207;31969;120176
2021.12_13-10-2022;Еврейская автономная область;90_105_days;EpiVacCorona;2;0;2;88207;31969;120176
2021.12_13-10-2022;Еврейская автономная область;90_105_days;SputnikLite;513;423;936;88207;31969;120176
2021.12_13-10-2022;Еврейская автономная область;90_105_days;SputnikV;399;161;560;88207;31969;120176
2021.12_13-10-2022;Забайкальский край;105_165_days;AllVaccines;94407;19439;113846;596322;191826;788148
2021.12_13-10-2022;Забайкальский край;105_165_days;CoviVac;553;26;579;596322;191826;788148
2021.12_13-10-2022;Забайкальский край;105_165_days;EpiVacCorona;1356;413;1769;596322;191826;788148
2021.12_13-10-2022;Забайкальский край;105_165_days;SputnikLite;33483;4860;38343;596322;191826;788148
2021.12_13-10-2022;Забайкальский край;105_165_days;SputnikV;59015;14140;73155;596322;191826;788148
2021.12_13-10-2022;Забайкальский край;165_195_days;AllVaccines;40307;9060;49367;596322;191826;788148
2021.12_13-10-2022;Забайкальский край;165_195_days;CoviVac;1353;55;1408;596322;191826;788148
2021.12_13-10-2022;Забайкальский край;165_195_days;EpiVacCorona;632;136;768;596322;191826;788148
2021.12_13-10-2022;Забайкальский край;165_195_days;SputnikLite;2009;118;2127;596322;191826;788148
2021.12_13-10-2022;Забайкальский край;165_195_days;SputnikV;36313;8751;45064;596322;191826;788148
2021.12_13-10-2022;Забайкальский край;21_45_days;AllVaccines;57898;22236;80134;596322;191826;788148
2021.12_13-10-2022;Забайкальский край;21_45_days;CoviVac;511;36;547;596322;191826;788148
2021.12_13-10-2022;Забайкальский край;21_45_days;EpiVacCorona;3649;1196;4845;596322;191826;788148
2021.12_13-10-2022;Забайкальский край;21_45_days;SputnikLite;17618;7916;25534;596322;191826;788148
2021.12_13-10-2022;Забайкальский край;21_45_days;SputnikV;36120;13088;49208;596322;191826;788148
2021.12_13-10-2022;Забайкальский край;45_75_days;AllVaccines;57415;24646;82061;596322;191826;788148
2021.12_13-10-2022;Забайкальский край;45_75_days;CoviVac;763;75;838;596322;191826;788148
2021.12_13-10-2022;Забайкальский край;45_75_days;EpiVacCorona;1842;670;2512;596322;191826;788148
2021.12_13-10-2022;Забайкальский край;45_75_days;SputnikLite;26556;11713;38269;596322;191826;788148
2021.12_13-10-2022;Забайкальский край;45_75_days;SputnikV;28254;12188;40442;596322;191826;788148
2021.12_13-10-2022;Забайкальский край;75_90_days;AllVaccines;21553;9416;30969;596322;191826;788148
2021.12_13-10-2022;Забайкальский край;75_90_days;CoviVac;79;10;89;596322;191826;788148
2021.12_13-10-2022;Забайкальский край;75_90_days;EpiVacCorona;43;17;60;596322;191826;788148
2021.12_13-10-2022;Забайкальский край;75_90_days;SputnikLite;18662;8070;26732;596322;191826;788148
2021.12_13-10-2022;Забайкальский край;75_90_days;SputnikV;2769;1319;4088;596322;191826;788148
2021.12_13-10-2022;Забайкальский край;90_105_days;AllVaccines;9670;4418;14088;596322;191826;788148
2021.12_13-10-2022;Забайкальский край;90_105_days;CoviVac;69;5;74;596322;191826;788148
2021.12_13-10-2022;Забайкальский край;90_105_days;EpiVacCorona;40;18;58;596322;191826;788148
2021.12_13-10-2022;Забайкальский край;90_105_days;SputnikLite;7435;3517;10952;596322;191826;788148
2021.12_13-10-2022;Забайкальский край;90_105_days;SputnikV;2126;878;3004;596322;191826;788148
2021.12_13-10-2022;Ивановская область;105_165_days;AllVaccines;69721;18276;87997;549803;255947;805750
2021.12_13-10-2022;Ивановская область;105_165_days;CoviVac;452;45;497;549803;255947;805750
2021.12_13-10-2022;Ивановская область;105_165_days;EpiVacCorona;612;394;1006;549803;255947;805750
2021.12_13-10-2022;Ивановская область;105_165_days;SputnikLite;13390;6430;19820;549803;255947;805750
2021.12_13-10-2022;Ивановская область;105_165_days;SputnikV;55267;11407;66674;549803;255947;805750
2021.12_13-10-2022;Ивановская область;165_195_days;AllVaccines;71488;11982;83470;549803;255947;805750
2021.12_13-10-2022;Ивановская область;165_195_days;CoviVac;1751;132;1883;549803;255947;805750
2021.12_13-10-2022;Ивановская область;165_195_days;EpiVacCorona;75;31;106;549803;255947;805750
2021.12_13-10-2022;Ивановская область;165_195_days;SputnikLite;684;67;751;549803;255947;805750
2021.12_13-10-2022;Ивановская область;165_195_days;SputnikV;68978;11752;80730;549803;255947;805750
2021.12_13-10-2022;Ивановская область;21_45_days;AllVaccines;19945;16131;36076;549803;255947;805750
2021.12_13-10-2022;Ивановская область;21_45_days;CoviVac;313;51;364;549803;255947;805750
2021.12_13-10-2022;Ивановская область;21_45_days;EpiVacCorona;891;837;1728;549803;255947;805750
2021.12_13-10-2022;Ивановская область;21_45_days;SputnikLite;7238;6775;14013;549803;255947;805750
2021.12_13-10-2022;Ивановская область;21_45_days;SputnikV;11503;8468;19971;549803;255947;805750
2021.12_13-10-2022;Ивановская область;45_75_days;AllVaccines;31468;25039;56507;549803;255947;805750
2021.12_13-10-2022;Ивановская область;45_75_days;CoviVac;324;68;392;549803;255947;805750
2021.12_13-10-2022;Ивановская область;45_75_days;EpiVacCorona;575;442;1017;549803;255947;805750
2021.12_13-10-2022;Ивановская область;45_75_days;SputnikLite;15427;13526;28953;549803;255947;805750
2021.12_13-10-2022;Ивановская область;45_75_days;SputnikV;15142;11003;26145;549803;255947;805750
2021.12_13-10-2022;Ивановская область;75_90_days;AllVaccines;13927;9956;23883;549803;255947;805750
2021.12_13-10-2022;Ивановская область;75_90_days;CoviVac;55;7;62;549803;255947;805750
2021.12_13-10-2022;Ивановская область;75_90_days;EpiVacCorona;87;92;179;549803;255947;805750
2021.12_13-10-2022;Ивановская область;75_90_days;SputnikLite;10623;7489;18112;549803;255947;805750
2021.12_13-10-2022;Ивановская область;75_90_days;SputnikV;3162;2368;5530;549803;255947;805750
2021.12_13-10-2022;Ивановская область;90_105_days;AllVaccines;7465;5256;12721;549803;255947;805750
2021.12_13-10-2022;Ивановская область;90_105_days;CoviVac;32;8;40;549803;255947;805750
2021.12_13-10-2022;Ивановская область;90_105_days;EpiVacCorona;42;22;64;549803;255947;805750
2021.12_13-10-2022;Ивановская область;90_105_days;SputnikLite;5142;3905;9047;549803;255947;805750
2021.12_13-10-2022;Ивановская область;90_105_days;SputnikV;2249;1321;3570;549803;255947;805750
2021.12_13-10-2022;Иркутская область;105_165_days;AllVaccines;142968;43623;186591;1316761;480655;1797416
2021.12_13-10-2022;Иркутская область;105_165_days;CoviVac;2567;578;3145;1316761;480655;1797416
2021.12_13-10-2022;Иркутская область;105_165_days;EpiVacCorona;7944;2226;10170;1316761;480655;1797416
2021.12_13-10-2022;Иркутская область;105_165_days;SputnikLite;23230;14030;37260;1316761;480655;1797416
2021.12_13-10-2022;Иркутская область;105_165_days;SputnikV;109227;26789;136016;1316761;480655;1797416
2021.12_13-10-2022;Иркутская область;165_195_days;AllVaccines;101215;30688;131903;1316761;480655;1797416
2021.12_13-10-2022;Иркутская область;165_195_days;CoviVac;688;149;837;1316761;480655;1797416
2021.12_13-10-2022;Иркутская область;165_195_days;EpiVacCorona;1819;825;2644;1316761;480655;1797416
2021.12_13-10-2022;Иркутская область;165_195_days;SputnikLite;620;152;772;1316761;480655;1797416
2021.12_13-10-2022;Иркутская область;165_195_days;SputnikV;98088;29562;127650;1316761;480655;1797416
2021.12_13-10-2022;Иркутская область;21_45_days;AllVaccines;169223;52520;221743;1316761;480655;1797416
2021.12_13-10-2022;Иркутская область;21_45_days;CoviVac;1688;365;2053;1316761;480655;1797416
2021.12_13-10-2022;Иркутская область;21_45_days;EpiVacCorona;2940;978;3918;1316761;480655;1797416
2021.12_13-10-2022;Иркутская область;21_45_days;SputnikLite;36826;26033;62859;1316761;480655;1797416
2021.12_13-10-2022;Иркутская область;21_45_days;SputnikV;127769;25144;152913;1316761;480655;1797416
2021.12_13-10-2022;Иркутская область;45_75_days;AllVaccines;142074;47533;189607;1316761;480655;1797416
2021.12_13-10-2022;Иркутская область;45_75_days;CoviVac;2364;469;2833;1316761;480655;1797416
2021.12_13-10-2022;Иркутская область;45_75_days;EpiVacCorona;3340;1010;4350;1316761;480655;1797416
2021.12_13-10-2022;Иркутская область;45_75_days;SputnikLite;33127;23692;56819;1316761;480655;1797416
2021.12_13-10-2022;Иркутская область;45_75_days;SputnikV;103243;22362;125605;1316761;480655;1797416
2021.12_13-10-2022;Иркутская область;75_90_days;AllVaccines;34050;17736;51786;1316761;480655;1797416
2021.12_13-10-2022;Иркутская область;75_90_days;CoviVac;323;117;440;1316761;480655;1797416
2021.12_13-10-2022;Иркутская область;75_90_days;EpiVacCorona;460;210;670;1316761;480655;1797416
2021.12_13-10-2022;Иркутская область;75_90_days;SputnikLite;21082;13485;34567;1316761;480655;1797416
2021.12_13-10-2022;Иркутская область;75_90_days;SputnikV;12185;3924;16109;1316761;480655;1797416
2021.12_13-10-2022;Иркутская область;90_105_days;AllVaccines;19071;11209;30280;1316761;480655;1797416
2021.12_13-10-2022;Иркутская область;90_105_days;CoviVac;197;64;261;1316761;480655;1797416
2021.12_13-10-2022;Иркутская область;90_105_days;EpiVacCorona;380;194;574;1316761;480655;1797416
2021.12_13-10-2022;Иркутская область;90_105_days;SputnikLite;9235;8234;17469;1316761;480655;1797416
2021.12_13-10-2022;Иркутская область;90_105_days;SputnikV;9259;2717;11976;1316761;480655;1797416
2021.12_13-10-2022;Кабардино-Балкарская Республика;105_165_days;AllVaccines;61190;14129;75319;502388;159241;661629
2021.12_13-10-2022;Кабардино-Балкарская Республика;105_165_days;CoviVac;425;75;500;502388;159241;661629
2021.12_13-10-2022;Кабардино-Балкарская Республика;105_165_days;EpiVacCorona;952;219;1171;502388;159241;661629
2021.12_13-10-2022;Кабардино-Балкарская Республика;105_165_days;SputnikLite;14312;3463;17775;502388;159241;661629
2021.12_13-10-2022;Кабардино-Балкарская Республика;105_165_days;SputnikV;45501;10372;55873;502388;159241;661629
2021.12_13-10-2022;Кабардино-Балкарская Республика;165_195_days;AllVaccines;34742;10458;45200;502388;159241;661629
2021.12_13-10-2022;Кабардино-Балкарская Республика;165_195_days;CoviVac;458;86;544;502388;159241;661629
2021.12_13-10-2022;Кабардино-Балкарская Республика;165_195_days;EpiVacCorona;829;286;1115;502388;159241;661629
2021.12_13-10-2022;Кабардино-Балкарская Республика;165_195_days;SputnikLite;1098;185;1283;502388;159241;661629
2021.12_13-10-2022;Кабардино-Балкарская Республика;165_195_days;SputnikV;32357;9901;42258;502388;159241;661629
2021.12_13-10-2022;Кабардино-Балкарская Республика;21_45_days;AllVaccines;16751;6147;22898;502388;159241;661629
2021.12_13-10-2022;Кабардино-Балкарская Республика;21_45_days;CoviVac;148;38;186;502388;159241;661629
2021.12_13-10-2022;Кабардино-Балкарская Республика;21_45_days;EpiVacCorona;679;195;874;502388;159241;661629
2021.12_13-10-2022;Кабардино-Балкарская Республика;21_45_days;SputnikLite;8291;2697;10988;502388;159241;661629
2021.12_13-10-2022;Кабардино-Балкарская Республика;21_45_days;SputnikV;7633;3217;10850;502388;159241;661629
2021.12_13-10-2022;Кабардино-Балкарская Республика;45_75_days;AllVaccines;32780;9541;42321;502388;159241;661629
2021.12_13-10-2022;Кабардино-Балкарская Республика;45_75_days;CoviVac;158;40;198;502388;159241;661629
2021.12_13-10-2022;Кабардино-Балкарская Республика;45_75_days;EpiVacCorona;581;151;732;502388;159241;661629
2021.12_13-10-2022;Кабардино-Балкарская Республика;45_75_days;SputnikLite;20416;5501;25917;502388;159241;661629
2021.12_13-10-2022;Кабардино-Балкарская Республика;45_75_days;SputnikV;11625;3849;15474;502388;159241;661629
2021.12_13-10-2022;Кабардино-Балкарская Республика;75_90_days;AllVaccines;14217;4201;18418;502388;159241;661629
2021.12_13-10-2022;Кабардино-Балкарская Республика;75_90_days;CoviVac;76;25;101;502388;159241;661629
2021.12_13-10-2022;Кабардино-Балкарская Республика;75_90_days;EpiVacCorona;38;12;50;502388;159241;661629
2021.12_13-10-2022;Кабардино-Балкарская Республика;75_90_days;SputnikLite;11894;3118;15012;502388;159241;661629
2021.12_13-10-2022;Кабардино-Балкарская Республика;75_90_days;SputnikV;2209;1046;3255;502388;159241;661629
2021.12_13-10-2022;Кабардино-Балкарская Республика;90_105_days;AllVaccines;6447;2526;8973;502388;159241;661629
2021.12_13-10-2022;Кабардино-Балкарская Республика;90_105_days;CoviVac;45;20;65;502388;159241;661629
2021.12_13-10-2022;Кабардино-Балкарская Республика;90_105_days;EpiVacCorona;27;17;44;502388;159241;661629
2021.12_13-10-2022;Кабардино-Балкарская Республика;90_105_days;SputnikLite;4526;1742;6268;502388;159241;661629
2021.12_13-10-2022;Кабардино-Балкарская Республика;90_105_days;SputnikV;1849;747;2596;502388;159241;661629
2021.12_13-10-2022;Калининградская область;105_165_days;AllVaccines;94215;25341;119556;585700;231702;817402
2021.12_13-10-2022;Калининградская область;105_165_days;CoviVac;662;146;808;585700;231702;817402
2021.12_13-10-2022;Калининградская область;105_165_days;EpiVacCorona;8196;1721;9917;585700;231702;817402
2021.12_13-10-2022;Калининградская область;105_165_days;SputnikLite;29823;9239;39062;585700;231702;817402
2021.12_13-10-2022;Калининградская область;105_165_days;SputnikV;55534;14235;69769;585700;231702;817402
2021.12_13-10-2022;Калининградская область;165_195_days;AllVaccines;53997;14939;68936;585700;231702;817402
2021.12_13-10-2022;Калининградская область;165_195_days;CoviVac;450;82;532;585700;231702;817402
2021.12_13-10-2022;Калининградская область;165_195_days;EpiVacCorona;217;91;308;585700;231702;817402
2021.12_13-10-2022;Калининградская область;165_195_days;SputnikLite;66;70;136;585700;231702;817402
2021.12_13-10-2022;Калининградская область;165_195_days;SputnikV;53264;14696;67960;585700;231702;817402
2021.12_13-10-2022;Калининградская область;21_45_days;AllVaccines;48147;25323;73470;585700;231702;817402
2021.12_13-10-2022;Калининградская область;21_45_days;CoviVac;928;242;1170;585700;231702;817402
2021.12_13-10-2022;Калининградская область;21_45_days;EpiVacCorona;1167;380;1547;585700;231702;817402
2021.12_13-10-2022;Калининградская область;21_45_days;SputnikLite;10932;10179;21111;585700;231702;817402
2021.12_13-10-2022;Калининградская область;21_45_days;SputnikV;35120;14522;49642;585700;231702;817402
2021.12_13-10-2022;Калининградская область;45_75_days;AllVaccines;59840;28499;88339;585700;231702;817402
2021.12_13-10-2022;Калининградская область;45_75_days;CoviVac;670;146;816;585700;231702;817402
2021.12_13-10-2022;Калининградская область;45_75_days;EpiVacCorona;1874;700;2574;585700;231702;817402
2021.12_13-10-2022;Калининградская область;45_75_days;SputnikLite;11456;10385;21841;585700;231702;817402
2021.12_13-10-2022;Калининградская область;45_75_days;SputnikV;45840;17268;63108;585700;231702;817402
2021.12_13-10-2022;Калининградская область;75_90_days;AllVaccines;21251;7712;28963;585700;231702;817402
2021.12_13-10-2022;Калининградская область;75_90_days;CoviVac;72;24;96;585700;231702;817402
2021.12_13-10-2022;Калининградская область;75_90_days;EpiVacCorona;188;64;252;585700;231702;817402
2021.12_13-10-2022;Калининградская область;75_90_days;SputnikLite;13724;5003;18727;585700;231702;817402
2021.12_13-10-2022;Калининградская область;75_90_days;SputnikV;7267;2621;9888;585700;231702;817402
2021.12_13-10-2022;Калининградская область;90_105_days;AllVaccines;21038;6295;27333;585700;231702;817402
2021.12_13-10-2022;Калининградская область;90_105_days;CoviVac;67;17;84;585700;231702;817402
2021.12_13-10-2022;Калининградская область;90_105_days;EpiVacCorona;155;30;185;585700;231702;817402
2021.12_13-10-2022;Калининградская область;90_105_days;SputnikLite;16076;4389;20465;585700;231702;817402
2021.12_13-10-2022;Калининградская область;90_105_days;SputnikV;4740;1859;6599;585700;231702;817402
2021.12_13-10-2022;Калужская область;105_165_days;AllVaccines;72154;22199;94353;559789;253023;812812
2021.12_13-10-2022;Калужская область;105_165_days;CoviVac;682;143;825;559789;253023;812812
2021.12_13-10-2022;Калужская область;105_165_days;EpiVacCorona;2860;1054;3914;559789;253023;812812
2021.12_13-10-2022;Калужская область;105_165_days;SputnikLite;14876;7322;22198;559789;253023;812812
2021.12_13-10-2022;Калужская область;105_165_days;SputnikV;53736;13680;67416;559789;253023;812812
2021.12_13-10-2022;Калужская область;165_195_days;AllVaccines;64828;15364;80192;559789;253023;812812
2021.12_13-10-2022;Калужская область;165_195_days;CoviVac;449;77;526;559789;253023;812812
2021.12_13-10-2022;Калужская область;165_195_days;EpiVacCorona;676;273;949;559789;253023;812812
2021.12_13-10-2022;Калужская область;165_195_days;SputnikLite;518;138;656;559789;253023;812812
2021.12_13-10-2022;Калужская область;165_195_days;SputnikV;63185;14876;78061;559789;253023;812812
2021.12_13-10-2022;Калужская область;21_45_days;AllVaccines;67897;25474;93371;559789;253023;812812
2021.12_13-10-2022;Калужская область;21_45_days;CoviVac;530;133;663;559789;253023;812812
2021.12_13-10-2022;Калужская область;21_45_days;EpiVacCorona;2578;939;3517;559789;253023;812812
2021.12_13-10-2022;Калужская область;21_45_days;SputnikLite;12240;9260;21500;559789;253023;812812
2021.12_13-10-2022;Калужская область;21_45_days;SputnikV;52549;15142;67691;559789;253023;812812
2021.12_13-10-2022;Калужская область;45_75_days;AllVaccines;75819;24425;100244;559789;253023;812812
2021.12_13-10-2022;Калужская область;45_75_days;CoviVac;2439;578;3017;559789;253023;812812
2021.12_13-10-2022;Калужская область;45_75_days;EpiVacCorona;3318;1067;4385;559789;253023;812812
2021.12_13-10-2022;Калужская область;45_75_days;SputnikLite;12182;7752;19934;559789;253023;812812
2021.12_13-10-2022;Калужская область;45_75_days;SputnikV;57880;15028;72908;559789;253023;812812
2021.12_13-10-2022;Калужская область;75_90_days;AllVaccines;26700;10791;37491;559789;253023;812812
2021.12_13-10-2022;Калужская область;75_90_days;CoviVac;80;15;95;559789;253023;812812
2021.12_13-10-2022;Калужская область;75_90_days;EpiVacCorona;241;168;409;559789;253023;812812
2021.12_13-10-2022;Калужская область;75_90_days;SputnikLite;22637;8765;31402;559789;253023;812812
2021.12_13-10-2022;Калужская область;75_90_days;SputnikV;3742;1843;5585;559789;253023;812812
2021.12_13-10-2022;Калужская область;90_105_days;AllVaccines;7732;5013;12745;559789;253023;812812
2021.12_13-10-2022;Калужская область;90_105_days;CoviVac;54;12;66;559789;253023;812812
2021.12_13-10-2022;Калужская область;90_105_days;EpiVacCorona;135;94;229;559789;253023;812812
2021.12_13-10-2022;Калужская область;90_105_days;SputnikLite;4304;3533;7837;559789;253023;812812
2021.12_13-10-2022;Калужская область;90_105_days;SputnikV;3239;1374;4613;559789;253023;812812
2021.12_13-10-2022;Камчатский край;105_165_days;AllVaccines;26763;5643;32406;189425;56856;246281
2021.12_13-10-2022;Камчатский край;105_165_days;CoviVac;55;18;73;189425;56856;246281
2021.12_13-10-2022;Камчатский край;105_165_days;EpiVacCorona;1794;377;2171;189425;56856;246281
2021.12_13-10-2022;Камчатский край;105_165_days;SputnikLite;6526;1836;8362;189425;56856;246281
2021.12_13-10-2022;Камчатский край;105_165_days;SputnikV;18388;3412;21800;189425;56856;246281
2021.12_13-10-2022;Камчатский край;165_195_days;AllVaccines;13269;3400;16669;189425;56856;246281
2021.12_13-10-2022;Камчатский край;165_195_days;CoviVac;120;23;143;189425;56856;246281
2021.12_13-10-2022;Камчатский край;165_195_days;EpiVacCorona;535;176;711;189425;56856;246281
2021.12_13-10-2022;Камчатский край;165_195_days;SputnikLite;2;1;3;189425;56856;246281
2021.12_13-10-2022;Камчатский край;165_195_days;SputnikV;12612;3200;15812;189425;56856;246281
2021.12_13-10-2022;Камчатский край;21_45_days;AllVaccines;14097;4019;18116;189425;56856;246281
2021.12_13-10-2022;Камчатский край;21_45_days;CoviVac;199;48;247;189425;56856;246281
2021.12_13-10-2022;Камчатский край;21_45_days;EpiVacCorona;413;173;586;189425;56856;246281
2021.12_13-10-2022;Камчатский край;21_45_days;SputnikLite;5374;1984;7358;189425;56856;246281
2021.12_13-10-2022;Камчатский край;21_45_days;SputnikV;8111;1814;9925;189425;56856;246281
2021.12_13-10-2022;Камчатский край;45_75_days;AllVaccines;16757;5272;22029;189425;56856;246281
2021.12_13-10-2022;Камчатский край;45_75_days;CoviVac;221;30;251;189425;56856;246281
2021.12_13-10-2022;Камчатский край;45_75_days;EpiVacCorona;451;123;574;189425;56856;246281
2021.12_13-10-2022;Камчатский край;45_75_days;SputnikLite;9789;3576;13365;189425;56856;246281
2021.12_13-10-2022;Камчатский край;45_75_days;SputnikV;6296;1543;7839;189425;56856;246281
2021.12_13-10-2022;Камчатский край;75_90_days;AllVaccines;5266;1705;6971;189425;56856;246281
2021.12_13-10-2022;Камчатский край;75_90_days;CoviVac;2;1;3;189425;56856;246281
2021.12_13-10-2022;Камчатский край;75_90_days;EpiVacCorona;176;40;216;189425;56856;246281
2021.12_13-10-2022;Камчатский край;75_90_days;SputnikLite;3740;1406;5146;189425;56856;246281
2021.12_13-10-2022;Камчатский край;75_90_days;SputnikV;1348;258;1606;189425;56856;246281
2021.12_13-10-2022;Камчатский край;90_105_days;AllVaccines;2878;1041;3919;189425;56856;246281
2021.12_13-10-2022;Камчатский край;90_105_days;CoviVac;1;2;3;189425;56856;246281
2021.12_13-10-2022;Камчатский край;90_105_days;EpiVacCorona;153;40;193;189425;56856;246281
2021.12_13-10-2022;Камчатский край;90_105_days;SputnikLite;1435;740;2175;189425;56856;246281
2021.12_13-10-2022;Камчатский край;90_105_days;SputnikV;1289;259;1548;189425;56856;246281
2021.12_13-10-2022;Карачаево-Черкесская Республика;105_165_days;AllVaccines;32860;7294;40154;266261;94005;360266
2021.12_13-10-2022;Карачаево-Черкесская Республика;105_165_days;CoviVac;465;112;577;266261;94005;360266
2021.12_13-10-2022;Карачаево-Черкесская Республика;105_165_days;EpiVacCorona;1690;210;1900;266261;94005;360266
2021.12_13-10-2022;Карачаево-Черкесская Республика;105_165_days;SputnikLite;9125;2380;11505;266261;94005;360266
2021.12_13-10-2022;Карачаево-Черкесская Республика;105_165_days;SputnikV;21580;4592;26172;266261;94005;360266
2021.12_13-10-2022;Карачаево-Черкесская Республика;165_195_days;AllVaccines;19894;4017;23911;266261;94005;360266
2021.12_13-10-2022;Карачаево-Черкесская Республика;165_195_days;CoviVac;1135;230;1365;266261;94005;360266
2021.12_13-10-2022;Карачаево-Черкесская Республика;165_195_days;EpiVacCorona;1531;202;1733;266261;94005;360266
2021.12_13-10-2022;Карачаево-Черкесская Республика;165_195_days;SputnikLite;199;50;249;266261;94005;360266
2021.12_13-10-2022;Карачаево-Черкесская Республика;165_195_days;SputnikV;17029;3535;20564;266261;94005;360266
2021.12_13-10-2022;Карачаево-Черкесская Республика;21_45_days;AllVaccines;11020;3836;14856;266261;94005;360266
2021.12_13-10-2022;Карачаево-Черкесская Республика;21_45_days;CoviVac;57;29;86;266261;94005;360266
2021.12_13-10-2022;Карачаево-Черкесская Республика;21_45_days;EpiVacCorona;119;39;158;266261;94005;360266
2021.12_13-10-2022;Карачаево-Черкесская Республика;21_45_days;SputnikLite;6606;2193;8799;266261;94005;360266
2021.12_13-10-2022;Карачаево-Черкесская Республика;21_45_days;SputnikV;4238;1575;5813;266261;94005;360266
2021.12_13-10-2022;Карачаево-Черкесская Республика;45_75_days;AllVaccines;15070;5640;20710;266261;94005;360266
2021.12_13-10-2022;Карачаево-Черкесская Республика;45_75_days;CoviVac;38;15;53;266261;94005;360266
2021.12_13-10-2022;Карачаево-Черкесская Республика;45_75_days;EpiVacCorona;94;33;127;266261;94005;360266
2021.12_13-10-2022;Карачаево-Черкесская Республика;45_75_days;SputnikLite;10536;3370;13906;266261;94005;360266
2021.12_13-10-2022;Карачаево-Черкесская Республика;45_75_days;SputnikV;4402;2222;6624;266261;94005;360266
2021.12_13-10-2022;Карачаево-Черкесская Республика;75_90_days;AllVaccines;3768;1607;5375;266261;94005;360266
2021.12_13-10-2022;Карачаево-Черкесская Республика;75_90_days;CoviVac;9;10;19;266261;94005;360266
2021.12_13-10-2022;Карачаево-Черкесская Республика;75_90_days;EpiVacCorona;35;8;43;266261;94005;360266
2021.12_13-10-2022;Карачаево-Черкесская Республика;75_90_days;SputnikLite;2835;1096;3931;266261;94005;360266
2021.12_13-10-2022;Карачаево-Черкесская Республика;75_90_days;SputnikV;889;493;1382;266261;94005;360266
2021.12_13-10-2022;Карачаево-Черкесская Республика;90_105_days;AllVaccines;2450;1265;3715;266261;94005;360266
2021.12_13-10-2022;Карачаево-Черкесская Республика;90_105_days;CoviVac;5;4;9;266261;94005;360266
2021.12_13-10-2022;Карачаево-Черкесская Республика;90_105_days;EpiVacCorona;25;6;31;266261;94005;360266
2021.12_13-10-2022;Карачаево-Черкесская Республика;90_105_days;SputnikLite;1325;817;2142;266261;94005;360266
2021.12_13-10-2022;Карачаево-Черкесская Республика;90_105_days;SputnikV;1095;438;1533;266261;94005;360266
2021.12_13-10-2022;Кемеровская область;105_165_days;AllVaccines;219798;47408;267206;1453976;610256;2064232
2021.12_13-10-2022;Кемеровская область;105_165_days;CoviVac;1893;359;2252;1453976;610256;2064232
2021.12_13-10-2022;Кемеровская область;105_165_days;EpiVacCorona;2228;710;2938;1453976;610256;2064232
2021.12_13-10-2022;Кемеровская область;105_165_days;SputnikLite;10946;8541;19487;1453976;610256;2064232
2021.12_13-10-2022;Кемеровская область;105_165_days;SputnikV;204731;37798;242529;1453976;610256;2064232
2021.12_13-10-2022;Кемеровская область;165_195_days;AllVaccines;194827;41298;236125;1453976;610256;2064232
2021.12_13-10-2022;Кемеровская область;165_195_days;CoviVac;1242;179;1421;1453976;610256;2064232
2021.12_13-10-2022;Кемеровская область;165_195_days;EpiVacCorona;1248;383;1631;1453976;610256;2064232
2021.12_13-10-2022;Кемеровская область;165_195_days;SputnikLite;200;27;227;1453976;610256;2064232
2021.12_13-10-2022;Кемеровская область;165_195_days;SputnikV;192137;40709;232846;1453976;610256;2064232
2021.12_13-10-2022;Кемеровская область;21_45_days;AllVaccines;131309;55446;186755;1453976;610256;2064232
2021.12_13-10-2022;Кемеровская область;21_45_days;CoviVac;1469;299;1768;1453976;610256;2064232
2021.12_13-10-2022;Кемеровская область;21_45_days;EpiVacCorona;4557;1891;6448;1453976;610256;2064232
2021.12_13-10-2022;Кемеровская область;21_45_days;SputnikLite;24285;19532;43817;1453976;610256;2064232
2021.12_13-10-2022;Кемеровская область;21_45_days;SputnikV;100998;33724;134722;1453976;610256;2064232
2021.12_13-10-2022;Кемеровская область;45_75_days;AllVaccines;74497;45084;119581;1453976;610256;2064232
2021.12_13-10-2022;Кемеровская область;45_75_days;CoviVac;1353;242;1595;1453976;610256;2064232
2021.12_13-10-2022;Кемеровская область;45_75_days;EpiVacCorona;3191;1758;4949;1453976;610256;2064232
2021.12_13-10-2022;Кемеровская область;45_75_days;SputnikLite;22699;20591;43290;1453976;610256;2064232
2021.12_13-10-2022;Кемеровская область;45_75_days;SputnikV;47254;22493;69747;1453976;610256;2064232
2021.12_13-10-2022;Кемеровская область;75_90_days;AllVaccines;22600;17143;39743;1453976;610256;2064232
2021.12_13-10-2022;Кемеровская область;75_90_days;CoviVac;269;96;365;1453976;610256;2064232
2021.12_13-10-2022;Кемеровская область;75_90_days;EpiVacCorona;185;88;273;1453976;610256;2064232
2021.12_13-10-2022;Кемеровская область;75_90_days;SputnikLite;11221;12417;23638;1453976;610256;2064232
2021.12_13-10-2022;Кемеровская область;75_90_days;SputnikV;10925;4542;15467;1453976;610256;2064232
2021.12_13-10-2022;Кемеровская область;90_105_days;AllVaccines;17453;9196;26649;1453976;610256;2064232
2021.12_13-10-2022;Кемеровская область;90_105_days;CoviVac;412;67;479;1453976;610256;2064232
2021.12_13-10-2022;Кемеровская область;90_105_days;EpiVacCorona;164;62;226;1453976;610256;2064232
2021.12_13-10-2022;Кемеровская область;90_105_days;SputnikLite;4910;5615;10525;1453976;610256;2064232
2021.12_13-10-2022;Кемеровская область;90_105_days;SputnikV;11967;3452;15419;1453976;610256;2064232
2021.12_13-10-2022;Кировская область;105_165_days;AllVaccines;67583;30551;98134;663621;334585;998206
2021.12_13-10-2022;Кировская область;105_165_days;CoviVac;813;58;871;663621;334585;998206
2021.12_13-10-2022;Кировская область;105_165_days;EpiVacCorona;1050;390;1440;663621;334585;998206
2021.12_13-10-2022;Кировская область;105_165_days;SputnikLite;25158;11733;36891;663621;334585;998206
2021.12_13-10-2022;Кировская область;105_165_days;SputnikV;40562;18370;58932;663621;334585;998206
2021.12_13-10-2022;Кировская область;165_195_days;AllVaccines;54034;20950;74984;663621;334585;998206
2021.12_13-10-2022;Кировская область;165_195_days;CoviVac;638;51;689;663621;334585;998206
2021.12_13-10-2022;Кировская область;165_195_days;EpiVacCorona;1601;450;2051;663621;334585;998206
2021.12_13-10-2022;Кировская область;165_195_days;SputnikLite;541;47;588;663621;334585;998206
2021.12_13-10-2022;Кировская область;165_195_days;SputnikV;51254;20402;71656;663621;334585;998206
2021.12_13-10-2022;Кировская область;21_45_days;AllVaccines;63925;39204;103129;663621;334585;998206
2021.12_13-10-2022;Кировская область;21_45_days;CoviVac;1049;153;1202;663621;334585;998206
2021.12_13-10-2022;Кировская область;21_45_days;EpiVacCorona;3051;1162;4213;663621;334585;998206
2021.12_13-10-2022;Кировская область;21_45_days;SputnikLite;19839;14154;33993;663621;334585;998206
2021.12_13-10-2022;Кировская область;21_45_days;SputnikV;39986;23735;63721;663621;334585;998206
2021.12_13-10-2022;Кировская область;45_75_days;AllVaccines;88525;46649;135174;663621;334585;998206
2021.12_13-10-2022;Кировская область;45_75_days;CoviVac;2862;294;3156;663621;334585;998206
2021.12_13-10-2022;Кировская область;45_75_days;EpiVacCorona;3884;1401;5285;663621;334585;998206
2021.12_13-10-2022;Кировская область;45_75_days;SputnikLite;35218;21761;56979;663621;334585;998206
2021.12_13-10-2022;Кировская область;45_75_days;SputnikV;46561;23193;69754;663621;334585;998206
2021.12_13-10-2022;Кировская область;75_90_days;AllVaccines;39017;15499;54516;663621;334585;998206
2021.12_13-10-2022;Кировская область;75_90_days;CoviVac;149;36;185;663621;334585;998206
2021.12_13-10-2022;Кировская область;75_90_days;EpiVacCorona;134;65;199;663621;334585;998206
2021.12_13-10-2022;Кировская область;75_90_days;SputnikLite;35567;12953;48520;663621;334585;998206
2021.12_13-10-2022;Кировская область;75_90_days;SputnikV;3167;2445;5612;663621;334585;998206
2021.12_13-10-2022;Кировская область;90_105_days;AllVaccines;11678;8841;20519;663621;334585;998206
2021.12_13-10-2022;Кировская область;90_105_days;CoviVac;95;21;116;663621;334585;998206
2021.12_13-10-2022;Кировская область;90_105_days;EpiVacCorona;41;24;65;663621;334585;998206
2021.12_13-10-2022;Кировская область;90_105_days;SputnikLite;9638;7129;16767;663621;334585;998206
2021.12_13-10-2022;Кировская область;90_105_days;SputnikV;1904;1667;3571;663621;334585;998206
2021.12_13-10-2022;Костромская область;105_165_days;AllVaccines;54517;15626;70143;339046;160543;499589
2021.12_13-10-2022;Костромская область;105_165_days;CoviVac;465;51;516;339046;160543;499589
2021.12_13-10-2022;Костромская область;105_165_days;EpiVacCorona;15;8;23;339046;160543;499589
2021.12_13-10-2022;Костромская область;105_165_days;SputnikLite;14767;5373;20140;339046;160543;499589
2021.12_13-10-2022;Костромская область;105_165_days;SputnikV;39270;10194;49464;339046;160543;499589
2021.12_13-10-2022;Костромская область;165_195_days;AllVaccines;29597;8793;38390;339046;160543;499589
2021.12_13-10-2022;Костромская область;165_195_days;CoviVac;723;51;774;339046;160543;499589
2021.12_13-10-2022;Костромская область;165_195_days;EpiVacCorona;49;31;80;339046;160543;499589
2021.12_13-10-2022;Костромская область;165_195_days;SputnikLite;282;54;336;339046;160543;499589
2021.12_13-10-2022;Костромская область;165_195_days;SputnikV;28543;8657;37200;339046;160543;499589
2021.12_13-10-2022;Костромская область;21_45_days;AllVaccines;27826;14836;42662;339046;160543;499589
2021.12_13-10-2022;Костромская область;21_45_days;CoviVac;215;56;271;339046;160543;499589
2021.12_13-10-2022;Костромская область;21_45_days;EpiVacCorona;3445;1335;4780;339046;160543;499589
2021.12_13-10-2022;Костромская область;21_45_days;SputnikLite;11480;6408;17888;339046;160543;499589
2021.12_13-10-2022;Костромская область;21_45_days;SputnikV;12686;7037;19723;339046;160543;499589
2021.12_13-10-2022;Костромская область;45_75_days;AllVaccines;36653;18500;55153;339046;160543;499589
2021.12_13-10-2022;Костромская область;45_75_days;CoviVac;815;231;1046;339046;160543;499589
2021.12_13-10-2022;Костромская область;45_75_days;EpiVacCorona;1059;521;1580;339046;160543;499589
2021.12_13-10-2022;Костромская область;45_75_days;SputnikLite;22446;10303;32749;339046;160543;499589
2021.12_13-10-2022;Костромская область;45_75_days;SputnikV;12333;7445;19778;339046;160543;499589
2021.12_13-10-2022;Костромская область;75_90_days;AllVaccines;15569;6366;21935;339046;160543;499589
2021.12_13-10-2022;Костромская область;75_90_days;CoviVac;15;9;24;339046;160543;499589
2021.12_13-10-2022;Костромская область;75_90_days;EpiVacCorona;8;7;15;339046;160543;499589
2021.12_13-10-2022;Костромская область;75_90_days;SputnikLite;13700;5079;18779;339046;160543;499589
2021.12_13-10-2022;Костромская область;75_90_days;SputnikV;1846;1271;3117;339046;160543;499589
2021.12_13-10-2022;Костромская область;90_105_days;AllVaccines;5761;4011;9772;339046;160543;499589
2021.12_13-10-2022;Костромская область;90_105_days;CoviVac;13;3;16;339046;160543;499589
2021.12_13-10-2022;Костромская область;90_105_days;EpiVacCorona;1;0;1;339046;160543;499589
2021.12_13-10-2022;Костромская область;90_105_days;SputnikLite;4022;3047;7069;339046;160543;499589
2021.12_13-10-2022;Костромская область;90_105_days;SputnikV;1725;961;2686;339046;160543;499589
2021.12_13-10-2022;Краснодарский край;105_165_days;AllVaccines;621991;155404;777395;3157155;1334085;4491240
2021.12_13-10-2022;Краснодарский край;105_165_days;CoviVac;6352;1543;7895;3157155;1334085;4491240
2021.12_13-10-2022;Краснодарский край;105_165_days;EpiVacCorona;5220;2127;7347;3157155;1334085;4491240
2021.12_13-10-2022;Краснодарский край;105_165_days;SputnikLite;25026;30312;55338;3157155;1334085;4491240
2021.12_13-10-2022;Краснодарский край;105_165_days;SputnikV;585393;121422;706815;3157155;1334085;4491240
2021.12_13-10-2022;Краснодарский край;165_195_days;AllVaccines;433801;91631;525432;3157155;1334085;4491240
2021.12_13-10-2022;Краснодарский край;165_195_days;CoviVac;4777;888;5665;3157155;1334085;4491240
2021.12_13-10-2022;Краснодарский край;165_195_days;EpiVacCorona;14537;5714;20251;3157155;1334085;4491240
2021.12_13-10-2022;Краснодарский край;165_195_days;SputnikLite;973;272;1245;3157155;1334085;4491240
2021.12_13-10-2022;Краснодарский край;165_195_days;SputnikV;413514;84757;498271;3157155;1334085;4491240
2021.12_13-10-2022;Краснодарский край;21_45_days;AllVaccines;296960;141394;438354;3157155;1334085;4491240
2021.12_13-10-2022;Краснодарский край;21_45_days;CoviVac;1873;611;2484;3157155;1334085;4491240
2021.12_13-10-2022;Краснодарский край;21_45_days;EpiVacCorona;5130;2596;7726;3157155;1334085;4491240
2021.12_13-10-2022;Краснодарский край;21_45_days;SputnikLite;47665;44309;91974;3157155;1334085;4491240
2021.12_13-10-2022;Краснодарский край;21_45_days;SputnikV;242292;93878;336170;3157155;1334085;4491240
2021.12_13-10-2022;Краснодарский край;45_75_days;AllVaccines;249655;120742;370397;3157155;1334085;4491240
2021.12_13-10-2022;Краснодарский край;45_75_days;CoviVac;3639;1133;4772;3157155;1334085;4491240
2021.12_13-10-2022;Краснодарский край;45_75_days;EpiVacCorona;4977;2740;7717;3157155;1334085;4491240
2021.12_13-10-2022;Краснодарский край;45_75_days;SputnikLite;39529;41802;81331;3157155;1334085;4491240
2021.12_13-10-2022;Краснодарский край;45_75_days;SputnikV;201510;75067;276577;3157155;1334085;4491240
2021.12_13-10-2022;Краснодарский край;75_90_days;AllVaccines;55638;37993;93631;3157155;1334085;4491240
2021.12_13-10-2022;Краснодарский край;75_90_days;CoviVac;1194;382;1576;3157155;1334085;4491240
2021.12_13-10-2022;Краснодарский край;75_90_days;EpiVacCorona;1143;641;1784;3157155;1334085;4491240
2021.12_13-10-2022;Краснодарский край;75_90_days;SputnikLite;16104;18880;34984;3157155;1334085;4491240
2021.12_13-10-2022;Краснодарский край;75_90_days;SputnikV;37197;18090;55287;3157155;1334085;4491240
2021.12_13-10-2022;Краснодарский край;90_105_days;AllVaccines;47751;33100;80851;3157155;1334085;4491240
2021.12_13-10-2022;Краснодарский край;90_105_days;CoviVac;821;271;1092;3157155;1334085;4491240
2021.12_13-10-2022;Краснодарский край;90_105_days;EpiVacCorona;976;489;1465;3157155;1334085;4491240
2021.12_13-10-2022;Краснодарский край;90_105_days;SputnikLite;10003;13497;23500;3157155;1334085;4491240
2021.12_13-10-2022;Краснодарский край;90_105_days;SputnikV;35951;18843;54794;3157155;1334085;4491240
2021.12_13-10-2022;Красноярский край;105_165_days;AllVaccines;315666;64494;380160;1637377;585822;2223199
2021.12_13-10-2022;Красноярский край;105_165_days;CoviVac;3899;425;4324;1637377;585822;2223199
2021.12_13-10-2022;Красноярский край;105_165_days;EpiVacCorona;7395;2460;9855;1637377;585822;2223199
2021.12_13-10-2022;Красноярский край;105_165_days;SputnikLite;111093;18098;129191;1637377;585822;2223199
2021.12_13-10-2022;Красноярский край;105_165_days;SputnikV;193279;43511;236790;1637377;585822;2223199
2021.12_13-10-2022;Красноярский край;165_195_days;AllVaccines;122303;34643;156946;1637377;585822;2223199
2021.12_13-10-2022;Красноярский край;165_195_days;CoviVac;2452;286;2738;1637377;585822;2223199
2021.12_13-10-2022;Красноярский край;165_195_days;EpiVacCorona;4363;1956;6319;1637377;585822;2223199
2021.12_13-10-2022;Красноярский край;165_195_days;SputnikLite;234;26;260;1637377;585822;2223199
2021.12_13-10-2022;Красноярский край;165_195_days;SputnikV;115254;32375;147629;1637377;585822;2223199
2021.12_13-10-2022;Красноярский край;21_45_days;AllVaccines;157857;61264;219121;1637377;585822;2223199
2021.12_13-10-2022;Красноярский край;21_45_days;CoviVac;1754;433;2187;1637377;585822;2223199
2021.12_13-10-2022;Красноярский край;21_45_days;EpiVacCorona;6619;3331;9950;1637377;585822;2223199
2021.12_13-10-2022;Красноярский край;21_45_days;SputnikLite;39608;22477;62085;1637377;585822;2223199
2021.12_13-10-2022;Красноярский край;21_45_days;SputnikV;109876;35023;144899;1637377;585822;2223199
2021.12_13-10-2022;Красноярский край;45_75_days;AllVaccines;117987;50384;168371;1637377;585822;2223199
2021.12_13-10-2022;Красноярский край;45_75_days;CoviVac;2027;466;2493;1637377;585822;2223199
2021.12_13-10-2022;Красноярский край;45_75_days;EpiVacCorona;4765;2535;7300;1637377;585822;2223199
2021.12_13-10-2022;Красноярский край;45_75_days;SputnikLite;42931;19495;62426;1637377;585822;2223199
2021.12_13-10-2022;Красноярский край;45_75_days;SputnikV;68264;27888;96152;1637377;585822;2223199
2021.12_13-10-2022;Красноярский край;75_90_days;AllVaccines;47457;17730;65187;1637377;585822;2223199
2021.12_13-10-2022;Красноярский край;75_90_days;CoviVac;320;86;406;1637377;585822;2223199
2021.12_13-10-2022;Красноярский край;75_90_days;EpiVacCorona;181;114;295;1637377;585822;2223199
2021.12_13-10-2022;Красноярский край;75_90_days;SputnikLite;35838;12537;48375;1637377;585822;2223199
2021.12_13-10-2022;Красноярский край;75_90_days;SputnikV;11118;4993;16111;1637377;585822;2223199
2021.12_13-10-2022;Красноярский край;90_105_days;AllVaccines;25954;11153;37107;1637377;585822;2223199
2021.12_13-10-2022;Красноярский край;90_105_days;CoviVac;489;123;612;1637377;585822;2223199
2021.12_13-10-2022;Красноярский край;90_105_days;EpiVacCorona;210;107;317;1637377;585822;2223199
2021.12_13-10-2022;Красноярский край;90_105_days;SputnikLite;14829;7097;21926;1637377;585822;2223199
2021.12_13-10-2022;Красноярский край;90_105_days;SputnikV;10426;3826;14252;1637377;585822;2223199
2021.12_13-10-2022;Курганская область;105_165_days;AllVaccines;53308;23690;76998;425081;217502;642583
2021.12_13-10-2022;Курганская область;105_165_days;CoviVac;482;111;593;425081;217502;642583
2021.12_13-10-2022;Курганская область;105_165_days;EpiVacCorona;169;104;273;425081;217502;642583
2021.12_13-10-2022;Курганская область;105_165_days;SputnikLite;10279;9304;19583;425081;217502;642583
2021.12_13-10-2022;Курганская область;105_165_days;SputnikV;42378;14171;56549;425081;217502;642583
2021.12_13-10-2022;Курганская область;165_195_days;AllVaccines;41524;14943;56467;425081;217502;642583
2021.12_13-10-2022;Курганская область;165_195_days;CoviVac;243;51;294;425081;217502;642583
2021.12_13-10-2022;Курганская область;165_195_days;EpiVacCorona;3570;1611;5181;425081;217502;642583
2021.12_13-10-2022;Курганская область;165_195_days;SputnikLite;22;15;37;425081;217502;642583
2021.12_13-10-2022;Курганская область;165_195_days;SputnikV;37689;13266;50955;425081;217502;642583
2021.12_13-10-2022;Курганская область;21_45_days;AllVaccines;33742;21102;54844;425081;217502;642583
2021.12_13-10-2022;Курганская область;21_45_days;CoviVac;531;194;725;425081;217502;642583
2021.12_13-10-2022;Курганская область;21_45_days;EpiVacCorona;274;201;475;425081;217502;642583
2021.12_13-10-2022;Курганская область;21_45_days;SputnikLite;10221;10636;20857;425081;217502;642583
2021.12_13-10-2022;Курганская область;21_45_days;SputnikV;22716;10071;32787;425081;217502;642583
2021.12_13-10-2022;Курганская область;45_75_days;AllVaccines;71463;30356;101819;425081;217502;642583
2021.12_13-10-2022;Курганская область;45_75_days;CoviVac;1177;364;1541;425081;217502;642583
2021.12_13-10-2022;Курганская область;45_75_days;EpiVacCorona;759;296;1055;425081;217502;642583
2021.12_13-10-2022;Курганская область;45_75_days;SputnikLite;12571;14035;26606;425081;217502;642583
2021.12_13-10-2022;Курганская область;45_75_days;SputnikV;56956;15661;72617;425081;217502;642583
2021.12_13-10-2022;Курганская область;75_90_days;AllVaccines;24366;9580;33946;425081;217502;642583
2021.12_13-10-2022;Курганская область;75_90_days;CoviVac;146;44;190;425081;217502;642583
2021.12_13-10-2022;Курганская область;75_90_days;EpiVacCorona;20;9;29;425081;217502;642583
2021.12_13-10-2022;Курганская область;75_90_days;SputnikLite;18867;7737;26604;425081;217502;642583
2021.12_13-10-2022;Курганская область;75_90_days;SputnikV;5333;1790;7123;425081;217502;642583
2021.12_13-10-2022;Курганская область;90_105_days;AllVaccines;10156;5011;15167;425081;217502;642583
2021.12_13-10-2022;Курганская область;90_105_days;CoviVac;55;16;71;425081;217502;642583
2021.12_13-10-2022;Курганская область;90_105_days;EpiVacCorona;20;15;35;425081;217502;642583
2021.12_13-10-2022;Курганская область;90_105_days;SputnikLite;6548;3866;10414;425081;217502;642583
2021.12_13-10-2022;Курганская область;90_105_days;SputnikV;3533;1114;4647;425081;217502;642583
2021.12_13-10-2022;Курская область;105_165_days;AllVaccines;125158;33316;158474;604409;285634;890043
2021.12_13-10-2022;Курская область;105_165_days;CoviVac;1185;150;1335;604409;285634;890043
2021.12_13-10-2022;Курская область;105_165_days;EpiVacCorona;1166;423;1589;604409;285634;890043
2021.12_13-10-2022;Курская область;105_165_days;SputnikLite;26354;12850;39204;604409;285634;890043
2021.12_13-10-2022;Курская область;105_165_days;SputnikV;96453;19893;116346;604409;285634;890043
2021.12_13-10-2022;Курская область;165_195_days;AllVaccines;66064;14718;80782;604409;285634;890043
2021.12_13-10-2022;Курская область;165_195_days;CoviVac;397;66;463;604409;285634;890043
2021.12_13-10-2022;Курская область;165_195_days;EpiVacCorona;1305;494;1799;604409;285634;890043
2021.12_13-10-2022;Курская область;165_195_days;SputnikLite;139;31;170;604409;285634;890043
2021.12_13-10-2022;Курская область;165_195_days;SputnikV;64223;14127;78350;604409;285634;890043
2021.12_13-10-2022;Курская область;21_45_days;AllVaccines;44151;23198;67349;604409;285634;890043
2021.12_13-10-2022;Курская область;21_45_days;CoviVac;1386;320;1706;604409;285634;890043
2021.12_13-10-2022;Курская область;21_45_days;EpiVacCorona;2767;1347;4114;604409;285634;890043
2021.12_13-10-2022;Курская область;21_45_days;SputnikLite;14725;8936;23661;604409;285634;890043
2021.12_13-10-2022;Курская область;21_45_days;SputnikV;25273;12595;37868;604409;285634;890043
2021.12_13-10-2022;Курская область;45_75_days;AllVaccines;62558;35510;98068;604409;285634;890043
2021.12_13-10-2022;Курская область;45_75_days;CoviVac;878;195;1073;604409;285634;890043
2021.12_13-10-2022;Курская область;45_75_days;EpiVacCorona;2499;1137;3636;604409;285634;890043
2021.12_13-10-2022;Курская область;45_75_days;SputnikLite;23476;18842;42318;604409;285634;890043
2021.12_13-10-2022;Курская область;45_75_days;SputnikV;35705;15336;51041;604409;285634;890043
2021.12_13-10-2022;Курская область;75_90_days;AllVaccines;18978;13494;32472;604409;285634;890043
2021.12_13-10-2022;Курская область;75_90_days;CoviVac;105;10;115;604409;285634;890043
2021.12_13-10-2022;Курская область;75_90_days;EpiVacCorona;348;186;534;604409;285634;890043
2021.12_13-10-2022;Курская область;75_90_days;SputnikLite;14455;10621;25076;604409;285634;890043
2021.12_13-10-2022;Курская область;75_90_days;SputnikV;4070;2677;6747;604409;285634;890043
2021.12_13-10-2022;Курская область;90_105_days;AllVaccines;12479;7766;20245;604409;285634;890043
2021.12_13-10-2022;Курская область;90_105_days;CoviVac;58;8;66;604409;285634;890043
2021.12_13-10-2022;Курская область;90_105_days;EpiVacCorona;21;18;39;604409;285634;890043
2021.12_13-10-2022;Курская область;90_105_days;SputnikLite;9119;5885;15004;604409;285634;890043
2021.12_13-10-2022;Курская область;90_105_days;SputnikV;3281;1855;5136;604409;285634;890043
2021.12_13-10-2022;Ленинградская область;105_165_days;AllVaccines;166631;46211;212842;1100343;462742;1563085
2021.12_13-10-2022;Ленинградская область;105_165_days;CoviVac;4055;357;4412;1100343;462742;1563085
2021.12_13-10-2022;Ленинградская область;105_165_days;EpiVacCorona;1142;393;1535;1100343;462742;1563085
2021.12_13-10-2022;Ленинградская область;105_165_days;SputnikLite;33873;10153;44026;1100343;462742;1563085
2021.12_13-10-2022;Ленинградская область;105_165_days;SputnikV;127561;35308;162869;1100343;462742;1563085
2021.12_13-10-2022;Ленинградская область;165_195_days;AllVaccines;95218;27646;122864;1100343;462742;1563085
2021.12_13-10-2022;Ленинградская область;165_195_days;CoviVac;2023;217;2240;1100343;462742;1563085
2021.12_13-10-2022;Ленинградская область;165_195_days;EpiVacCorona;5231;2031;7262;1100343;462742;1563085
2021.12_13-10-2022;Ленинградская область;165_195_days;SputnikLite;543;102;645;1100343;462742;1563085
2021.12_13-10-2022;Ленинградская область;165_195_days;SputnikV;87421;25296;112717;1100343;462742;1563085
2021.12_13-10-2022;Ленинградская область;21_45_days;AllVaccines;87881;45327;133208;1100343;462742;1563085
2021.12_13-10-2022;Ленинградская область;21_45_days;CoviVac;886;109;995;1100343;462742;1563085
2021.12_13-10-2022;Ленинградская область;21_45_days;EpiVacCorona;2174;1249;3423;1100343;462742;1563085
2021.12_13-10-2022;Ленинградская область;21_45_days;SputnikLite;19039;16413;35452;1100343;462742;1563085
2021.12_13-10-2022;Ленинградская область;21_45_days;SputnikV;65782;27556;93338;1100343;462742;1563085
2021.12_13-10-2022;Ленинградская область;45_75_days;AllVaccines;86763;41307;128070;1100343;462742;1563085
2021.12_13-10-2022;Ленинградская область;45_75_days;CoviVac;1384;212;1596;1100343;462742;1563085
2021.12_13-10-2022;Ленинградская область;45_75_days;EpiVacCorona;1929;883;2812;1100343;462742;1563085
2021.12_13-10-2022;Ленинградская область;45_75_days;SputnikLite;26531;16736;43267;1100343;462742;1563085
2021.12_13-10-2022;Ленинградская область;45_75_days;SputnikV;56919;23476;80395;1100343;462742;1563085
2021.12_13-10-2022;Ленинградская область;75_90_days;AllVaccines;40203;16672;56875;1100343;462742;1563085
2021.12_13-10-2022;Ленинградская область;75_90_days;CoviVac;499;133;632;1100343;462742;1563085
2021.12_13-10-2022;Ленинградская область;75_90_days;EpiVacCorona;66;22;88;1100343;462742;1563085
2021.12_13-10-2022;Ленинградская область;75_90_days;SputnikLite;30280;12062;42342;1100343;462742;1563085
2021.12_13-10-2022;Ленинградская область;75_90_days;SputnikV;9358;4455;13813;1100343;462742;1563085
2021.12_13-10-2022;Ленинградская область;90_105_days;AllVaccines;18619;9694;28313;1100343;462742;1563085
2021.12_13-10-2022;Ленинградская область;90_105_days;CoviVac;471;78;549;1100343;462742;1563085
2021.12_13-10-2022;Ленинградская область;90_105_days;EpiVacCorona;48;14;62;1100343;462742;1563085
2021.12_13-10-2022;Ленинградская область;90_105_days;SputnikLite;9824;5930;15754;1100343;462742;1563085
2021.12_13-10-2022;Ленинградская область;90_105_days;SputnikV;8276;3672;11948;1100343;462742;1563085
2021.12_13-10-2022;Липецкая область;105_165_days;AllVaccines;105044;25763;130807;621641;290878;912519
2021.12_13-10-2022;Липецкая область;105_165_days;CoviVac;1914;93;2007;621641;290878;912519
2021.12_13-10-2022;Липецкая область;105_165_days;EpiVacCorona;898;420;1318;621641;290878;912519
2021.12_13-10-2022;Липецкая область;105_165_days;SputnikLite;11619;9302;20921;621641;290878;912519
2021.12_13-10-2022;Липецкая область;105_165_days;SputnikV;90613;15948;106561;621641;290878;912519
2021.12_13-10-2022;Липецкая область;165_195_days;AllVaccines;89937;16163;106100;621641;290878;912519
2021.12_13-10-2022;Липецкая область;165_195_days;CoviVac;2376;136;2512;621641;290878;912519
2021.12_13-10-2022;Липецкая область;165_195_days;EpiVacCorona;279;130;409;621641;290878;912519
2021.12_13-10-2022;Липецкая область;165_195_days;SputnikLite;177;21;198;621641;290878;912519
2021.12_13-10-2022;Липецкая область;165_195_days;SputnikV;87105;15876;102981;621641;290878;912519
2021.12_13-10-2022;Липецкая область;21_45_days;AllVaccines;51798;22329;74127;621641;290878;912519
2021.12_13-10-2022;Липецкая область;21_45_days;CoviVac;277;30;307;621641;290878;912519
2021.12_13-10-2022;Липецкая область;21_45_days;EpiVacCorona;2721;972;3693;621641;290878;912519
2021.12_13-10-2022;Липецкая область;21_45_days;SputnikLite;10469;9594;20063;621641;290878;912519
2021.12_13-10-2022;Липецкая область;21_45_days;SputnikV;38331;11733;50064;621641;290878;912519
2021.12_13-10-2022;Липецкая область;45_75_days;AllVaccines;104174;36290;140464;621641;290878;912519
2021.12_13-10-2022;Липецкая область;45_75_days;CoviVac;278;39;317;621641;290878;912519
2021.12_13-10-2022;Липецкая область;45_75_days;EpiVacCorona;4402;778;5180;621641;290878;912519
2021.12_13-10-2022;Липецкая область;45_75_days;SputnikLite;23310;19444;42754;621641;290878;912519
2021.12_13-10-2022;Липецкая область;45_75_days;SputnikV;76184;16029;92213;621641;290878;912519
2021.12_13-10-2022;Липецкая область;75_90_days;AllVaccines;24147;11341;35488;621641;290878;912519
2021.12_13-10-2022;Липецкая область;75_90_days;CoviVac;364;34;398;621641;290878;912519
2021.12_13-10-2022;Липецкая область;75_90_days;EpiVacCorona;408;76;484;621641;290878;912519
2021.12_13-10-2022;Липецкая область;75_90_days;SputnikLite;13312;8629;21941;621641;290878;912519
2021.12_13-10-2022;Липецкая область;75_90_days;SputnikV;10063;2602;12665;621641;290878;912519
2021.12_13-10-2022;Липецкая область;90_105_days;AllVaccines;13159;6996;20155;621641;290878;912519
2021.12_13-10-2022;Липецкая область;90_105_days;CoviVac;252;31;283;621641;290878;912519
2021.12_13-10-2022;Липецкая область;90_105_days;EpiVacCorona;30;26;56;621641;290878;912519
2021.12_13-10-2022;Липецкая область;90_105_days;SputnikLite;7399;4932;12331;621641;290878;912519
2021.12_13-10-2022;Липецкая область;90_105_days;SputnikV;5478;2007;7485;621641;290878;912519
2021.12_13-10-2022;Магаданская область;105_165_days;AllVaccines;13512;2523;16035;83196;26810;110006
2021.12_13-10-2022;Магаданская область;105_165_days;CoviVac;163;32;195;83196;26810;110006
2021.12_13-10-2022;Магаданская область;105_165_days;EpiVacCorona;2;0;2;83196;26810;110006
2021.12_13-10-2022;Магаданская область;105_165_days;SputnikLite;5277;945;6222;83196;26810;110006
2021.12_13-10-2022;Магаданская область;105_165_days;SputnikV;8070;1546;9616;83196;26810;110006
2021.12_13-10-2022;Магаданская область;165_195_days;AllVaccines;7430;1443;8873;83196;26810;110006
2021.12_13-10-2022;Магаданская область;165_195_days;CoviVac;560;128;688;83196;26810;110006
2021.12_13-10-2022;Магаданская область;165_195_days;SputnikLite;110;6;116;83196;26810;110006
2021.12_13-10-2022;Магаданская область;165_195_days;SputnikV;6760;1309;8069;83196;26810;110006
2021.12_13-10-2022;Магаданская область;21_45_days;AllVaccines;7414;1941;9355;83196;26810;110006
2021.12_13-10-2022;Магаданская область;21_45_days;CoviVac;40;5;45;83196;26810;110006
2021.12_13-10-2022;Магаданская область;21_45_days;EpiVacCorona;840;104;944;83196;26810;110006
2021.12_13-10-2022;Магаданская область;21_45_days;SputnikLite;3186;1144;4330;83196;26810;110006
2021.12_13-10-2022;Магаданская область;21_45_days;SputnikV;3348;688;4036;83196;26810;110006
2021.12_13-10-2022;Магаданская область;45_75_days;AllVaccines;6780;2413;9193;83196;26810;110006
2021.12_13-10-2022;Магаданская область;45_75_days;CoviVac;168;46;214;83196;26810;110006
2021.12_13-10-2022;Магаданская область;45_75_days;EpiVacCorona;443;66;509;83196;26810;110006
2021.12_13-10-2022;Магаданская область;45_75_days;SputnikLite;4132;1779;5911;83196;26810;110006
2021.12_13-10-2022;Магаданская область;45_75_days;SputnikV;2037;522;2559;83196;26810;110006
2021.12_13-10-2022;Магаданская область;75_90_days;AllVaccines;3519;996;4515;83196;26810;110006
2021.12_13-10-2022;Магаданская область;75_90_days;CoviVac;62;19;81;83196;26810;110006
2021.12_13-10-2022;Магаданская область;75_90_days;EpiVacCorona;0;1;1;83196;26810;110006
2021.12_13-10-2022;Магаданская область;75_90_days;SputnikLite;3011;854;3865;83196;26810;110006
2021.12_13-10-2022;Магаданская область;75_90_days;SputnikV;446;122;568;83196;26810;110006
2021.12_13-10-2022;Магаданская область;90_105_days;AllVaccines;1518;463;1981;83196;26810;110006
2021.12_13-10-2022;Магаданская область;90_105_days;CoviVac;5;0;5;83196;26810;110006
2021.12_13-10-2022;Магаданская область;90_105_days;SputnikLite;1096;353;1449;83196;26810;110006
2021.12_13-10-2022;Магаданская область;90_105_days;SputnikV;417;110;527;83196;26810;110006
2021.12_13-10-2022;Московская область;105_165_days;AllVaccines;867822;188376;1056198;4485323;1674471;6159794
2021.12_13-10-2022;Московская область;105_165_days;CoviVac;10709;2663;13372;4485323;1674471;6159794
2021.12_13-10-2022;Московская область;105_165_days;EpiVacCorona;6368;3258;9626;4485323;1674471;6159794
2021.12_13-10-2022;Московская область;105_165_days;SputnikLite;48214;35810;84024;4485323;1674471;6159794
2021.12_13-10-2022;Московская область;105_165_days;SputnikV;802531;146645;949176;4485323;1674471;6159794
2021.12_13-10-2022;Московская область;165_195_days;AllVaccines;1074546;152271;1226817;4485323;1674471;6159794
2021.12_13-10-2022;Московская область;165_195_days;CoviVac;12295;2092;14387;4485323;1674471;6159794
2021.12_13-10-2022;Московская область;165_195_days;EpiVacCorona;14118;3861;17979;4485323;1674471;6159794
2021.12_13-10-2022;Московская область;165_195_days;SputnikLite;2666;274;2940;4485323;1674471;6159794
2021.12_13-10-2022;Московская область;165_195_days;SputnikV;1045467;146044;1191511;4485323;1674471;6159794
2021.12_13-10-2022;Московская область;21_45_days;AllVaccines;254651;127296;381947;4485323;1674471;6159794
2021.12_13-10-2022;Московская область;21_45_days;CoviVac;3756;1453;5209;4485323;1674471;6159794
2021.12_13-10-2022;Московская область;21_45_days;EpiVacCorona;4273;3475;7748;4485323;1674471;6159794
2021.12_13-10-2022;Московская область;21_45_days;SputnikLite;51969;44902;96871;4485323;1674471;6159794
2021.12_13-10-2022;Московская область;21_45_days;SputnikV;194653;77466;272119;4485323;1674471;6159794
2021.12_13-10-2022;Московская область;45_75_days;AllVaccines;319557;165726;485283;4485323;1674471;6159794
2021.12_13-10-2022;Московская область;45_75_days;CoviVac;3648;1582;5230;4485323;1674471;6159794
2021.12_13-10-2022;Московская область;45_75_days;EpiVacCorona;5203;4306;9509;4485323;1674471;6159794
2021.12_13-10-2022;Московская область;45_75_days;SputnikLite;72292;65260;137552;4485323;1674471;6159794
2021.12_13-10-2022;Московская область;45_75_days;SputnikV;238414;94578;332992;4485323;1674471;6159794
2021.12_13-10-2022;Московская область;75_90_days;AllVaccines;105065;61540;166605;4485323;1674471;6159794
2021.12_13-10-2022;Московская область;75_90_days;CoviVac;1361;538;1899;4485323;1674471;6159794
2021.12_13-10-2022;Московская область;75_90_days;EpiVacCorona;765;529;1294;4485323;1674471;6159794
2021.12_13-10-2022;Московская область;75_90_days;SputnikLite;44984;42856;87840;4485323;1674471;6159794
2021.12_13-10-2022;Московская область;75_90_days;SputnikV;57955;17617;75572;4485323;1674471;6159794
2021.12_13-10-2022;Московская область;90_105_days;AllVaccines;67371;35131;102502;4485323;1674471;6159794
2021.12_13-10-2022;Московская область;90_105_days;CoviVac;1328;488;1816;4485323;1674471;6159794
2021.12_13-10-2022;Московская область;90_105_days;EpiVacCorona;494;382;876;4485323;1674471;6159794
2021.12_13-10-2022;Московская область;90_105_days;SputnikLite;20521;21896;42417;4485323;1674471;6159794
2021.12_13-10-2022;Московская область;90_105_days;SputnikV;45028;12365;57393;4485323;1674471;6159794
2021.12_13-10-2022;Мурманская область;105_165_days;AllVaccines;87865;14060;101925;436555;144366;580921
2021.12_13-10-2022;Мурманская область;105_165_days;CoviVac;770;81;851;436555;144366;580921
2021.12_13-10-2022;Мурманская область;105_165_days;EpiVacCorona;649;146;795;436555;144366;580921
2021.12_13-10-2022;Мурманская область;105_165_days;SputnikLite;33593;4454;38047;436555;144366;580921
2021.12_13-10-2022;Мурманская область;105_165_days;SputnikV;52853;9379;62232;436555;144366;580921
2021.12_13-10-2022;Мурманская область;165_195_days;AllVaccines;36667;6774;43441;436555;144366;580921
2021.12_13-10-2022;Мурманская область;165_195_days;CoviVac;454;79;533;436555;144366;580921
2021.12_13-10-2022;Мурманская область;165_195_days;EpiVacCorona;194;58;252;436555;144366;580921
2021.12_13-10-2022;Мурманская область;165_195_days;SputnikLite;79;11;90;436555;144366;580921
2021.12_13-10-2022;Мурманская область;165_195_days;SputnikV;35940;6626;42566;436555;144366;580921
2021.12_13-10-2022;Мурманская область;21_45_days;AllVaccines;40744;13197;53941;436555;144366;580921
2021.12_13-10-2022;Мурманская область;21_45_days;CoviVac;741;74;815;436555;144366;580921
2021.12_13-10-2022;Мурманская область;21_45_days;EpiVacCorona;1939;537;2476;436555;144366;580921
2021.12_13-10-2022;Мурманская область;21_45_days;SputnikLite;15754;6330;22084;436555;144366;580921
2021.12_13-10-2022;Мурманская область;21_45_days;SputnikV;22310;6256;28566;436555;144366;580921
2021.12_13-10-2022;Мурманская область;45_75_days;AllVaccines;38657;14089;52746;436555;144366;580921
2021.12_13-10-2022;Мурманская область;45_75_days;CoviVac;579;87;666;436555;144366;580921
2021.12_13-10-2022;Мурманская область;45_75_days;EpiVacCorona;845;460;1305;436555;144366;580921
2021.12_13-10-2022;Мурманская область;45_75_days;SputnikLite;24710;8917;33627;436555;144366;580921
2021.12_13-10-2022;Мурманская область;45_75_days;SputnikV;12523;4625;17148;436555;144366;580921
2021.12_13-10-2022;Мурманская область;75_90_days;AllVaccines;13873;4888;18761;436555;144366;580921
2021.12_13-10-2022;Мурманская область;75_90_days;CoviVac;25;2;27;436555;144366;580921
2021.12_13-10-2022;Мурманская область;75_90_days;EpiVacCorona;82;36;118;436555;144366;580921
2021.12_13-10-2022;Мурманская область;75_90_days;SputnikLite;8654;3678;12332;436555;144366;580921
2021.12_13-10-2022;Мурманская область;75_90_days;SputnikV;5112;1172;6284;436555;144366;580921
2021.12_13-10-2022;Мурманская область;90_105_days;AllVaccines;9300;3156;12456;436555;144366;580921
2021.12_13-10-2022;Мурманская область;90_105_days;CoviVac;37;7;44;436555;144366;580921
2021.12_13-10-2022;Мурманская область;90_105_days;EpiVacCorona;62;20;82;436555;144366;580921
2021.12_13-10-2022;Мурманская область;90_105_days;SputnikLite;4528;2133;6661;436555;144366;580921
2021.12_13-10-2022;Мурманская область;90_105_days;SputnikV;4673;996;5669;436555;144366;580921
2021.12_13-10-2022;Ненецкий автономный округ;105_165_days;AllVaccines;2285;601;2886;24931;7449;32380
2021.12_13-10-2022;Ненецкий автономный округ;105_165_days;CoviVac;122;21;143;24931;7449;32380
2021.12_13-10-2022;Ненецкий автономный округ;105_165_days;EpiVacCorona;657;96;753;24931;7449;32380
2021.12_13-10-2022;Ненецкий автономный округ;105_165_days;SputnikLite;964;377;1341;24931;7449;32380
2021.12_13-10-2022;Ненецкий автономный округ;105_165_days;SputnikV;542;107;649;24931;7449;32380
2021.12_13-10-2022;Ненецкий автономный округ;165_195_days;AllVaccines;2297;498;2795;24931;7449;32380
2021.12_13-10-2022;Ненецкий автономный округ;165_195_days;CoviVac;339;45;384;24931;7449;32380
2021.12_13-10-2022;Ненецкий автономный округ;165_195_days;EpiVacCorona;1451;336;1787;24931;7449;32380
2021.12_13-10-2022;Ненецкий автономный округ;165_195_days;SputnikLite;27;15;42;24931;7449;32380
2021.12_13-10-2022;Ненецкий автономный округ;165_195_days;SputnikV;480;102;582;24931;7449;32380
2021.12_13-10-2022;Ненецкий автономный округ;21_45_days;AllVaccines;1538;469;2007;24931;7449;32380
2021.12_13-10-2022;Ненецкий автономный округ;21_45_days;EpiVacCorona;65;11;76;24931;7449;32380
2021.12_13-10-2022;Ненецкий автономный округ;21_45_days;SputnikLite;1057;390;1447;24931;7449;32380
2021.12_13-10-2022;Ненецкий автономный округ;21_45_days;SputnikV;416;68;484;24931;7449;32380
2021.12_13-10-2022;Ненецкий автономный округ;45_75_days;AllVaccines;2642;855;3497;24931;7449;32380
2021.12_13-10-2022;Ненецкий автономный округ;45_75_days;CoviVac;3;0;3;24931;7449;32380
2021.12_13-10-2022;Ненецкий автономный округ;45_75_days;EpiVacCorona;51;5;56;24931;7449;32380
2021.12_13-10-2022;Ненецкий автономный округ;45_75_days;SputnikLite;2230;769;2999;24931;7449;32380
2021.12_13-10-2022;Ненецкий автономный округ;45_75_days;SputnikV;358;81;439;24931;7449;32380
2021.12_13-10-2022;Ненецкий автономный округ;75_90_days;AllVaccines;897;360;1257;24931;7449;32380
2021.12_13-10-2022;Ненецкий автономный округ;75_90_days;CoviVac;47;1;48;24931;7449;32380
2021.12_13-10-2022;Ненецкий автономный округ;75_90_days;EpiVacCorona;7;7;14;24931;7449;32380
2021.12_13-10-2022;Ненецкий автономный округ;75_90_days;SputnikLite;806;344;1150;24931;7449;32380
2021.12_13-10-2022;Ненецкий автономный округ;75_90_days;SputnikV;37;8;45;24931;7449;32380
2021.12_13-10-2022;Ненецкий автономный округ;90_105_days;AllVaccines;353;204;557;24931;7449;32380
2021.12_13-10-2022;Ненецкий автономный округ;90_105_days;CoviVac;15;0;15;24931;7449;32380
2021.12_13-10-2022;Ненецкий автономный округ;90_105_days;EpiVacCorona;7;1;8;24931;7449;32380
2021.12_13-10-2022;Ненецкий автономный округ;90_105_days;SputnikLite;314;199;513;24931;7449;32380
2021.12_13-10-2022;Ненецкий автономный округ;90_105_days;SputnikV;17;4;21;24931;7449;32380
2021.12_13-10-2022;Нижегородская область;105_165_days;AllVaccines;276668;69156;345824;1769909;800663;2570572
2021.12_13-10-2022;Нижегородская область;105_165_days;CoviVac;5625;767;6392;1769909;800663;2570572
2021.12_13-10-2022;Нижегородская область;105_165_days;EpiVacCorona;7798;2924;10722;1769909;800663;2570572
2021.12_13-10-2022;Нижегородская область;105_165_days;SputnikLite;91154;24468;115622;1769909;800663;2570572
2021.12_13-10-2022;Нижегородская область;105_165_days;SputnikV;172091;40997;213088;1769909;800663;2570572
2021.12_13-10-2022;Нижегородская область;165_195_days;AllVaccines;205906;41713;247619;1769909;800663;2570572
2021.12_13-10-2022;Нижегородская область;165_195_days;CoviVac;11507;1334;12841;1769909;800663;2570572
2021.12_13-10-2022;Нижегородская область;165_195_days;EpiVacCorona;2895;827;3722;1769909;800663;2570572
2021.12_13-10-2022;Нижегородская область;165_195_days;SputnikLite;11813;960;12773;1769909;800663;2570572
2021.12_13-10-2022;Нижегородская область;165_195_days;SputnikV;179691;38592;218283;1769909;800663;2570572
2021.12_13-10-2022;Нижегородская область;21_45_days;AllVaccines;130141;81168;211309;1769909;800663;2570572
2021.12_13-10-2022;Нижегородская область;21_45_days;CoviVac;368;88;456;1769909;800663;2570572
2021.12_13-10-2022;Нижегородская область;21_45_days;EpiVacCorona;3180;2188;5368;1769909;800663;2570572
2021.12_13-10-2022;Нижегородская область;21_45_days;SputnikLite;36544;32583;69127;1769909;800663;2570572
2021.12_13-10-2022;Нижегородская область;21_45_days;SputnikV;90049;46309;136358;1769909;800663;2570572
2021.12_13-10-2022;Нижегородская область;45_75_days;AllVaccines;168220;89148;257368;1769909;800663;2570572
2021.12_13-10-2022;Нижегородская область;45_75_days;CoviVac;1027;189;1216;1769909;800663;2570572
2021.12_13-10-2022;Нижегородская область;45_75_days;EpiVacCorona;3298;1783;5081;1769909;800663;2570572
2021.12_13-10-2022;Нижегородская область;45_75_days;SputnikLite;47259;40010;87269;1769909;800663;2570572
2021.12_13-10-2022;Нижегородская область;45_75_days;SputnikV;116636;47166;163802;1769909;800663;2570572
2021.12_13-10-2022;Нижегородская область;75_90_days;AllVaccines;80339;33369;113708;1769909;800663;2570572
2021.12_13-10-2022;Нижегородская область;75_90_days;CoviVac;680;132;812;1769909;800663;2570572
2021.12_13-10-2022;Нижегородская область;75_90_days;EpiVacCorona;358;247;605;1769909;800663;2570572
2021.12_13-10-2022;Нижегородская область;75_90_days;SputnikLite;64725;25584;90309;1769909;800663;2570572
2021.12_13-10-2022;Нижегородская область;75_90_days;SputnikV;14576;7406;21982;1769909;800663;2570572
2021.12_13-10-2022;Нижегородская область;90_105_days;AllVaccines;37088;17254;54342;1769909;800663;2570572
2021.12_13-10-2022;Нижегородская область;90_105_days;CoviVac;594;139;733;1769909;800663;2570572
2021.12_13-10-2022;Нижегородская область;90_105_days;EpiVacCorona;207;159;366;1769909;800663;2570572
2021.12_13-10-2022;Нижегородская область;90_105_days;SputnikLite;26134;11948;38082;1769909;800663;2570572
2021.12_13-10-2022;Нижегородская область;90_105_days;SputnikV;10153;5008;15161;1769909;800663;2570572
2021.12_13-10-2022;Новгородская область;105_165_days;AllVaccines;49873;15184;65057;317276;158308;475584
2021.12_13-10-2022;Новгородская область;105_165_days;CoviVac;296;56;352;317276;158308;475584
2021.12_13-10-2022;Новгородская область;105_165_days;EpiVacCorona;398;126;524;317276;158308;475584
2021.12_13-10-2022;Новгородская область;105_165_days;SputnikLite;23326;6410;29736;317276;158308;475584
2021.12_13-10-2022;Новгородская область;105_165_days;SputnikV;25853;8592;34445;317276;158308;475584
2021.12_13-10-2022;Новгородская область;165_195_days;AllVaccines;25084;8680;33764;317276;158308;475584
2021.12_13-10-2022;Новгородская область;165_195_days;CoviVac;553;98;651;317276;158308;475584
2021.12_13-10-2022;Новгородская область;165_195_days;EpiVacCorona;19;3;22;317276;158308;475584
2021.12_13-10-2022;Новгородская область;165_195_days;SputnikLite;860;77;937;317276;158308;475584
2021.12_13-10-2022;Новгородская область;165_195_days;SputnikV;23652;8502;32154;317276;158308;475584
2021.12_13-10-2022;Новгородская область;21_45_days;AllVaccines;20975;13485;34460;317276;158308;475584
2021.12_13-10-2022;Новгородская область;21_45_days;CoviVac;719;249;968;317276;158308;475584
2021.12_13-10-2022;Новгородская область;21_45_days;EpiVacCorona;1696;892;2588;317276;158308;475584
2021.12_13-10-2022;Новгородская область;21_45_days;SputnikLite;4904;4863;9767;317276;158308;475584
2021.12_13-10-2022;Новгородская область;21_45_days;SputnikV;13656;7481;21137;317276;158308;475584
2021.12_13-10-2022;Новгородская область;45_75_days;AllVaccines;24995;15506;40501;317276;158308;475584
2021.12_13-10-2022;Новгородская область;45_75_days;CoviVac;356;104;460;317276;158308;475584
2021.12_13-10-2022;Новгородская область;45_75_days;EpiVacCorona;870;352;1222;317276;158308;475584
2021.12_13-10-2022;Новгородская область;45_75_days;SputnikLite;11645;8717;20362;317276;158308;475584
2021.12_13-10-2022;Новгородская область;45_75_days;SputnikV;12124;6333;18457;317276;158308;475584
2021.12_13-10-2022;Новгородская область;75_90_days;AllVaccines;15545;6428;21973;317276;158308;475584
2021.12_13-10-2022;Новгородская область;75_90_days;CoviVac;27;4;31;317276;158308;475584
2021.12_13-10-2022;Новгородская область;75_90_days;EpiVacCorona;35;27;62;317276;158308;475584
2021.12_13-10-2022;Новгородская область;75_90_days;SputnikLite;14491;5627;20118;317276;158308;475584
2021.12_13-10-2022;Новгородская область;75_90_days;SputnikV;992;770;1762;317276;158308;475584
2021.12_13-10-2022;Новгородская область;90_105_days;AllVaccines;6404;3259;9663;317276;158308;475584
2021.12_13-10-2022;Новгородская область;90_105_days;CoviVac;7;1;8;317276;158308;475584
2021.12_13-10-2022;Новгородская область;90_105_days;EpiVacCorona;29;28;57;317276;158308;475584
2021.12_13-10-2022;Новгородская область;90_105_days;SputnikLite;5491;2700;8191;317276;158308;475584
2021.12_13-10-2022;Новгородская область;90_105_days;SputnikV;877;530;1407;317276;158308;475584
2021.12_13-10-2022;Новосибирская область;105_165_days;AllVaccines;155891;49657;205548;1571829;624100;2195929
2021.12_13-10-2022;Новосибирская область;105_165_days;CoviVac;3120;478;3598;1571829;624100;2195929
2021.12_13-10-2022;Новосибирская область;105_165_days;EpiVacCorona;5615;3075;8690;1571829;624100;2195929
2021.12_13-10-2022;Новосибирская область;105_165_days;SputnikLite;47444;15091;62535;1571829;624100;2195929
2021.12_13-10-2022;Новосибирская область;105_165_days;SputnikV;99712;31013;130725;1571829;624100;2195929
2021.12_13-10-2022;Новосибирская область;165_195_days;AllVaccines;121192;40882;162074;1571829;624100;2195929
2021.12_13-10-2022;Новосибирская область;165_195_days;CoviVac;4871;632;5503;1571829;624100;2195929
2021.12_13-10-2022;Новосибирская область;165_195_days;EpiVacCorona;3107;2015;5122;1571829;624100;2195929
2021.12_13-10-2022;Новосибирская область;165_195_days;SputnikLite;5145;365;5510;1571829;624100;2195929
2021.12_13-10-2022;Новосибирская область;165_195_days;SputnikV;108069;37870;145939;1571829;624100;2195929
2021.12_13-10-2022;Новосибирская область;21_45_days;AllVaccines;192995;78142;271137;1571829;624100;2195929
2021.12_13-10-2022;Новосибирская область;21_45_days;CoviVac;215;62;277;1571829;624100;2195929
2021.12_13-10-2022;Новосибирская область;21_45_days;EpiVacCorona;4478;1583;6061;1571829;624100;2195929
2021.12_13-10-2022;Новосибирская область;21_45_days;SputnikLite;40830;33783;74613;1571829;624100;2195929
2021.12_13-10-2022;Новосибирская область;21_45_days;SputnikV;147472;42714;190186;1571829;624100;2195929
2021.12_13-10-2022;Новосибирская область;45_75_days;AllVaccines;142071;53593;195664;1571829;624100;2195929
2021.12_13-10-2022;Новосибирская область;45_75_days;CoviVac;1166;142;1308;1571829;624100;2195929
2021.12_13-10-2022;Новосибирская область;45_75_days;EpiVacCorona;4537;1413;5950;1571829;624100;2195929
2021.12_13-10-2022;Новосибирская область;45_75_days;SputnikLite;28957;19287;48244;1571829;624100;2195929
2021.12_13-10-2022;Новосибирская область;45_75_days;SputnikV;107411;32751;140162;1571829;624100;2195929
2021.12_13-10-2022;Новосибирская область;75_90_days;AllVaccines;55259;22282;77541;1571829;624100;2195929
2021.12_13-10-2022;Новосибирская область;75_90_days;CoviVac;637;125;762;1571829;624100;2195929
2021.12_13-10-2022;Новосибирская область;75_90_days;EpiVacCorona;375;225;600;1571829;624100;2195929
2021.12_13-10-2022;Новосибирская область;75_90_days;SputnikLite;44319;16294;60613;1571829;624100;2195929
2021.12_13-10-2022;Новосибирская область;75_90_days;SputnikV;9928;5638;15566;1571829;624100;2195929
2021.12_13-10-2022;Новосибирская область;90_105_days;AllVaccines;21291;11294;32585;1571829;624100;2195929
2021.12_13-10-2022;Новосибирская область;90_105_days;CoviVac;684;194;878;1571829;624100;2195929
2021.12_13-10-2022;Новосибирская область;90_105_days;EpiVacCorona;251;173;424;1571829;624100;2195929
2021.12_13-10-2022;Новосибирская область;90_105_days;SputnikLite;12202;7540;19742;1571829;624100;2195929
2021.12_13-10-2022;Новосибирская область;90_105_days;SputnikV;8154;3387;11541;1571829;624100;2195929
2021.12_13-10-2022;Омская область;105_165_days;AllVaccines;202779;38487;241266;1058291;431046;1489337
2021.12_13-10-2022;Омская область;105_165_days;CoviVac;2656;450;3106;1058291;431046;1489337
2021.12_13-10-2022;Омская область;105_165_days;EpiVacCorona;3407;967;4374;1058291;431046;1489337
2021.12_13-10-2022;Омская область;105_165_days;SputnikLite;41695;9768;51463;1058291;431046;1489337
2021.12_13-10-2022;Омская область;105_165_days;SputnikV;155021;27302;182323;1058291;431046;1489337
2021.12_13-10-2022;Омская область;165_195_days;AllVaccines;99116;23842;122958;1058291;431046;1489337
2021.12_13-10-2022;Омская область;165_195_days;CoviVac;2152;286;2438;1058291;431046;1489337
2021.12_13-10-2022;Омская область;165_195_days;EpiVacCorona;2526;886;3412;1058291;431046;1489337
2021.12_13-10-2022;Омская область;165_195_days;SputnikLite;1472;112;1584;1058291;431046;1489337
2021.12_13-10-2022;Омская область;165_195_days;SputnikV;92966;22558;115524;1058291;431046;1489337
2021.12_13-10-2022;Омская область;21_45_days;AllVaccines;110797;46689;157486;1058291;431046;1489337
2021.12_13-10-2022;Омская область;21_45_days;CoviVac;488;130;618;1058291;431046;1489337
2021.12_13-10-2022;Омская область;21_45_days;EpiVacCorona;2692;1044;3736;1058291;431046;1489337
2021.12_13-10-2022;Омская область;21_45_days;SputnikLite;22450;15027;37477;1058291;431046;1489337
2021.12_13-10-2022;Омская область;21_45_days;SputnikV;85167;30488;115655;1058291;431046;1489337
2021.12_13-10-2022;Омская область;45_75_days;AllVaccines;96190;40635;136825;1058291;431046;1489337
2021.12_13-10-2022;Омская область;45_75_days;CoviVac;983;234;1217;1058291;431046;1489337
2021.12_13-10-2022;Омская область;45_75_days;EpiVacCorona;3094;964;4058;1058291;431046;1489337
2021.12_13-10-2022;Омская область;45_75_days;SputnikLite;21161;13166;34327;1058291;431046;1489337
2021.12_13-10-2022;Омская область;45_75_days;SputnikV;70952;26271;97223;1058291;431046;1489337
2021.12_13-10-2022;Омская область;75_90_days;AllVaccines;25043;11949;36992;1058291;431046;1489337
2021.12_13-10-2022;Омская область;75_90_days;CoviVac;209;77;286;1058291;431046;1489337
2021.12_13-10-2022;Омская область;75_90_days;EpiVacCorona;232;193;425;1058291;431046;1489337
2021.12_13-10-2022;Омская область;75_90_days;SputnikLite;16512;8229;24741;1058291;431046;1489337
2021.12_13-10-2022;Омская область;75_90_days;SputnikV;8090;3450;11540;1058291;431046;1489337
2021.12_13-10-2022;Омская область;90_105_days;AllVaccines;13664;6927;20591;1058291;431046;1489337
2021.12_13-10-2022;Омская область;90_105_days;CoviVac;201;49;250;1058291;431046;1489337
2021.12_13-10-2022;Омская область;90_105_days;EpiVacCorona;201;101;302;1058291;431046;1489337
2021.12_13-10-2022;Омская область;90_105_days;SputnikLite;6942;4785;11727;1058291;431046;1489337
2021.12_13-10-2022;Омская область;90_105_days;SputnikV;6320;1992;8312;1058291;431046;1489337
2021.12_13-10-2022;Оренбургская область;105_165_days;AllVaccines;160883;42752;203635;1068899;440686;1509585
2021.12_13-10-2022;Оренбургская область;105_165_days;CoviVac;1436;201;1637;1068899;440686;1509585
2021.12_13-10-2022;Оренбургская область;105_165_days;EpiVacCorona;2148;600;2748;1068899;440686;1509585
2021.12_13-10-2022;Оренбургская область;105_165_days;SputnikLite;13492;12046;25538;1068899;440686;1509585
2021.12_13-10-2022;Оренбургская область;105_165_days;SputnikV;143807;29905;173712;1068899;440686;1509585
2021.12_13-10-2022;Оренбургская область;165_195_days;AllVaccines;115407;25773;141180;1068899;440686;1509585
2021.12_13-10-2022;Оренбургская область;165_195_days;CoviVac;540;52;592;1068899;440686;1509585
2021.12_13-10-2022;Оренбургская область;165_195_days;EpiVacCorona;399;164;563;1068899;440686;1509585
2021.12_13-10-2022;Оренбургская область;165_195_days;SputnikLite;72;13;85;1068899;440686;1509585
2021.12_13-10-2022;Оренбургская область;165_195_days;SputnikV;114396;25544;139940;1068899;440686;1509585
2021.12_13-10-2022;Оренбургская область;21_45_days;AllVaccines;73711;41038;114749;1068899;440686;1509585
2021.12_13-10-2022;Оренбургская область;21_45_days;CoviVac;779;115;894;1068899;440686;1509585
2021.12_13-10-2022;Оренбургская область;21_45_days;EpiVacCorona;4827;2281;7108;1068899;440686;1509585
2021.12_13-10-2022;Оренбургская область;21_45_days;SputnikLite;24456;19098;43554;1068899;440686;1509585
2021.12_13-10-2022;Оренбургская область;21_45_days;SputnikV;43649;19544;63193;1068899;440686;1509585
2021.12_13-10-2022;Оренбургская область;45_75_days;AllVaccines;124073;57035;181108;1068899;440686;1509585
2021.12_13-10-2022;Оренбургская область;45_75_days;CoviVac;1332;221;1553;1068899;440686;1509585
2021.12_13-10-2022;Оренбургская область;45_75_days;EpiVacCorona;4433;1524;5957;1068899;440686;1509585
2021.12_13-10-2022;Оренбургская область;45_75_days;SputnikLite;26602;27396;53998;1068899;440686;1509585
2021.12_13-10-2022;Оренбургская область;45_75_days;SputnikV;91706;27894;119600;1068899;440686;1509585
2021.12_13-10-2022;Оренбургская область;75_90_days;AllVaccines;24832;16035;40867;1068899;440686;1509585
2021.12_13-10-2022;Оренбургская область;75_90_days;CoviVac;222;28;250;1068899;440686;1509585
2021.12_13-10-2022;Оренбургская область;75_90_days;EpiVacCorona;177;74;251;1068899;440686;1509585
2021.12_13-10-2022;Оренбургская область;75_90_days;SputnikLite;12760;11747;24507;1068899;440686;1509585
2021.12_13-10-2022;Оренбургская область;75_90_days;SputnikV;11673;4186;15859;1068899;440686;1509585
2021.12_13-10-2022;Оренбургская область;90_105_days;AllVaccines;16746;9642;26388;1068899;440686;1509585
2021.12_13-10-2022;Оренбургская область;90_105_days;CoviVac;230;52;282;1068899;440686;1509585
2021.12_13-10-2022;Оренбургская область;90_105_days;EpiVacCorona;63;49;112;1068899;440686;1509585
2021.12_13-10-2022;Оренбургская область;90_105_days;SputnikLite;5716;6114;11830;1068899;440686;1509585
2021.12_13-10-2022;Оренбургская область;90_105_days;SputnikV;10737;3427;14164;1068899;440686;1509585
2021.12_13-10-2022;Орловская область;105_165_days;AllVaccines;71230;20582;91812;398663;193123;591786
2021.12_13-10-2022;Орловская область;105_165_days;CoviVac;18;10;28;398663;193123;591786
2021.12_13-10-2022;Орловская область;105_165_days;EpiVacCorona;7323;1644;8967;398663;193123;591786
2021.12_13-10-2022;Орловская область;105_165_days;SputnikLite;19368;7009;26377;398663;193123;591786
2021.12_13-10-2022;Орловская область;105_165_days;SputnikV;44521;11919;56440;398663;193123;591786
2021.12_13-10-2022;Орловская область;165_195_days;AllVaccines;44402;10437;54839;398663;193123;591786
2021.12_13-10-2022;Орловская область;165_195_days;CoviVac;75;9;84;398663;193123;591786
2021.12_13-10-2022;Орловская область;165_195_days;EpiVacCorona;1877;629;2506;398663;193123;591786
2021.12_13-10-2022;Орловская область;165_195_days;SputnikLite;340;43;383;398663;193123;591786
2021.12_13-10-2022;Орловская область;165_195_days;SputnikV;42110;9756;51866;398663;193123;591786
2021.12_13-10-2022;Орловская область;21_45_days;AllVaccines;46042;20404;66446;398663;193123;591786
2021.12_13-10-2022;Орловская область;21_45_days;CoviVac;1517;422;1939;398663;193123;591786
2021.12_13-10-2022;Орловская область;21_45_days;EpiVacCorona;503;250;753;398663;193123;591786
2021.12_13-10-2022;Орловская область;21_45_days;SputnikLite;7838;7225;15063;398663;193123;591786
2021.12_13-10-2022;Орловская область;21_45_days;SputnikV;36184;12507;48691;398663;193123;591786
2021.12_13-10-2022;Орловская область;45_75_days;AllVaccines;42370;19994;62364;398663;193123;591786
2021.12_13-10-2022;Орловская область;45_75_days;CoviVac;894;190;1084;398663;193123;591786
2021.12_13-10-2022;Орловская область;45_75_days;EpiVacCorona;431;246;677;398663;193123;591786
2021.12_13-10-2022;Орловская область;45_75_days;SputnikLite;12715;10174;22889;398663;193123;591786
2021.12_13-10-2022;Орловская область;45_75_days;SputnikV;28330;9384;37714;398663;193123;591786
2021.12_13-10-2022;Орловская область;75_90_days;AllVaccines;20985;9329;30314;398663;193123;591786
2021.12_13-10-2022;Орловская область;75_90_days;CoviVac;1;0;1;398663;193123;591786
2021.12_13-10-2022;Орловская область;75_90_days;EpiVacCorona;84;33;117;398663;193123;591786
2021.12_13-10-2022;Орловская область;75_90_days;SputnikLite;18742;7913;26655;398663;193123;591786
2021.12_13-10-2022;Орловская область;75_90_days;SputnikV;2158;1383;3541;398663;193123;591786
2021.12_13-10-2022;Орловская область;90_105_days;AllVaccines;6792;4610;11402;398663;193123;591786
2021.12_13-10-2022;Орловская область;90_105_days;CoviVac;2;0;2;398663;193123;591786
2021.12_13-10-2022;Орловская область;90_105_days;EpiVacCorona;68;30;98;398663;193123;591786
2021.12_13-10-2022;Орловская область;90_105_days;SputnikLite;4719;3528;8247;398663;193123;591786
2021.12_13-10-2022;Орловская область;90_105_days;SputnikV;2003;1052;3055;398663;193123;591786
2021.12_13-10-2022;Пензенская область;105_165_days;AllVaccines;135757;54119;189876;710438;350687;1061125
2021.12_13-10-2022;Пензенская область;105_165_days;CoviVac;1036;108;1144;710438;350687;1061125
2021.12_13-10-2022;Пензенская область;105_165_days;EpiVacCorona;2826;1378;4204;710438;350687;1061125
2021.12_13-10-2022;Пензенская область;105_165_days;SputnikLite;63635;18201;81836;710438;350687;1061125
2021.12_13-10-2022;Пензенская область;105_165_days;SputnikV;68260;34432;102692;710438;350687;1061125
2021.12_13-10-2022;Пензенская область;165_195_days;AllVaccines;68995;21696;90691;710438;350687;1061125
2021.12_13-10-2022;Пензенская область;165_195_days;CoviVac;441;47;488;710438;350687;1061125
2021.12_13-10-2022;Пензенская область;165_195_days;EpiVacCorona;3903;1149;5052;710438;350687;1061125
2021.12_13-10-2022;Пензенская область;165_195_days;SputnikLite;561;61;622;710438;350687;1061125
2021.12_13-10-2022;Пензенская область;165_195_days;SputnikV;64090;20439;84529;710438;350687;1061125
2021.12_13-10-2022;Пензенская область;21_45_days;AllVaccines;58741;39864;98605;710438;350687;1061125
2021.12_13-10-2022;Пензенская область;21_45_days;CoviVac;761;211;972;710438;350687;1061125
2021.12_13-10-2022;Пензенская область;21_45_days;EpiVacCorona;689;567;1256;710438;350687;1061125
2021.12_13-10-2022;Пензенская область;21_45_days;SputnikLite;15327;10183;25510;710438;350687;1061125
2021.12_13-10-2022;Пензенская область;21_45_days;SputnikV;41964;28903;70867;710438;350687;1061125
2021.12_13-10-2022;Пензенская область;45_75_days;AllVaccines;123977;45292;169269;710438;350687;1061125
2021.12_13-10-2022;Пензенская область;45_75_days;CoviVac;1458;200;1658;710438;350687;1061125
2021.12_13-10-2022;Пензенская область;45_75_days;EpiVacCorona;2479;574;3053;710438;350687;1061125
2021.12_13-10-2022;Пензенская область;45_75_days;SputnikLite;8522;5086;13608;710438;350687;1061125
2021.12_13-10-2022;Пензенская область;45_75_days;SputnikV;111518;39432;150950;710438;350687;1061125
2021.12_13-10-2022;Пензенская область;75_90_days;AllVaccines;13924;8336;22260;710438;350687;1061125
2021.12_13-10-2022;Пензенская область;75_90_days;CoviVac;95;14;109;710438;350687;1061125
2021.12_13-10-2022;Пензенская область;75_90_days;EpiVacCorona;306;97;403;710438;350687;1061125
2021.12_13-10-2022;Пензенская область;75_90_days;SputnikLite;6099;1210;7309;710438;350687;1061125
2021.12_13-10-2022;Пензенская область;75_90_days;SputnikV;7424;7015;14439;710438;350687;1061125
2021.12_13-10-2022;Пензенская область;90_105_days;AllVaccines;27010;13644;40654;710438;350687;1061125
2021.12_13-10-2022;Пензенская область;90_105_days;CoviVac;37;6;43;710438;350687;1061125
2021.12_13-10-2022;Пензенская область;90_105_days;EpiVacCorona;91;50;141;710438;350687;1061125
2021.12_13-10-2022;Пензенская область;90_105_days;SputnikLite;18493;4703;23196;710438;350687;1061125
2021.12_13-10-2022;Пензенская область;90_105_days;SputnikV;8389;8885;17274;710438;350687;1061125
2021.12_13-10-2022;Пермский край;105_165_days;AllVaccines;257749;61212;318961;1423011;574038;1997049
2021.12_13-10-2022;Пермский край;105_165_days;CoviVac;4128;547;4675;1423011;574038;1997049
2021.12_13-10-2022;Пермский край;105_165_days;EpiVacCorona;5421;1450;6871;1423011;574038;1997049
2021.12_13-10-2022;Пермский край;105_165_days;SputnikLite;60051;18893;78944;1423011;574038;1997049
2021.12_13-10-2022;Пермский край;105_165_days;SputnikV;188149;40322;228471;1423011;574038;1997049
2021.12_13-10-2022;Пермский край;165_195_days;AllVaccines;105551;29338;134889;1423011;574038;1997049
2021.12_13-10-2022;Пермский край;165_195_days;CoviVac;1653;260;1913;1423011;574038;1997049
2021.12_13-10-2022;Пермский край;165_195_days;EpiVacCorona;6370;2620;8990;1423011;574038;1997049
2021.12_13-10-2022;Пермский край;165_195_days;SputnikLite;941;116;1057;1423011;574038;1997049
2021.12_13-10-2022;Пермский край;165_195_days;SputnikV;96587;26342;122929;1423011;574038;1997049
2021.12_13-10-2022;Пермский край;21_45_days;AllVaccines;126891;61346;188237;1423011;574038;1997049
2021.12_13-10-2022;Пермский край;21_45_days;CoviVac;970;222;1192;1423011;574038;1997049
2021.12_13-10-2022;Пермский край;21_45_days;EpiVacCorona;1317;473;1790;1423011;574038;1997049
2021.12_13-10-2022;Пермский край;21_45_days;SputnikLite;27745;26351;54096;1423011;574038;1997049
2021.12_13-10-2022;Пермский край;21_45_days;SputnikV;96859;34300;131159;1423011;574038;1997049
2021.12_13-10-2022;Пермский край;45_75_days;AllVaccines;128514;55763;184277;1423011;574038;1997049
2021.12_13-10-2022;Пермский край;45_75_days;CoviVac;1298;272;1570;1423011;574038;1997049
2021.12_13-10-2022;Пермский край;45_75_days;EpiVacCorona;2174;767;2941;1423011;574038;1997049
2021.12_13-10-2022;Пермский край;45_75_days;SputnikLite;21265;19200;40465;1423011;574038;1997049
2021.12_13-10-2022;Пермский край;45_75_days;SputnikV;103777;35524;139301;1423011;574038;1997049
2021.12_13-10-2022;Пермский край;75_90_days;AllVaccines;45250;16965;62215;1423011;574038;1997049
2021.12_13-10-2022;Пермский край;75_90_days;CoviVac;524;150;674;1423011;574038;1997049
2021.12_13-10-2022;Пермский край;75_90_days;EpiVacCorona;380;199;579;1423011;574038;1997049
2021.12_13-10-2022;Пермский край;75_90_days;SputnikLite;28634;11374;40008;1423011;574038;1997049
2021.12_13-10-2022;Пермский край;75_90_days;SputnikV;15712;5242;20954;1423011;574038;1997049
2021.12_13-10-2022;Пермский край;90_105_days;AllVaccines;27827;12444;40271;1423011;574038;1997049
2021.12_13-10-2022;Пермский край;90_105_days;CoviVac;527;132;659;1423011;574038;1997049
2021.12_13-10-2022;Пермский край;90_105_days;EpiVacCorona;270;116;386;1423011;574038;1997049
2021.12_13-10-2022;Пермский край;90_105_days;SputnikLite;15138;8325;23463;1423011;574038;1997049
2021.12_13-10-2022;Пермский край;90_105_days;SputnikV;11892;3871;15763;1423011;574038;1997049
2021.12_13-10-2022;Приморский край;105_165_days;AllVaccines;101353;27876;129229;1086430;416518;1502948
2021.12_13-10-2022;Приморский край;105_165_days;CoviVac;1532;144;1676;1086430;416518;1502948
2021.12_13-10-2022;Приморский край;105_165_days;EpiVacCorona;2247;922;3169;1086430;416518;1502948
2021.12_13-10-2022;Приморский край;105_165_days;SputnikLite;16976;7174;24150;1086430;416518;1502948
2021.12_13-10-2022;Приморский край;105_165_days;SputnikV;80598;19636;100234;1086430;416518;1502948
2021.12_13-10-2022;Приморский край;165_195_days;AllVaccines;71754;25148;96902;1086430;416518;1502948
2021.12_13-10-2022;Приморский край;165_195_days;CoviVac;421;25;446;1086430;416518;1502948
2021.12_13-10-2022;Приморский край;165_195_days;EpiVacCorona;3512;1429;4941;1086430;416518;1502948
2021.12_13-10-2022;Приморский край;165_195_days;SputnikLite;12;3;15;1086430;416518;1502948
2021.12_13-10-2022;Приморский край;165_195_days;SputnikV;67809;23691;91500;1086430;416518;1502948
2021.12_13-10-2022;Приморский край;21_45_days;AllVaccines;154249;45172;199421;1086430;416518;1502948
2021.12_13-10-2022;Приморский край;21_45_days;CoviVac;1054;95;1149;1086430;416518;1502948
2021.12_13-10-2022;Приморский край;21_45_days;EpiVacCorona;1394;691;2085;1086430;416518;1502948
2021.12_13-10-2022;Приморский край;21_45_days;SputnikLite;21992;17504;39496;1086430;416518;1502948
2021.12_13-10-2022;Приморский край;21_45_days;SputnikV;129809;26882;156691;1086430;416518;1502948
2021.12_13-10-2022;Приморский край;45_75_days;AllVaccines;150063;36532;186595;1086430;416518;1502948
2021.12_13-10-2022;Приморский край;45_75_days;CoviVac;3166;279;3445;1086430;416518;1502948
2021.12_13-10-2022;Приморский край;45_75_days;EpiVacCorona;2185;640;2825;1086430;416518;1502948
2021.12_13-10-2022;Приморский край;45_75_days;SputnikLite;26608;13657;40265;1086430;416518;1502948
2021.12_13-10-2022;Приморский край;45_75_days;SputnikV;118104;21956;140060;1086430;416518;1502948
2021.12_13-10-2022;Приморский край;75_90_days;AllVaccines;23937;9819;33756;1086430;416518;1502948
2021.12_13-10-2022;Приморский край;75_90_days;CoviVac;427;53;480;1086430;416518;1502948
2021.12_13-10-2022;Приморский край;75_90_days;EpiVacCorona;430;205;635;1086430;416518;1502948
2021.12_13-10-2022;Приморский край;75_90_days;SputnikLite;15880;7195;23075;1086430;416518;1502948
2021.12_13-10-2022;Приморский край;75_90_days;SputnikV;7200;2366;9566;1086430;416518;1502948
2021.12_13-10-2022;Приморский край;90_105_days;AllVaccines;13692;6439;20131;1086430;416518;1502948
2021.12_13-10-2022;Приморский край;90_105_days;CoviVac;304;42;346;1086430;416518;1502948
2021.12_13-10-2022;Приморский край;90_105_days;EpiVacCorona;319;123;442;1086430;416518;1502948
2021.12_13-10-2022;Приморский край;90_105_days;SputnikLite;6947;4354;11301;1086430;416518;1502948
2021.12_13-10-2022;Приморский край;90_105_days;SputnikV;6122;1920;8042;1086430;416518;1502948
2021.12_13-10-2022;Псковская область;105_165_days;AllVaccines;57861;16145;74006;337881;166663;504544
2021.12_13-10-2022;Псковская область;105_165_days;CoviVac;282;24;306;337881;166663;504544
2021.12_13-10-2022;Псковская область;105_165_days;EpiVacCorona;7064;1774;8838;337881;166663;504544
2021.12_13-10-2022;Псковская область;105_165_days;SputnikLite;5833;3842;9675;337881;166663;504544
2021.12_13-10-2022;Псковская область;105_165_days;SputnikV;44682;10505;55187;337881;166663;504544
2021.12_13-10-2022;Псковская область;165_195_days;AllVaccines;30791;9333;40124;337881;166663;504544
2021.12_13-10-2022;Псковская область;165_195_days;CoviVac;753;113;866;337881;166663;504544
2021.12_13-10-2022;Псковская область;165_195_days;EpiVacCorona;97;62;159;337881;166663;504544
2021.12_13-10-2022;Псковская область;165_195_days;SputnikLite;2;0;2;337881;166663;504544
2021.12_13-10-2022;Псковская область;165_195_days;SputnikV;29939;9158;39097;337881;166663;504544
2021.12_13-10-2022;Псковская область;21_45_days;AllVaccines;22758;13877;36635;337881;166663;504544
2021.12_13-10-2022;Псковская область;21_45_days;CoviVac;395;65;460;337881;166663;504544
2021.12_13-10-2022;Псковская область;21_45_days;EpiVacCorona;775;351;1126;337881;166663;504544
2021.12_13-10-2022;Псковская область;21_45_days;SputnikLite;6582;6461;13043;337881;166663;504544
2021.12_13-10-2022;Псковская область;21_45_days;SputnikV;15006;7000;22006;337881;166663;504544
2021.12_13-10-2022;Псковская область;45_75_days;AllVaccines;23818;15702;39520;337881;166663;504544
2021.12_13-10-2022;Псковская область;45_75_days;CoviVac;659;127;786;337881;166663;504544
2021.12_13-10-2022;Псковская область;45_75_days;EpiVacCorona;955;429;1384;337881;166663;504544
2021.12_13-10-2022;Псковская область;45_75_days;SputnikLite;7809;8819;16628;337881;166663;504544
2021.12_13-10-2022;Псковская область;45_75_days;SputnikV;14395;6327;20722;337881;166663;504544
2021.12_13-10-2022;Псковская область;75_90_days;AllVaccines;8814;6003;14817;337881;166663;504544
2021.12_13-10-2022;Псковская область;75_90_days;CoviVac;8;3;11;337881;166663;504544
2021.12_13-10-2022;Псковская область;75_90_days;EpiVacCorona;204;75;279;337881;166663;504544
2021.12_13-10-2022;Псковская область;75_90_days;SputnikLite;5475;4675;10150;337881;166663;504544
2021.12_13-10-2022;Псковская область;75_90_days;SputnikV;3127;1250;4377;337881;166663;504544
2021.12_13-10-2022;Псковская область;90_105_days;AllVaccines;5092;3424;8516;337881;166663;504544
2021.12_13-10-2022;Псковская область;90_105_days;CoviVac;4;0;4;337881;166663;504544
2021.12_13-10-2022;Псковская область;90_105_days;EpiVacCorona;137;63;200;337881;166663;504544
2021.12_13-10-2022;Псковская область;90_105_days;SputnikLite;2460;2377;4837;337881;166663;504544
2021.12_13-10-2022;Псковская область;90_105_days;SputnikV;2491;984;3475;337881;166663;504544
2021.12_13-10-2022;РФ;105_165_days;AllVaccines;12810845;3246785;16057630;82332898;33454776;115787674
2021.12_13-10-2022;РФ;105_165_days;CoviVac;167211;25402;192613;82332898;33454776;115787674
2021.12_13-10-2022;РФ;105_165_days;EpiVacCorona;231093;77569;308662;82332898;33454776;115787674
2021.12_13-10-2022;РФ;105_165_days;SputnikLite;2876276;941926;3818202;82332898;33454776;115787674
2021.12_13-10-2022;РФ;105_165_days;SputnikV;9536265;2201888;11738153;82332898;33454776;115787674
2021.12_13-10-2022;РФ;165_195_days;AllVaccines;9645125;2006622;11651747;82332898;33454776;115787674
2021.12_13-10-2022;РФ;165_195_days;CoviVac;166809;20182;186991;82332898;33454776;115787674
2021.12_13-10-2022;РФ;165_195_days;EpiVacCorona;289629;85812;375441;82332898;33454776;115787674
2021.12_13-10-2022;РФ;165_195_days;SputnikLite;306736;19550;326286;82332898;33454776;115787674
2021.12_13-10-2022;РФ;165_195_days;SputnikV;8881951;1881078;10763029;82332898;33454776;115787674
2021.12_13-10-2022;РФ;21_45_days;AllVaccines;6681778;3065111;9746889;82332898;33454776;115787674
2021.12_13-10-2022;РФ;21_45_days;CoviVac;78011;16605;94616;82332898;33454776;115787674
2021.12_13-10-2022;РФ;21_45_days;EpiVacCorona;176502;80806;257308;82332898;33454776;115787674
2021.12_13-10-2022;РФ;21_45_days;SputnikLite;1726091;1184735;2910826;82332898;33454776;115787674
2021.12_13-10-2022;РФ;21_45_days;SputnikV;4701174;1782965;6484139;82332898;33454776;115787674
2021.12_13-10-2022;РФ;45_75_days;AllVaccines;7977980;3387252;11365232;82332898;33454776;115787674
2021.12_13-10-2022;РФ;45_75_days;CoviVac;108207;23188;131395;82332898;33454776;115787674
2021.12_13-10-2022;РФ;45_75_days;EpiVacCorona;211569;85636;297205;82332898;33454776;115787674
2021.12_13-10-2022;РФ;45_75_days;SputnikLite;2091772;1339635;3431407;82332898;33454776;115787674
2021.12_13-10-2022;РФ;45_75_days;SputnikV;5566432;1938793;7505225;82332898;33454776;115787674
2021.12_13-10-2022;РФ;75_90_days;AllVaccines;2473444;1112820;3586264;82332898;33454776;115787674
2021.12_13-10-2022;РФ;75_90_days;CoviVac;22364;5614;27978;82332898;33454776;115787674
2021.12_13-10-2022;РФ;75_90_days;EpiVacCorona;21937;10953;32890;82332898;33454776;115787674
2021.12_13-10-2022;РФ;75_90_days;SputnikLite;1656785;768616;2425401;82332898;33454776;115787674
2021.12_13-10-2022;РФ;75_90_days;SputnikV;772358;327637;1099995;82332898;33454776;115787674
2021.12_13-10-2022;РФ;90_105_days;AllVaccines;1483956;728014;2211970;82332898;33454776;115787674
2021.12_13-10-2022;РФ;90_105_days;CoviVac;19298;4768;24066;82332898;33454776;115787674
2021.12_13-10-2022;РФ;90_105_days;EpiVacCorona;11164;6240;17404;82332898;33454776;115787674
2021.12_13-10-2022;РФ;90_105_days;SputnikLite;853294;465827;1319121;82332898;33454776;115787674
2021.12_13-10-2022;РФ;90_105_days;SputnikV;600200;251179;851379;82332898;33454776;115787674
2021.12_13-10-2022;Республика Адыгея;105_165_days;AllVaccines;35865;9398;45263;256368;104563;360931
2021.12_13-10-2022;Республика Адыгея;105_165_days;CoviVac;32;9;41;256368;104563;360931
2021.12_13-10-2022;Республика Адыгея;105_165_days;EpiVacCorona;438;194;632;256368;104563;360931
2021.12_13-10-2022;Республика Адыгея;105_165_days;SputnikLite;5278;2377;7655;256368;104563;360931
2021.12_13-10-2022;Республика Адыгея;105_165_days;SputnikV;30117;6818;36935;256368;104563;360931
2021.12_13-10-2022;Республика Адыгея;165_195_days;AllVaccines;23933;6613;30546;256368;104563;360931
2021.12_13-10-2022;Республика Адыгея;165_195_days;CoviVac;141;25;166;256368;104563;360931
2021.12_13-10-2022;Республика Адыгея;165_195_days;EpiVacCorona;1089;320;1409;256368;104563;360931
2021.12_13-10-2022;Республика Адыгея;165_195_days;SputnikLite;226;29;255;256368;104563;360931
2021.12_13-10-2022;Республика Адыгея;165_195_days;SputnikV;22477;6239;28716;256368;104563;360931
2021.12_13-10-2022;Республика Адыгея;21_45_days;AllVaccines;12534;6741;19275;256368;104563;360931
2021.12_13-10-2022;Республика Адыгея;21_45_days;CoviVac;127;41;168;256368;104563;360931
2021.12_13-10-2022;Республика Адыгея;21_45_days;EpiVacCorona;388;250;638;256368;104563;360931
2021.12_13-10-2022;Республика Адыгея;21_45_days;SputnikLite;4850;3214;8064;256368;104563;360931
2021.12_13-10-2022;Республика Адыгея;21_45_days;SputnikV;7169;3236;10405;256368;104563;360931
2021.12_13-10-2022;Республика Адыгея;45_75_days;AllVaccines;19805;8709;28514;256368;104563;360931
2021.12_13-10-2022;Республика Адыгея;45_75_days;CoviVac;360;91;451;256368;104563;360931
2021.12_13-10-2022;Республика Адыгея;45_75_days;EpiVacCorona;508;222;730;256368;104563;360931
2021.12_13-10-2022;Республика Адыгея;45_75_days;SputnikLite;8120;4527;12647;256368;104563;360931
2021.12_13-10-2022;Республика Адыгея;45_75_days;SputnikV;10817;3869;14686;256368;104563;360931
2021.12_13-10-2022;Республика Адыгея;75_90_days;AllVaccines;13186;4202;17388;256368;104563;360931
2021.12_13-10-2022;Республика Адыгея;75_90_days;CoviVac;17;1;18;256368;104563;360931
2021.12_13-10-2022;Республика Адыгея;75_90_days;EpiVacCorona;50;31;81;256368;104563;360931
2021.12_13-10-2022;Республика Адыгея;75_90_days;SputnikLite;11585;3486;15071;256368;104563;360931
2021.12_13-10-2022;Республика Адыгея;75_90_days;SputnikV;1534;684;2218;256368;104563;360931
2021.12_13-10-2022;Республика Адыгея;90_105_days;AllVaccines;3905;1800;5705;256368;104563;360931
2021.12_13-10-2022;Республика Адыгея;90_105_days;CoviVac;8;2;10;256368;104563;360931
2021.12_13-10-2022;Республика Адыгея;90_105_days;EpiVacCorona;14;5;19;256368;104563;360931
2021.12_13-10-2022;Республика Адыгея;90_105_days;SputnikLite;2599;1272;3871;256368;104563;360931
2021.12_13-10-2022;Республика Адыгея;90_105_days;SputnikV;1284;521;1805;256368;104563;360931
2021.12_13-10-2022;Республика Алтай;105_165_days;AllVaccines;17164;3598;20762;117210;36468;153678
2021.12_13-10-2022;Республика Алтай;105_165_days;CoviVac;516;85;601;117210;36468;153678
2021.12_13-10-2022;Республика Алтай;105_165_days;EpiVacCorona;77;25;102;117210;36468;153678
2021.12_13-10-2022;Республика Алтай;105_165_days;SputnikLite;4551;1675;6226;117210;36468;153678
2021.12_13-10-2022;Республика Алтай;105_165_days;SputnikV;12020;1813;13833;117210;36468;153678
2021.12_13-10-2022;Республика Алтай;165_195_days;AllVaccines;9392;2511;11903;117210;36468;153678
2021.12_13-10-2022;Республика Алтай;165_195_days;CoviVac;113;32;145;117210;36468;153678
2021.12_13-10-2022;Республика Алтай;165_195_days;EpiVacCorona;579;198;777;117210;36468;153678
2021.12_13-10-2022;Республика Алтай;165_195_days;SputnikLite;64;6;70;117210;36468;153678
2021.12_13-10-2022;Республика Алтай;165_195_days;SputnikV;8636;2275;10911;117210;36468;153678
2021.12_13-10-2022;Республика Алтай;21_45_days;AllVaccines;9466;3490;12956;117210;36468;153678
2021.12_13-10-2022;Республика Алтай;21_45_days;CoviVac;109;22;131;117210;36468;153678
2021.12_13-10-2022;Республика Алтай;21_45_days;EpiVacCorona;177;41;218;117210;36468;153678
2021.12_13-10-2022;Республика Алтай;21_45_days;SputnikLite;5583;2188;7771;117210;36468;153678
2021.12_13-10-2022;Республика Алтай;21_45_days;SputnikV;3597;1239;4836;117210;36468;153678
2021.12_13-10-2022;Республика Алтай;45_75_days;AllVaccines;9949;4777;14726;117210;36468;153678
2021.12_13-10-2022;Республика Алтай;45_75_days;CoviVac;5;6;11;117210;36468;153678
2021.12_13-10-2022;Республика Алтай;45_75_days;EpiVacCorona;152;51;203;117210;36468;153678
2021.12_13-10-2022;Республика Алтай;45_75_days;SputnikLite;7339;3522;10861;117210;36468;153678
2021.12_13-10-2022;Республика Алтай;45_75_days;SputnikV;2453;1198;3651;117210;36468;153678
2021.12_13-10-2022;Республика Алтай;75_90_days;AllVaccines;3083;1733;4816;117210;36468;153678
2021.12_13-10-2022;Республика Алтай;75_90_days;CoviVac;5;1;6;117210;36468;153678
2021.12_13-10-2022;Республика Алтай;75_90_days;EpiVacCorona;15;7;22;117210;36468;153678
2021.12_13-10-2022;Республика Алтай;75_90_days;SputnikLite;2196;1471;3667;117210;36468;153678
2021.12_13-10-2022;Республика Алтай;75_90_days;SputnikV;867;254;1121;117210;36468;153678
2021.12_13-10-2022;Республика Алтай;90_105_days;AllVaccines;1892;1085;2977;117210;36468;153678
2021.12_13-10-2022;Республика Алтай;90_105_days;CoviVac;12;7;19;117210;36468;153678
2021.12_13-10-2022;Республика Алтай;90_105_days;EpiVacCorona;16;21;37;117210;36468;153678
2021.12_13-10-2022;Республика Алтай;90_105_days;SputnikLite;1142;816;1958;117210;36468;153678
2021.12_13-10-2022;Республика Алтай;90_105_days;SputnikV;722;241;963;117210;36468;153678
2021.12_13-10-2022;Республика Башкортостан;105_165_days;AllVaccines;370413;91826;462239;2235962;869874;3105836
2021.12_13-10-2022;Республика Башкортостан;105_165_days;CoviVac;5373;951;6324;2235962;869874;3105836
2021.12_13-10-2022;Республика Башкортостан;105_165_days;EpiVacCorona;4842;1906;6748;2235962;869874;3105836
2021.12_13-10-2022;Республика Башкортостан;105_165_days;SputnikLite;73225;22618;95843;2235962;869874;3105836
2021.12_13-10-2022;Республика Башкортостан;105_165_days;SputnikV;286973;66351;353324;2235962;869874;3105836
2021.12_13-10-2022;Республика Башкортостан;165_195_days;AllVaccines;291122;50819;341941;2235962;869874;3105836
2021.12_13-10-2022;Республика Башкортостан;165_195_days;CoviVac;4664;560;5224;2235962;869874;3105836
2021.12_13-10-2022;Республика Башкортостан;165_195_days;EpiVacCorona;3746;966;4712;2235962;869874;3105836
2021.12_13-10-2022;Республика Башкортостан;165_195_days;SputnikLite;5087;685;5772;2235962;869874;3105836
2021.12_13-10-2022;Республика Башкортостан;165_195_days;SputnikV;277625;48608;326233;2235962;869874;3105836
2021.12_13-10-2022;Республика Башкортостан;21_45_days;AllVaccines;188348;75397;263745;2235962;869874;3105836
2021.12_13-10-2022;Республика Башкортостан;21_45_days;CoviVac;2016;573;2589;2235962;869874;3105836
2021.12_13-10-2022;Республика Башкортостан;21_45_days;EpiVacCorona;4017;1977;5994;2235962;869874;3105836
2021.12_13-10-2022;Республика Башкортостан;21_45_days;SputnikLite;46801;24027;70828;2235962;869874;3105836
2021.12_13-10-2022;Республика Башкортостан;21_45_days;SputnikV;135514;48820;184334;2235962;869874;3105836
2021.12_13-10-2022;Республика Башкортостан;45_75_days;AllVaccines;297419;103933;401352;2235962;869874;3105836
2021.12_13-10-2022;Республика Башкортостан;45_75_days;CoviVac;828;198;1026;2235962;869874;3105836
2021.12_13-10-2022;Республика Башкортостан;45_75_days;EpiVacCorona;7892;3699;11591;2235962;869874;3105836
2021.12_13-10-2022;Республика Башкортостан;45_75_days;SputnikLite;31398;19823;51221;2235962;869874;3105836
2021.12_13-10-2022;Республика Башкортостан;45_75_days;SputnikV;257301;80213;337514;2235962;869874;3105836
2021.12_13-10-2022;Республика Башкортостан;75_90_days;AllVaccines;57963;21342;79305;2235962;869874;3105836
2021.12_13-10-2022;Республика Башкортостан;75_90_days;CoviVac;686;191;877;2235962;869874;3105836
2021.12_13-10-2022;Республика Башкортостан;75_90_days;EpiVacCorona;1152;543;1695;2235962;869874;3105836
2021.12_13-10-2022;Республика Башкортостан;75_90_days;SputnikLite;17395;6892;24287;2235962;869874;3105836
2021.12_13-10-2022;Республика Башкортостан;75_90_days;SputnikV;38730;13716;52446;2235962;869874;3105836
2021.12_13-10-2022;Республика Башкортостан;90_105_days;AllVaccines;53909;20603;74512;2235962;869874;3105836
2021.12_13-10-2022;Республика Башкортостан;90_105_days;CoviVac;603;208;811;2235962;869874;3105836
2021.12_13-10-2022;Республика Башкортостан;90_105_days;EpiVacCorona;353;181;534;2235962;869874;3105836
2021.12_13-10-2022;Республика Башкортостан;90_105_days;SputnikLite;27778;10351;38129;2235962;869874;3105836
2021.12_13-10-2022;Республика Башкортостан;90_105_days;SputnikV;25175;9863;35038;2235962;869874;3105836
2021.12_13-10-2022;Республика Бурятия;105_165_days;AllVaccines;93660;22270;115930;542372;176777;719149
2021.12_13-10-2022;Республика Бурятия;105_165_days;CoviVac;426;124;550;542372;176777;719149
2021.12_13-10-2022;Республика Бурятия;105_165_days;EpiVacCorona;1181;343;1524;542372;176777;719149
2021.12_13-10-2022;Республика Бурятия;105_165_days;SputnikLite;29146;7743;36889;542372;176777;719149
2021.12_13-10-2022;Республика Бурятия;105_165_days;SputnikV;62907;14060;76967;542372;176777;719149
2021.12_13-10-2022;Республика Бурятия;165_195_days;AllVaccines;52373;15012;67385;542372;176777;719149
2021.12_13-10-2022;Республика Бурятия;165_195_days;CoviVac;389;118;507;542372;176777;719149
2021.12_13-10-2022;Республика Бурятия;165_195_days;EpiVacCorona;6027;1938;7965;542372;176777;719149
2021.12_13-10-2022;Республика Бурятия;165_195_days;SputnikLite;247;49;296;542372;176777;719149
2021.12_13-10-2022;Республика Бурятия;165_195_days;SputnikV;45710;12907;58617;542372;176777;719149
2021.12_13-10-2022;Республика Бурятия;21_45_days;AllVaccines;49077;20780;69857;542372;176777;719149
2021.12_13-10-2022;Республика Бурятия;21_45_days;CoviVac;737;229;966;542372;176777;719149
2021.12_13-10-2022;Республика Бурятия;21_45_days;EpiVacCorona;394;259;653;542372;176777;719149
2021.12_13-10-2022;Республика Бурятия;21_45_days;SputnikLite;15897;9167;25064;542372;176777;719149
2021.12_13-10-2022;Республика Бурятия;21_45_days;SputnikV;32049;11125;43174;542372;176777;719149
2021.12_13-10-2022;Республика Бурятия;45_75_days;AllVaccines;45942;17956;63898;542372;176777;719149
2021.12_13-10-2022;Республика Бурятия;45_75_days;CoviVac;645;132;777;542372;176777;719149
2021.12_13-10-2022;Республика Бурятия;45_75_days;EpiVacCorona;920;476;1396;542372;176777;719149
2021.12_13-10-2022;Республика Бурятия;45_75_days;SputnikLite;14518;7704;22222;542372;176777;719149
2021.12_13-10-2022;Республика Бурятия;45_75_days;SputnikV;29859;9644;39503;542372;176777;719149
2021.12_13-10-2022;Республика Бурятия;75_90_days;AllVaccines;13945;5382;19327;542372;176777;719149
2021.12_13-10-2022;Республика Бурятия;75_90_days;CoviVac;14;5;19;542372;176777;719149
2021.12_13-10-2022;Республика Бурятия;75_90_days;EpiVacCorona;141;57;198;542372;176777;719149
2021.12_13-10-2022;Республика Бурятия;75_90_days;SputnikLite;9945;3901;13846;542372;176777;719149
2021.12_13-10-2022;Республика Бурятия;75_90_days;SputnikV;3845;1419;5264;542372;176777;719149
2021.12_13-10-2022;Республика Бурятия;90_105_days;AllVaccines;10911;4200;15111;542372;176777;719149
2021.12_13-10-2022;Республика Бурятия;90_105_days;CoviVac;16;5;21;542372;176777;719149
2021.12_13-10-2022;Республика Бурятия;90_105_days;EpiVacCorona;69;17;86;542372;176777;719149
2021.12_13-10-2022;Республика Бурятия;90_105_days;SputnikLite;7574;3289;10863;542372;176777;719149
2021.12_13-10-2022;Республика Бурятия;90_105_days;SputnikV;3252;889;4141;542372;176777;719149
2021.12_13-10-2022;Республика Дагестан;105_165_days;AllVaccines;196981;33544;230525;1856109;394621;2250730
2021.12_13-10-2022;Республика Дагестан;105_165_days;CoviVac;1429;343;1772;1856109;394621;2250730
2021.12_13-10-2022;Республика Дагестан;105_165_days;EpiVacCorona;6119;1084;7203;1856109;394621;2250730
2021.12_13-10-2022;Республика Дагестан;105_165_days;SputnikLite;56740;10703;67443;1856109;394621;2250730
2021.12_13-10-2022;Республика Дагестан;105_165_days;SputnikV;132693;21414;154107;1856109;394621;2250730
2021.12_13-10-2022;Республика Дагестан;165_195_days;AllVaccines;71472;13042;84514;1856109;394621;2250730
2021.12_13-10-2022;Республика Дагестан;165_195_days;CoviVac;2041;349;2390;1856109;394621;2250730
2021.12_13-10-2022;Республика Дагестан;165_195_days;EpiVacCorona;1833;490;2323;1856109;394621;2250730
2021.12_13-10-2022;Республика Дагестан;165_195_days;SputnikLite;2636;344;2980;1856109;394621;2250730
2021.12_13-10-2022;Республика Дагестан;165_195_days;SputnikV;64962;11859;76821;1856109;394621;2250730
2021.12_13-10-2022;Республика Дагестан;21_45_days;AllVaccines;79336;13443;92779;1856109;394621;2250730
2021.12_13-10-2022;Республика Дагестан;21_45_days;CoviVac;952;155;1107;1856109;394621;2250730
2021.12_13-10-2022;Республика Дагестан;21_45_days;EpiVacCorona;5511;957;6468;1856109;394621;2250730
2021.12_13-10-2022;Республика Дагестан;21_45_days;SputnikLite;21155;4088;25243;1856109;394621;2250730
2021.12_13-10-2022;Республика Дагестан;21_45_days;SputnikV;51718;8243;59961;1856109;394621;2250730
2021.12_13-10-2022;Республика Дагестан;45_75_days;AllVaccines;101846;16377;118223;1856109;394621;2250730
2021.12_13-10-2022;Республика Дагестан;45_75_days;CoviVac;758;145;903;1856109;394621;2250730
2021.12_13-10-2022;Республика Дагестан;45_75_days;EpiVacCorona;5898;743;6641;1856109;394621;2250730
2021.12_13-10-2022;Республика Дагестан;45_75_days;SputnikLite;20191;3373;23564;1856109;394621;2250730
2021.12_13-10-2022;Республика Дагестан;45_75_days;SputnikV;74999;12116;87115;1856109;394621;2250730
2021.12_13-10-2022;Республика Дагестан;75_90_days;AllVaccines;27299;8480;35779;1856109;394621;2250730
2021.12_13-10-2022;Республика Дагестан;75_90_days;CoviVac;109;35;144;1856109;394621;2250730
2021.12_13-10-2022;Республика Дагестан;75_90_days;EpiVacCorona;239;81;320;1856109;394621;2250730
2021.12_13-10-2022;Республика Дагестан;75_90_days;SputnikLite;14110;1971;16081;1856109;394621;2250730
2021.12_13-10-2022;Республика Дагестан;75_90_days;SputnikV;12841;6393;19234;1856109;394621;2250730
2021.12_13-10-2022;Республика Дагестан;90_105_days;AllVaccines;17346;5900;23246;1856109;394621;2250730
2021.12_13-10-2022;Республика Дагестан;90_105_days;CoviVac;84;33;117;1856109;394621;2250730
2021.12_13-10-2022;Республика Дагестан;90_105_days;EpiVacCorona;43;10;53;1856109;394621;2250730
2021.12_13-10-2022;Республика Дагестан;90_105_days;SputnikLite;6304;1131;7435;1856109;394621;2250730
2021.12_13-10-2022;Республика Дагестан;90_105_days;SputnikV;10915;4726;15641;1856109;394621;2250730
2021.12_13-10-2022;Республика Ингушетия;105_165_days;AllVaccines;50539;7377;57916;295583;61477;357060
2021.12_13-10-2022;Республика Ингушетия;105_165_days;CoviVac;597;84;681;295583;61477;357060
2021.12_13-10-2022;Республика Ингушетия;105_165_days;EpiVacCorona;743;87;830;295583;61477;357060
2021.12_13-10-2022;Республика Ингушетия;105_165_days;SputnikLite;10153;1439;11592;295583;61477;357060
2021.12_13-10-2022;Республика Ингушетия;105_165_days;SputnikV;39046;5767;44813;295583;61477;357060
2021.12_13-10-2022;Республика Ингушетия;165_195_days;AllVaccines;29845;3901;33746;295583;61477;357060
2021.12_13-10-2022;Республика Ингушетия;165_195_days;CoviVac;96;13;109;295583;61477;357060
2021.12_13-10-2022;Республика Ингушетия;165_195_days;EpiVacCorona;7181;887;8068;295583;61477;357060
2021.12_13-10-2022;Республика Ингушетия;165_195_days;SputnikLite;640;89;729;295583;61477;357060
2021.12_13-10-2022;Республика Ингушетия;165_195_days;SputnikV;21928;2912;24840;295583;61477;357060
2021.12_13-10-2022;Республика Ингушетия;21_45_days;AllVaccines;29550;6582;36132;295583;61477;357060
2021.12_13-10-2022;Республика Ингушетия;21_45_days;CoviVac;2;0;2;295583;61477;357060
2021.12_13-10-2022;Республика Ингушетия;21_45_days;EpiVacCorona;416;72;488;295583;61477;357060
2021.12_13-10-2022;Республика Ингушетия;21_45_days;SputnikLite;18297;3975;22272;295583;61477;357060
2021.12_13-10-2022;Республика Ингушетия;21_45_days;SputnikV;10835;2535;13370;295583;61477;357060
2021.12_13-10-2022;Республика Ингушетия;45_75_days;AllVaccines;15791;3567;19358;295583;61477;357060
2021.12_13-10-2022;Республика Ингушетия;45_75_days;CoviVac;9;7;16;295583;61477;357060
2021.12_13-10-2022;Республика Ингушетия;45_75_days;SputnikLite;7937;2182;10119;295583;61477;357060
2021.12_13-10-2022;Республика Ингушетия;45_75_days;SputnikV;7845;1378;9223;295583;61477;357060
2021.12_13-10-2022;Республика Ингушетия;75_90_days;AllVaccines;5381;890;6271;295583;61477;357060
2021.12_13-10-2022;Республика Ингушетия;75_90_days;SputnikLite;2372;394;2766;295583;61477;357060
2021.12_13-10-2022;Республика Ингушетия;75_90_days;SputnikV;3009;496;3505;295583;61477;357060
2021.12_13-10-2022;Республика Ингушетия;90_105_days;AllVaccines;3071;557;3628;295583;61477;357060
2021.12_13-10-2022;Республика Ингушетия;90_105_days;SputnikLite;1243;298;1541;295583;61477;357060
2021.12_13-10-2022;Республика Ингушетия;90_105_days;SputnikV;1828;259;2087;295583;61477;357060
2021.12_13-10-2022;Республика Калмыкия;105_165_days;AllVaccines;15300;5081;20381;150440;54890;205330
2021.12_13-10-2022;Республика Калмыкия;105_165_days;CoviVac;383;68;451;150440;54890;205330
2021.12_13-10-2022;Республика Калмыкия;105_165_days;EpiVacCorona;45;18;63;150440;54890;205330
2021.12_13-10-2022;Республика Калмыкия;105_165_days;SputnikLite;6175;2394;8569;150440;54890;205330
2021.12_13-10-2022;Республика Калмыкия;105_165_days;SputnikV;8697;2601;11298;150440;54890;205330
2021.12_13-10-2022;Республика Калмыкия;165_195_days;AllVaccines;10053;2757;12810;150440;54890;205330
2021.12_13-10-2022;Республика Калмыкия;165_195_days;CoviVac;399;58;457;150440;54890;205330
2021.12_13-10-2022;Республика Калмыкия;165_195_days;EpiVacCorona;296;129;425;150440;54890;205330
2021.12_13-10-2022;Республика Калмыкия;165_195_days;SputnikLite;326;25;351;150440;54890;205330
2021.12_13-10-2022;Республика Калмыкия;165_195_days;SputnikV;9032;2545;11577;150440;54890;205330
2021.12_13-10-2022;Республика Калмыкия;21_45_days;AllVaccines;9732;3839;13571;150440;54890;205330
2021.12_13-10-2022;Республика Калмыкия;21_45_days;CoviVac;293;70;363;150440;54890;205330
2021.12_13-10-2022;Республика Калмыкия;21_45_days;EpiVacCorona;126;65;191;150440;54890;205330
2021.12_13-10-2022;Республика Калмыкия;21_45_days;SputnikLite;7017;2866;9883;150440;54890;205330
2021.12_13-10-2022;Республика Калмыкия;21_45_days;SputnikV;2296;838;3134;150440;54890;205330
2021.12_13-10-2022;Республика Калмыкия;45_75_days;AllVaccines;19750;8562;28312;150440;54890;205330
2021.12_13-10-2022;Республика Калмыкия;45_75_days;CoviVac;445;89;534;150440;54890;205330
2021.12_13-10-2022;Республика Калмыкия;45_75_days;EpiVacCorona;54;24;78;150440;54890;205330
2021.12_13-10-2022;Республика Калмыкия;45_75_days;SputnikLite;16597;7145;23742;150440;54890;205330
2021.12_13-10-2022;Республика Калмыкия;45_75_days;SputnikV;2654;1304;3958;150440;54890;205330
2021.12_13-10-2022;Республика Калмыкия;75_90_days;AllVaccines;7058;4312;11370;150440;54890;205330
2021.12_13-10-2022;Республика Калмыкия;75_90_days;CoviVac;30;12;42;150440;54890;205330
2021.12_13-10-2022;Республика Калмыкия;75_90_days;EpiVacCorona;1;0;1;150440;54890;205330
2021.12_13-10-2022;Республика Калмыкия;75_90_days;SputnikLite;6660;4144;10804;150440;54890;205330
2021.12_13-10-2022;Республика Калмыкия;75_90_days;SputnikV;367;156;523;150440;54890;205330
2021.12_13-10-2022;Республика Калмыкия;90_105_days;AllVaccines;1904;1633;3537;150440;54890;205330
2021.12_13-10-2022;Республика Калмыкия;90_105_days;CoviVac;28;6;34;150440;54890;205330
2021.12_13-10-2022;Республика Калмыкия;90_105_days;SputnikLite;1562;1408;2970;150440;54890;205330
2021.12_13-10-2022;Республика Калмыкия;90_105_days;SputnikV;314;219;533;150440;54890;205330
2021.12_13-10-2022;Республика Карелия;105_165_days;AllVaccines;60312;18677;78989;334874;149526;484400
2021.12_13-10-2022;Республика Карелия;105_165_days;CoviVac;294;33;327;334874;149526;484400
2021.12_13-10-2022;Республика Карелия;105_165_days;EpiVacCorona;439;146;585;334874;149526;484400
2021.12_13-10-2022;Республика Карелия;105_165_days;SputnikLite;23423;8267;31690;334874;149526;484400
2021.12_13-10-2022;Республика Карелия;105_165_days;SputnikV;36156;10231;46387;334874;149526;484400
2021.12_13-10-2022;Республика Карелия;165_195_days;AllVaccines;29623;8029;37652;334874;149526;484400
2021.12_13-10-2022;Республика Карелия;165_195_days;CoviVac;505;59;564;334874;149526;484400
2021.12_13-10-2022;Республика Карелия;165_195_days;EpiVacCorona;48;27;75;334874;149526;484400
2021.12_13-10-2022;Республика Карелия;165_195_days;SputnikLite;659;78;737;334874;149526;484400
2021.12_13-10-2022;Республика Карелия;165_195_days;SputnikV;28411;7865;36276;334874;149526;484400
2021.12_13-10-2022;Республика Карелия;21_45_days;AllVaccines;22553;14110;36663;334874;149526;484400
2021.12_13-10-2022;Республика Карелия;21_45_days;CoviVac;457;100;557;334874;149526;484400
2021.12_13-10-2022;Республика Карелия;21_45_days;EpiVacCorona;884;471;1355;334874;149526;484400
2021.12_13-10-2022;Республика Карелия;21_45_days;SputnikLite;7914;6456;14370;334874;149526;484400
2021.12_13-10-2022;Республика Карелия;21_45_days;SputnikV;13298;7083;20381;334874;149526;484400
2021.12_13-10-2022;Республика Карелия;45_75_days;AllVaccines;24483;20849;45332;334874;149526;484400
2021.12_13-10-2022;Республика Карелия;45_75_days;CoviVac;703;177;880;334874;149526;484400
2021.12_13-10-2022;Республика Карелия;45_75_days;EpiVacCorona;449;323;772;334874;149526;484400
2021.12_13-10-2022;Республика Карелия;45_75_days;SputnikLite;13370;13090;26460;334874;149526;484400
2021.12_13-10-2022;Республика Карелия;45_75_days;SputnikV;9961;7259;17220;334874;149526;484400
2021.12_13-10-2022;Республика Карелия;75_90_days;AllVaccines;15561;8292;23853;334874;149526;484400
2021.12_13-10-2022;Республика Карелия;75_90_days;CoviVac;5;0;5;334874;149526;484400
2021.12_13-10-2022;Республика Карелия;75_90_days;EpiVacCorona;41;44;85;334874;149526;484400
2021.12_13-10-2022;Республика Карелия;75_90_days;SputnikLite;13565;6636;20201;334874;149526;484400
2021.12_13-10-2022;Республика Карелия;75_90_days;SputnikV;1950;1612;3562;334874;149526;484400
2021.12_13-10-2022;Республика Карелия;90_105_days;AllVaccines;8117;5080;13197;334874;149526;484400
2021.12_13-10-2022;Республика Карелия;90_105_days;CoviVac;6;4;10;334874;149526;484400
2021.12_13-10-2022;Республика Карелия;90_105_days;EpiVacCorona;23;22;45;334874;149526;484400
2021.12_13-10-2022;Республика Карелия;90_105_days;SputnikLite;6450;3847;10297;334874;149526;484400
2021.12_13-10-2022;Республика Карелия;90_105_days;SputnikV;1638;1207;2845;334874;149526;484400
2021.12_13-10-2022;Республика Коми;105_165_days;AllVaccines;85189;16001;101190;465210;166370;631580
2021.12_13-10-2022;Республика Коми;105_165_days;CoviVac;575;64;639;465210;166370;631580
2021.12_13-10-2022;Республика Коми;105_165_days;EpiVacCorona;48;15;63;465210;166370;631580
2021.12_13-10-2022;Республика Коми;105_165_days;SputnikLite;27880;4741;32621;465210;166370;631580
2021.12_13-10-2022;Республика Коми;105_165_days;SputnikV;56686;11181;67867;465210;166370;631580
2021.12_13-10-2022;Республика Коми;165_195_days;AllVaccines;36573;8546;45119;465210;166370;631580
2021.12_13-10-2022;Республика Коми;165_195_days;CoviVac;1256;145;1401;465210;166370;631580
2021.12_13-10-2022;Республика Коми;165_195_days;EpiVacCorona;229;134;363;465210;166370;631580
2021.12_13-10-2022;Республика Коми;165_195_days;SputnikLite;1535;41;1576;465210;166370;631580
2021.12_13-10-2022;Республика Коми;165_195_days;SputnikV;33553;8226;41779;465210;166370;631580
2021.12_13-10-2022;Республика Коми;21_45_days;AllVaccines;27494;13690;41184;465210;166370;631580
2021.12_13-10-2022;Республика Коми;21_45_days;CoviVac;277;49;326;465210;166370;631580
2021.12_13-10-2022;Республика Коми;21_45_days;EpiVacCorona;848;368;1216;465210;166370;631580
2021.12_13-10-2022;Республика Коми;21_45_days;SputnikLite;10844;6475;17319;465210;166370;631580
2021.12_13-10-2022;Республика Коми;21_45_days;SputnikV;15525;6798;22323;465210;166370;631580
2021.12_13-10-2022;Республика Коми;45_75_days;AllVaccines;32988;17423;50411;465210;166370;631580
2021.12_13-10-2022;Республика Коми;45_75_days;CoviVac;451;98;549;465210;166370;631580
2021.12_13-10-2022;Республика Коми;45_75_days;EpiVacCorona;412;150;562;465210;166370;631580
2021.12_13-10-2022;Республика Коми;45_75_days;SputnikLite;21417;11256;32673;465210;166370;631580
2021.12_13-10-2022;Республика Коми;45_75_days;SputnikV;10708;5919;16627;465210;166370;631580
2021.12_13-10-2022;Республика Коми;75_90_days;AllVaccines;11063;4810;15873;465210;166370;631580
2021.12_13-10-2022;Республика Коми;75_90_days;CoviVac;10;0;10;465210;166370;631580
2021.12_13-10-2022;Республика Коми;75_90_days;EpiVacCorona;2;3;5;465210;166370;631580
2021.12_13-10-2022;Республика Коми;75_90_days;SputnikLite;8954;3651;12605;465210;166370;631580
2021.12_13-10-2022;Республика Коми;75_90_days;SputnikV;2097;1156;3253;465210;166370;631580
2021.12_13-10-2022;Республика Коми;90_105_days;AllVaccines;6826;2949;9775;465210;166370;631580
2021.12_13-10-2022;Республика Коми;90_105_days;CoviVac;20;1;21;465210;166370;631580
2021.12_13-10-2022;Республика Коми;90_105_days;SputnikLite;4561;1960;6521;465210;166370;631580
2021.12_13-10-2022;Республика Коми;90_105_days;SputnikV;2245;988;3233;465210;166370;631580
2021.12_13-10-2022;Республика Крым;105_165_days;AllVaccines;99042;30830;129872;1036087;480146;1516233
2021.12_13-10-2022;Республика Крым;105_165_days;CoviVac;1192;297;1489;1036087;480146;1516233
2021.12_13-10-2022;Республика Крым;105_165_days;EpiVacCorona;1802;915;2717;1036087;480146;1516233
2021.12_13-10-2022;Республика Крым;105_165_days;SputnikLite;6813;8599;15412;1036087;480146;1516233
2021.12_13-10-2022;Республика Крым;105_165_days;SputnikV;89235;21019;110254;1036087;480146;1516233
2021.12_13-10-2022;Республика Крым;165_195_days;AllVaccines;77941;27225;105166;1036087;480146;1516233
2021.12_13-10-2022;Республика Крым;165_195_days;CoviVac;1113;293;1406;1036087;480146;1516233
2021.12_13-10-2022;Республика Крым;165_195_days;EpiVacCorona;3147;1534;4681;1036087;480146;1516233
2021.12_13-10-2022;Республика Крым;165_195_days;SputnikLite;33;10;43;1036087;480146;1516233
2021.12_13-10-2022;Республика Крым;165_195_days;SputnikV;73648;25388;99036;1036087;480146;1516233
2021.12_13-10-2022;Республика Крым;21_45_days;AllVaccines;122499;59514;182013;1036087;480146;1516233
2021.12_13-10-2022;Республика Крым;21_45_days;CoviVac;1012;351;1363;1036087;480146;1516233
2021.12_13-10-2022;Республика Крым;21_45_days;EpiVacCorona;2055;1031;3086;1036087;480146;1516233
2021.12_13-10-2022;Республика Крым;21_45_days;SputnikLite;30887;31482;62369;1036087;480146;1516233
2021.12_13-10-2022;Республика Крым;21_45_days;SputnikV;88545;26650;115195;1036087;480146;1516233
2021.12_13-10-2022;Республика Крым;45_75_days;AllVaccines;208888;53309;262197;1036087;480146;1516233
2021.12_13-10-2022;Республика Крым;45_75_days;CoviVac;2021;436;2457;1036087;480146;1516233
2021.12_13-10-2022;Республика Крым;45_75_days;EpiVacCorona;5482;1679;7161;1036087;480146;1516233
2021.12_13-10-2022;Республика Крым;45_75_days;SputnikLite;17915;19631;37546;1036087;480146;1516233
2021.12_13-10-2022;Республика Крым;45_75_days;SputnikV;183470;31563;215033;1036087;480146;1516233
2021.12_13-10-2022;Республика Крым;75_90_days;AllVaccines;29751;12260;42011;1036087;480146;1516233
2021.12_13-10-2022;Республика Крым;75_90_days;CoviVac;444;102;546;1036087;480146;1516233
2021.12_13-10-2022;Республика Крым;75_90_days;EpiVacCorona;371;136;507;1036087;480146;1516233
2021.12_13-10-2022;Республика Крым;75_90_days;SputnikLite;13711;8969;22680;1036087;480146;1516233
2021.12_13-10-2022;Республика Крым;75_90_days;SputnikV;15225;3053;18278;1036087;480146;1516233
2021.12_13-10-2022;Республика Крым;90_105_days;AllVaccines;16487;8918;25405;1036087;480146;1516233
2021.12_13-10-2022;Республика Крым;90_105_days;CoviVac;250;93;343;1036087;480146;1516233
2021.12_13-10-2022;Республика Крым;90_105_days;EpiVacCorona;131;76;207;1036087;480146;1516233
2021.12_13-10-2022;Республика Крым;90_105_days;SputnikLite;5514;5867;11381;1036087;480146;1516233
2021.12_13-10-2022;Республика Крым;90_105_days;SputnikV;10592;2882;13474;1036087;480146;1516233
2021.12_13-10-2022;Республика Марий Эл;105_165_days;AllVaccines;67966;13602;81568;370626;156749;527375
2021.12_13-10-2022;Республика Марий Эл;105_165_days;CoviVac;342;50;392;370626;156749;527375
2021.12_13-10-2022;Республика Марий Эл;105_165_days;EpiVacCorona;488;251;739;370626;156749;527375
2021.12_13-10-2022;Республика Марий Эл;105_165_days;SputnikLite;32233;4568;36801;370626;156749;527375
2021.12_13-10-2022;Республика Марий Эл;105_165_days;SputnikV;34903;8733;43636;370626;156749;527375
2021.12_13-10-2022;Республика Марий Эл;165_195_days;AllVaccines;26993;7733;34726;370626;156749;527375
2021.12_13-10-2022;Республика Марий Эл;165_195_days;CoviVac;370;51;421;370626;156749;527375
2021.12_13-10-2022;Республика Марий Эл;165_195_days;EpiVacCorona;38;22;60;370626;156749;527375
2021.12_13-10-2022;Республика Марий Эл;165_195_days;SputnikLite;1207;47;1254;370626;156749;527375
2021.12_13-10-2022;Республика Марий Эл;165_195_days;SputnikV;25378;7613;32991;370626;156749;527375
2021.12_13-10-2022;Республика Марий Эл;21_45_days;AllVaccines;39919;15044;54963;370626;156749;527375
2021.12_13-10-2022;Республика Марий Эл;21_45_days;CoviVac;374;114;488;370626;156749;527375
2021.12_13-10-2022;Республика Марий Эл;21_45_days;EpiVacCorona;1561;599;2160;370626;156749;527375
2021.12_13-10-2022;Республика Марий Эл;21_45_days;SputnikLite;14387;5869;20256;370626;156749;527375
2021.12_13-10-2022;Республика Марий Эл;21_45_days;SputnikV;23597;8462;32059;370626;156749;527375
2021.12_13-10-2022;Республика Марий Эл;45_75_days;AllVaccines;41312;17405;58717;370626;156749;527375
2021.12_13-10-2022;Республика Марий Эл;45_75_days;CoviVac;417;122;539;370626;156749;527375
2021.12_13-10-2022;Республика Марий Эл;45_75_days;EpiVacCorona;3206;878;4084;370626;156749;527375
2021.12_13-10-2022;Республика Марий Эл;45_75_days;SputnikLite;14396;7905;22301;370626;156749;527375
2021.12_13-10-2022;Республика Марий Эл;45_75_days;SputnikV;23293;8500;31793;370626;156749;527375
2021.12_13-10-2022;Республика Марий Эл;75_90_days;AllVaccines;27050;6715;33765;370626;156749;527375
2021.12_13-10-2022;Республика Марий Эл;75_90_days;CoviVac;14;3;17;370626;156749;527375
2021.12_13-10-2022;Республика Марий Эл;75_90_days;EpiVacCorona;61;20;81;370626;156749;527375
2021.12_13-10-2022;Республика Марий Эл;75_90_days;SputnikLite;24963;5320;30283;370626;156749;527375
2021.12_13-10-2022;Республика Марий Эл;75_90_days;SputnikV;2012;1372;3384;370626;156749;527375
2021.12_13-10-2022;Республика Марий Эл;90_105_days;AllVaccines;9530;3357;12887;370626;156749;527375
2021.12_13-10-2022;Республика Марий Эл;90_105_days;CoviVac;6;2;8;370626;156749;527375
2021.12_13-10-2022;Республика Марий Эл;90_105_days;EpiVacCorona;10;4;14;370626;156749;527375
2021.12_13-10-2022;Республика Марий Эл;90_105_days;SputnikLite;8014;2488;10502;370626;156749;527375
2021.12_13-10-2022;Республика Марий Эл;90_105_days;SputnikV;1500;863;2363;370626;156749;527375
2021.12_13-10-2022;Республика Мордовия;105_165_days;AllVaccines;78636;26934;105570;448319;198808;647127
2021.12_13-10-2022;Республика Мордовия;105_165_days;CoviVac;204;32;236;448319;198808;647127
2021.12_13-10-2022;Республика Мордовия;105_165_days;EpiVacCorona;564;190;754;448319;198808;647127
2021.12_13-10-2022;Республика Мордовия;105_165_days;SputnikLite;20698;9244;29942;448319;198808;647127
2021.12_13-10-2022;Республика Мордовия;105_165_days;SputnikV;57170;17468;74638;448319;198808;647127
2021.12_13-10-2022;Республика Мордовия;165_195_days;AllVaccines;52155;9815;61970;448319;198808;647127
2021.12_13-10-2022;Республика Мордовия;165_195_days;CoviVac;636;58;694;448319;198808;647127
2021.12_13-10-2022;Республика Мордовия;165_195_days;EpiVacCorona;1969;408;2377;448319;198808;647127
2021.12_13-10-2022;Республика Мордовия;165_195_days;SputnikLite;770;85;855;448319;198808;647127
2021.12_13-10-2022;Республика Мордовия;165_195_days;SputnikV;48780;9264;58044;448319;198808;647127
2021.12_13-10-2022;Республика Мордовия;21_45_days;AllVaccines;37963;20246;58209;448319;198808;647127
2021.12_13-10-2022;Республика Мордовия;21_45_days;CoviVac;737;224;961;448319;198808;647127
2021.12_13-10-2022;Республика Мордовия;21_45_days;EpiVacCorona;1147;453;1600;448319;198808;647127
2021.12_13-10-2022;Республика Мордовия;21_45_days;SputnikLite;13405;8608;22013;448319;198808;647127
2021.12_13-10-2022;Республика Мордовия;21_45_days;SputnikV;22674;10961;33635;448319;198808;647127
2021.12_13-10-2022;Республика Мордовия;45_75_days;AllVaccines;51341;28091;79432;448319;198808;647127
2021.12_13-10-2022;Республика Мордовия;45_75_days;CoviVac;881;234;1115;448319;198808;647127
2021.12_13-10-2022;Республика Мордовия;45_75_days;EpiVacCorona;1459;480;1939;448319;198808;647127
2021.12_13-10-2022;Республика Мордовия;45_75_days;SputnikLite;16956;12863;29819;448319;198808;647127
2021.12_13-10-2022;Республика Мордовия;45_75_days;SputnikV;32045;14514;46559;448319;198808;647127
2021.12_13-10-2022;Республика Мордовия;75_90_days;AllVaccines;19316;11953;31269;448319;198808;647127
2021.12_13-10-2022;Республика Мордовия;75_90_days;CoviVac;18;0;18;448319;198808;647127
2021.12_13-10-2022;Республика Мордовия;75_90_days;EpiVacCorona;92;21;113;448319;198808;647127
2021.12_13-10-2022;Республика Мордовия;75_90_days;SputnikLite;15532;9095;24627;448319;198808;647127
2021.12_13-10-2022;Республика Мордовия;75_90_days;SputnikV;3674;2837;6511;448319;198808;647127
2021.12_13-10-2022;Республика Мордовия;90_105_days;AllVaccines;11321;8844;20165;448319;198808;647127
2021.12_13-10-2022;Республика Мордовия;90_105_days;CoviVac;4;2;6;448319;198808;647127
2021.12_13-10-2022;Республика Мордовия;90_105_days;EpiVacCorona;43;32;75;448319;198808;647127
2021.12_13-10-2022;Республика Мордовия;90_105_days;SputnikLite;8326;4916;13242;448319;198808;647127
2021.12_13-10-2022;Республика Мордовия;90_105_days;SputnikV;2948;3894;6842;448319;198808;647127
2021.12_13-10-2022;Республика Саха (Якутия);105_165_days;AllVaccines;89954;12246;102200;568643;148395;717038
2021.12_13-10-2022;Республика Саха (Якутия);105_165_days;CoviVac;25;2;27;568643;148395;717038
2021.12_13-10-2022;Республика Саха (Якутия);105_165_days;EpiVacCorona;15789;2578;18367;568643;148395;717038
2021.12_13-10-2022;Республика Саха (Якутия);105_165_days;SputnikLite;50027;5665;55692;568643;148395;717038
2021.12_13-10-2022;Республика Саха (Якутия);105_165_days;SputnikV;24113;4001;28114;568643;148395;717038
2021.12_13-10-2022;Республика Саха (Якутия);165_195_days;AllVaccines;51648;8253;59901;568643;148395;717038
2021.12_13-10-2022;Республика Саха (Якутия);165_195_days;CoviVac;83;3;86;568643;148395;717038
2021.12_13-10-2022;Республика Саха (Якутия);165_195_days;EpiVacCorona;18339;3333;21672;568643;148395;717038
2021.12_13-10-2022;Республика Саха (Якутия);165_195_days;SputnikLite;1510;101;1611;568643;148395;717038
2021.12_13-10-2022;Республика Саха (Якутия);165_195_days;SputnikV;31716;4816;36532;568643;148395;717038
2021.12_13-10-2022;Республика Саха (Якутия);21_45_days;AllVaccines;39883;11755;51638;568643;148395;717038
2021.12_13-10-2022;Республика Саха (Якутия);21_45_days;CoviVac;824;109;933;568643;148395;717038
2021.12_13-10-2022;Республика Саха (Якутия);21_45_days;EpiVacCorona;314;112;426;568643;148395;717038
2021.12_13-10-2022;Республика Саха (Якутия);21_45_days;SputnikLite;17324;5713;23037;568643;148395;717038
2021.12_13-10-2022;Республика Саха (Якутия);21_45_days;SputnikV;21421;5821;27242;568643;148395;717038
2021.12_13-10-2022;Республика Саха (Якутия);45_75_days;AllVaccines;47899;14057;61956;568643;148395;717038
2021.12_13-10-2022;Республика Саха (Якутия);45_75_days;CoviVac;888;167;1055;568643;148395;717038
2021.12_13-10-2022;Республика Саха (Якутия);45_75_days;EpiVacCorona;386;180;566;568643;148395;717038
2021.12_13-10-2022;Республика Саха (Якутия);45_75_days;SputnikLite;30681;9335;40016;568643;148395;717038
2021.12_13-10-2022;Республика Саха (Якутия);45_75_days;SputnikV;15944;4375;20319;568643;148395;717038
2021.12_13-10-2022;Республика Саха (Якутия);75_90_days;AllVaccines;20612;5043;25655;568643;148395;717038
2021.12_13-10-2022;Республика Саха (Якутия);75_90_days;CoviVac;12;6;18;568643;148395;717038
2021.12_13-10-2022;Республика Саха (Якутия);75_90_days;EpiVacCorona;484;146;630;568643;148395;717038
2021.12_13-10-2022;Республика Саха (Якутия);75_90_days;SputnikLite;17410;4253;21663;568643;148395;717038
2021.12_13-10-2022;Республика Саха (Якутия);75_90_days;SputnikV;2706;638;3344;568643;148395;717038
2021.12_13-10-2022;Республика Саха (Якутия);90_105_days;AllVaccines;9960;2630;12590;568643;148395;717038
2021.12_13-10-2022;Республика Саха (Якутия);90_105_days;CoviVac;10;1;11;568643;148395;717038
2021.12_13-10-2022;Республика Саха (Якутия);90_105_days;EpiVacCorona;276;36;312;568643;148395;717038
2021.12_13-10-2022;Республика Саха (Якутия);90_105_days;SputnikLite;7475;2036;9511;568643;148395;717038
2021.12_13-10-2022;Республика Саха (Якутия);90_105_days;SputnikV;2199;557;2756;568643;148395;717038
2021.12_13-10-2022;Республика Северная Осетия - Алания;105_165_days;AllVaccines;40565;7750;48315;385443;144230;529673
2021.12_13-10-2022;Республика Северная Осетия - Алания;105_165_days;CoviVac;17;7;24;385443;144230;529673
2021.12_13-10-2022;Республика Северная Осетия - Алания;105_165_days;EpiVacCorona;423;67;490;385443;144230;529673
2021.12_13-10-2022;Республика Северная Осетия - Алания;105_165_days;SputnikLite;7841;1594;9435;385443;144230;529673
2021.12_13-10-2022;Республика Северная Осетия - Алания;105_165_days;SputnikV;32284;6082;38366;385443;144230;529673
2021.12_13-10-2022;Республика Северная Осетия - Алания;165_195_days;AllVaccines;32960;6082;39042;385443;144230;529673
2021.12_13-10-2022;Республика Северная Осетия - Алания;165_195_days;CoviVac;98;57;155;385443;144230;529673
2021.12_13-10-2022;Республика Северная Осетия - Алания;165_195_days;EpiVacCorona;76;41;117;385443;144230;529673
2021.12_13-10-2022;Республика Северная Осетия - Алания;165_195_days;SputnikLite;381;92;473;385443;144230;529673
2021.12_13-10-2022;Республика Северная Осетия - Алания;165_195_days;SputnikV;32405;5892;38297;385443;144230;529673
2021.12_13-10-2022;Республика Северная Осетия - Алания;21_45_days;AllVaccines;21734;4254;25988;385443;144230;529673
2021.12_13-10-2022;Республика Северная Осетия - Алания;21_45_days;CoviVac;227;82;309;385443;144230;529673
2021.12_13-10-2022;Республика Северная Осетия - Алания;21_45_days;EpiVacCorona;618;110;728;385443;144230;529673
2021.12_13-10-2022;Республика Северная Осетия - Алания;21_45_days;SputnikLite;7792;1772;9564;385443;144230;529673
2021.12_13-10-2022;Республика Северная Осетия - Алания;21_45_days;SputnikV;13097;2290;15387;385443;144230;529673
2021.12_13-10-2022;Республика Северная Осетия - Алания;45_75_days;AllVaccines;32264;6531;38795;385443;144230;529673
2021.12_13-10-2022;Республика Северная Осетия - Алания;45_75_days;CoviVac;478;125;603;385443;144230;529673
2021.12_13-10-2022;Республика Северная Осетия - Алания;45_75_days;EpiVacCorona;545;55;600;385443;144230;529673
2021.12_13-10-2022;Республика Северная Осетия - Алания;45_75_days;SputnikLite;16732;3604;20336;385443;144230;529673
2021.12_13-10-2022;Республика Северная Осетия - Алания;45_75_days;SputnikV;14509;2747;17256;385443;144230;529673
2021.12_13-10-2022;Республика Северная Осетия - Алания;75_90_days;AllVaccines;7793;1942;9735;385443;144230;529673
2021.12_13-10-2022;Республика Северная Осетия - Алания;75_90_days;CoviVac;6;0;6;385443;144230;529673
2021.12_13-10-2022;Республика Северная Осетия - Алания;75_90_days;EpiVacCorona;99;10;109;385443;144230;529673
2021.12_13-10-2022;Республика Северная Осетия - Алания;75_90_days;SputnikLite;5333;1366;6699;385443;144230;529673
2021.12_13-10-2022;Республика Северная Осетия - Алания;75_90_days;SputnikV;2355;566;2921;385443;144230;529673
2021.12_13-10-2022;Республика Северная Осетия - Алания;90_105_days;AllVaccines;4089;1159;5248;385443;144230;529673
2021.12_13-10-2022;Республика Северная Осетия - Алания;90_105_days;CoviVac;4;2;6;385443;144230;529673
2021.12_13-10-2022;Республика Северная Осетия - Алания;90_105_days;EpiVacCorona;78;22;100;385443;144230;529673
2021.12_13-10-2022;Республика Северная Осетия - Алания;90_105_days;SputnikLite;1925;619;2544;385443;144230;529673
2021.12_13-10-2022;Республика Северная Осетия - Алания;90_105_days;SputnikV;2082;516;2598;385443;144230;529673
2021.12_13-10-2022;Республика Татарстан;105_165_days;AllVaccines;294603;61104;355707;2180132;866477;3046609
2021.12_13-10-2022;Республика Татарстан;105_165_days;CoviVac;7668;1079;8747;2180132;866477;3046609
2021.12_13-10-2022;Республика Татарстан;105_165_days;EpiVacCorona;6298;2272;8570;2180132;866477;3046609
2021.12_13-10-2022;Республика Татарстан;105_165_days;SputnikLite;43368;11566;54934;2180132;866477;3046609
2021.12_13-10-2022;Республика Татарстан;105_165_days;SputnikV;237269;46187;283456;2180132;866477;3046609
2021.12_13-10-2022;Республика Татарстан;165_195_days;AllVaccines;215112;42026;257138;2180132;866477;3046609
2021.12_13-10-2022;Республика Татарстан;165_195_days;CoviVac;2950;492;3442;2180132;866477;3046609
2021.12_13-10-2022;Республика Татарстан;165_195_days;EpiVacCorona;4523;1417;5940;2180132;866477;3046609
2021.12_13-10-2022;Республика Татарстан;165_195_days;SputnikLite;3113;238;3351;2180132;866477;3046609
2021.12_13-10-2022;Республика Татарстан;165_195_days;SputnikV;204526;39879;244405;2180132;866477;3046609
2021.12_13-10-2022;Республика Татарстан;21_45_days;AllVaccines;211905;93950;305855;2180132;866477;3046609
2021.12_13-10-2022;Республика Татарстан;21_45_days;CoviVac;720;270;990;2180132;866477;3046609
2021.12_13-10-2022;Республика Татарстан;21_45_days;EpiVacCorona;3492;2310;5802;2180132;866477;3046609
2021.12_13-10-2022;Республика Татарстан;21_45_days;SputnikLite;32112;25345;57457;2180132;866477;3046609
2021.12_13-10-2022;Республика Татарстан;21_45_days;SputnikV;175581;66025;241606;2180132;866477;3046609
2021.12_13-10-2022;Республика Татарстан;45_75_days;AllVaccines;508093;139959;648052;2180132;866477;3046609
2021.12_13-10-2022;Республика Татарстан;45_75_days;CoviVac;2043;428;2471;2180132;866477;3046609
2021.12_13-10-2022;Республика Татарстан;45_75_days;EpiVacCorona;9758;4243;14001;2180132;866477;3046609
2021.12_13-10-2022;Республика Татарстан;45_75_days;SputnikLite;51634;27506;79140;2180132;866477;3046609
2021.12_13-10-2022;Республика Татарстан;45_75_days;SputnikV;444658;107782;552440;2180132;866477;3046609
2021.12_13-10-2022;Республика Татарстан;75_90_days;AllVaccines;73946;23784;97730;2180132;866477;3046609
2021.12_13-10-2022;Республика Татарстан;75_90_days;CoviVac;1355;293;1648;2180132;866477;3046609
2021.12_13-10-2022;Республика Татарстан;75_90_days;EpiVacCorona;2434;1085;3519;2180132;866477;3046609
2021.12_13-10-2022;Республика Татарстан;75_90_days;SputnikLite;28165;8861;37026;2180132;866477;3046609
2021.12_13-10-2022;Республика Татарстан;75_90_days;SputnikV;41992;13545;55537;2180132;866477;3046609
2021.12_13-10-2022;Республика Татарстан;90_105_days;AllVaccines;63437;17858;81295;2180132;866477;3046609
2021.12_13-10-2022;Республика Татарстан;90_105_days;CoviVac;822;169;991;2180132;866477;3046609
2021.12_13-10-2022;Республика Татарстан;90_105_days;EpiVacCorona;432;222;654;2180132;866477;3046609
2021.12_13-10-2022;Республика Татарстан;90_105_days;SputnikLite;33100;9786;42886;2180132;866477;3046609
2021.12_13-10-2022;Республика Татарстан;90_105_days;SputnikV;29083;7681;36764;2180132;866477;3046609
2021.12_13-10-2022;Республика Тыва;105_165_days;AllVaccines;28472;3028;31500;176122;31028;207150
2021.12_13-10-2022;Республика Тыва;105_165_days;CoviVac;219;13;232;176122;31028;207150
2021.12_13-10-2022;Республика Тыва;105_165_days;EpiVacCorona;73;15;88;176122;31028;207150
2021.12_13-10-2022;Республика Тыва;105_165_days;SputnikLite;15296;1212;16508;176122;31028;207150
2021.12_13-10-2022;Республика Тыва;105_165_days;SputnikV;12884;1788;14672;176122;31028;207150
2021.12_13-10-2022;Республика Тыва;165_195_days;AllVaccines;18077;2547;20624;176122;31028;207150
2021.12_13-10-2022;Республика Тыва;165_195_days;CoviVac;985;34;1019;176122;31028;207150
2021.12_13-10-2022;Республика Тыва;165_195_days;EpiVacCorona;376;122;498;176122;31028;207150
2021.12_13-10-2022;Республика Тыва;165_195_days;SputnikLite;1624;81;1705;176122;31028;207150
2021.12_13-10-2022;Республика Тыва;165_195_days;SputnikV;15092;2310;17402;176122;31028;207150
2021.12_13-10-2022;Республика Тыва;21_45_days;AllVaccines;10663;2185;12848;176122;31028;207150
2021.12_13-10-2022;Республика Тыва;21_45_days;CoviVac;3;0;3;176122;31028;207150
2021.12_13-10-2022;Республика Тыва;21_45_days;EpiVacCorona;95;9;104;176122;31028;207150
2021.12_13-10-2022;Республика Тыва;21_45_days;SputnikLite;5713;1511;7224;176122;31028;207150
2021.12_13-10-2022;Республика Тыва;21_45_days;SputnikV;4852;665;5517;176122;31028;207150
2021.12_13-10-2022;Республика Тыва;45_75_days;AllVaccines;18524;3768;22292;176122;31028;207150
2021.12_13-10-2022;Республика Тыва;45_75_days;CoviVac;22;2;24;176122;31028;207150
2021.12_13-10-2022;Республика Тыва;45_75_days;EpiVacCorona;85;22;107;176122;31028;207150
2021.12_13-10-2022;Республика Тыва;45_75_days;SputnikLite;14084;2934;17018;176122;31028;207150
2021.12_13-10-2022;Республика Тыва;45_75_days;SputnikV;4333;810;5143;176122;31028;207150
2021.12_13-10-2022;Республика Тыва;75_90_days;AllVaccines;10351;2971;13322;176122;31028;207150
2021.12_13-10-2022;Республика Тыва;75_90_days;CoviVac;12;1;13;176122;31028;207150
2021.12_13-10-2022;Республика Тыва;75_90_days;EpiVacCorona;3;0;3;176122;31028;207150
2021.12_13-10-2022;Республика Тыва;75_90_days;SputnikLite;9513;2765;12278;176122;31028;207150
2021.12_13-10-2022;Республика Тыва;75_90_days;SputnikV;823;205;1028;176122;31028;207150
2021.12_13-10-2022;Республика Тыва;90_105_days;AllVaccines;5613;1337;6950;176122;31028;207150
2021.12_13-10-2022;Республика Тыва;90_105_days;CoviVac;8;1;9;176122;31028;207150
2021.12_13-10-2022;Республика Тыва;90_105_days;EpiVacCorona;22;4;26;176122;31028;207150
2021.12_13-10-2022;Республика Тыва;90_105_days;SputnikLite;4933;1203;6136;176122;31028;207150
2021.12_13-10-2022;Республика Тыва;90_105_days;SputnikV;650;129;779;176122;31028;207150
2021.12_13-10-2022;Республика Хакасия;105_165_days;AllVaccines;52171;11620;63791;291439;112190;403629
2021.12_13-10-2022;Республика Хакасия;105_165_days;CoviVac;622;166;788;291439;112190;403629
2021.12_13-10-2022;Республика Хакасия;105_165_days;EpiVacCorona;546;154;700;291439;112190;403629
2021.12_13-10-2022;Республика Хакасия;105_165_days;SputnikLite;8844;2552;11396;291439;112190;403629
2021.12_13-10-2022;Республика Хакасия;105_165_days;SputnikV;42159;8748;50907;291439;112190;403629
2021.12_13-10-2022;Республика Хакасия;165_195_days;AllVaccines;31006;7669;38675;291439;112190;403629
2021.12_13-10-2022;Республика Хакасия;165_195_days;CoviVac;929;192;1121;291439;112190;403629
2021.12_13-10-2022;Республика Хакасия;165_195_days;EpiVacCorona;106;40;146;291439;112190;403629
2021.12_13-10-2022;Республика Хакасия;165_195_days;SputnikLite;0;1;1;291439;112190;403629
2021.12_13-10-2022;Республика Хакасия;165_195_days;SputnikV;29971;7436;37407;291439;112190;403629
2021.12_13-10-2022;Республика Хакасия;21_45_days;AllVaccines;17368;8403;25771;291439;112190;403629
2021.12_13-10-2022;Республика Хакасия;21_45_days;CoviVac;233;65;298;291439;112190;403629
2021.12_13-10-2022;Республика Хакасия;21_45_days;EpiVacCorona;422;182;604;291439;112190;403629
2021.12_13-10-2022;Республика Хакасия;21_45_days;SputnikLite;6680;3744;10424;291439;112190;403629
2021.12_13-10-2022;Республика Хакасия;21_45_days;SputnikV;10033;4412;14445;291439;112190;403629
2021.12_13-10-2022;Республика Хакасия;45_75_days;AllVaccines;20207;12007;32214;291439;112190;403629
2021.12_13-10-2022;Республика Хакасия;45_75_days;CoviVac;489;165;654;291439;112190;403629
2021.12_13-10-2022;Республика Хакасия;45_75_days;EpiVacCorona;384;198;582;291439;112190;403629
2021.12_13-10-2022;Республика Хакасия;45_75_days;SputnikLite;10121;7168;17289;291439;112190;403629
2021.12_13-10-2022;Республика Хакасия;45_75_days;SputnikV;9213;4476;13689;291439;112190;403629
2021.12_13-10-2022;Республика Хакасия;75_90_days;AllVaccines;8117;3967;12084;291439;112190;403629
2021.12_13-10-2022;Республика Хакасия;75_90_days;CoviVac;80;56;136;291439;112190;403629
2021.12_13-10-2022;Республика Хакасия;75_90_days;EpiVacCorona;11;4;15;291439;112190;403629
2021.12_13-10-2022;Республика Хакасия;75_90_days;SputnikLite;6604;3070;9674;291439;112190;403629
2021.12_13-10-2022;Республика Хакасия;75_90_days;SputnikV;1422;837;2259;291439;112190;403629
2021.12_13-10-2022;Республика Хакасия;90_105_days;AllVaccines;4015;2111;6126;291439;112190;403629
2021.12_13-10-2022;Республика Хакасия;90_105_days;CoviVac;60;24;84;291439;112190;403629
2021.12_13-10-2022;Республика Хакасия;90_105_days;EpiVacCorona;18;5;23;291439;112190;403629
2021.12_13-10-2022;Республика Хакасия;90_105_days;SputnikLite;2540;1542;4082;291439;112190;403629
2021.12_13-10-2022;Республика Хакасия;90_105_days;SputnikV;1397;540;1937;291439;112190;403629
2021.12_13-10-2022;Ростовская область;105_165_days;AllVaccines;539865;117478;657343;2367942;1020468;3388410
2021.12_13-10-2022;Ростовская область;105_165_days;CoviVac;4798;992;5790;2367942;1020468;3388410
2021.12_13-10-2022;Ростовская область;105_165_days;EpiVacCorona;7454;2383;9837;2367942;1020468;3388410
2021.12_13-10-2022;Ростовская область;105_165_days;SputnikLite;67751;21954;89705;2367942;1020468;3388410
2021.12_13-10-2022;Ростовская область;105_165_days;SputnikV;459862;92149;552011;2367942;1020468;3388410
2021.12_13-10-2022;Ростовская область;165_195_days;AllVaccines;273856;60862;334718;2367942;1020468;3388410
2021.12_13-10-2022;Ростовская область;165_195_days;CoviVac;5380;929;6309;2367942;1020468;3388410
2021.12_13-10-2022;Ростовская область;165_195_days;EpiVacCorona;13369;5431;18800;2367942;1020468;3388410
2021.12_13-10-2022;Ростовская область;165_195_days;SputnikLite;3767;621;4388;2367942;1020468;3388410
2021.12_13-10-2022;Ростовская область;165_195_days;SputnikV;251340;53881;305221;2367942;1020468;3388410
2021.12_13-10-2022;Ростовская область;21_45_days;AllVaccines;137221;82633;219854;2367942;1020468;3388410
2021.12_13-10-2022;Ростовская область;21_45_days;CoviVac;807;373;1180;2367942;1020468;3388410
2021.12_13-10-2022;Ростовская область;21_45_days;EpiVacCorona;926;669;1595;2367942;1020468;3388410
2021.12_13-10-2022;Ростовская область;21_45_days;SputnikLite;33656;24145;57801;2367942;1020468;3388410
2021.12_13-10-2022;Ростовская область;21_45_days;SputnikV;101832;57446;159278;2367942;1020468;3388410
2021.12_13-10-2022;Ростовская область;45_75_days;AllVaccines;132735;70758;203493;2367942;1020468;3388410
2021.12_13-10-2022;Ростовская область;45_75_days;CoviVac;1908;780;2688;2367942;1020468;3388410
2021.12_13-10-2022;Ростовская область;45_75_days;EpiVacCorona;1730;794;2524;2367942;1020468;3388410
2021.12_13-10-2022;Ростовская область;45_75_days;SputnikLite;31884;23733;55617;2367942;1020468;3388410
2021.12_13-10-2022;Ростовская область;45_75_days;SputnikV;97213;45451;142664;2367942;1020468;3388410
2021.12_13-10-2022;Ростовская область;75_90_days;AllVaccines;48472;24570;73042;2367942;1020468;3388410
2021.12_13-10-2022;Ростовская область;75_90_days;CoviVac;530;229;759;2367942;1020468;3388410
2021.12_13-10-2022;Ростовская область;75_90_days;EpiVacCorona;416;269;685;2367942;1020468;3388410
2021.12_13-10-2022;Ростовская область;75_90_days;SputnikLite;26611;15571;42182;2367942;1020468;3388410
2021.12_13-10-2022;Ростовская область;75_90_days;SputnikV;20915;8501;29416;2367942;1020468;3388410
2021.12_13-10-2022;Ростовская область;90_105_days;AllVaccines;34997;17738;52735;2367942;1020468;3388410
2021.12_13-10-2022;Ростовская область;90_105_days;CoviVac;464;171;635;2367942;1020468;3388410
2021.12_13-10-2022;Ростовская область;90_105_days;EpiVacCorona;489;185;674;2367942;1020468;3388410
2021.12_13-10-2022;Ростовская область;90_105_days;SputnikLite;13946;9126;23072;2367942;1020468;3388410
2021.12_13-10-2022;Ростовская область;90_105_days;SputnikV;20098;8256;28354;2367942;1020468;3388410
2021.12_13-10-2022;Рязанская область;105_165_days;AllVaccines;74086;26267;100353;600731;301318;902049
2021.12_13-10-2022;Рязанская область;105_165_days;CoviVac;847;147;994;600731;301318;902049
2021.12_13-10-2022;Рязанская область;105_165_days;EpiVacCorona;1335;535;1870;600731;301318;902049
2021.12_13-10-2022;Рязанская область;105_165_days;SputnikLite;13754;10199;23953;600731;301318;902049
2021.12_13-10-2022;Рязанская область;105_165_days;SputnikV;58150;15386;73536;600731;301318;902049
2021.12_13-10-2022;Рязанская область;165_195_days;AllVaccines;47735;13182;60917;600731;301318;902049
2021.12_13-10-2022;Рязанская область;165_195_days;CoviVac;334;65;399;600731;301318;902049
2021.12_13-10-2022;Рязанская область;165_195_days;EpiVacCorona;277;345;622;600731;301318;902049
2021.12_13-10-2022;Рязанская область;165_195_days;SputnikLite;105;68;173;600731;301318;902049
2021.12_13-10-2022;Рязанская область;165_195_days;SputnikV;47019;12704;59723;600731;301318;902049
2021.12_13-10-2022;Рязанская область;21_45_days;AllVaccines;57838;33038;90876;600731;301318;902049
2021.12_13-10-2022;Рязанская область;21_45_days;CoviVac;989;313;1302;600731;301318;902049
2021.12_13-10-2022;Рязанская область;21_45_days;EpiVacCorona;1093;456;1549;600731;301318;902049
2021.12_13-10-2022;Рязанская область;21_45_days;SputnikLite;12550;13529;26079;600731;301318;902049
2021.12_13-10-2022;Рязанская область;21_45_days;SputnikV;43206;18740;61946;600731;301318;902049
2021.12_13-10-2022;Рязанская область;45_75_days;AllVaccines;87799;27079;114878;600731;301318;902049
2021.12_13-10-2022;Рязанская область;45_75_days;CoviVac;1304;266;1570;600731;301318;902049
2021.12_13-10-2022;Рязанская область;45_75_days;EpiVacCorona;4487;1109;5596;600731;301318;902049
2021.12_13-10-2022;Рязанская область;45_75_days;SputnikLite;6799;6740;13539;600731;301318;902049
2021.12_13-10-2022;Рязанская область;45_75_days;SputnikV;75209;18964;94173;600731;301318;902049
2021.12_13-10-2022;Рязанская область;75_90_days;AllVaccines;16134;7031;23165;600731;301318;902049
2021.12_13-10-2022;Рязанская область;75_90_days;CoviVac;78;17;95;600731;301318;902049
2021.12_13-10-2022;Рязанская область;75_90_days;EpiVacCorona;550;133;683;600731;301318;902049
2021.12_13-10-2022;Рязанская область;75_90_days;SputnikLite;9813;4752;14565;600731;301318;902049
2021.12_13-10-2022;Рязанская область;75_90_days;SputnikV;5693;2129;7822;600731;301318;902049
2021.12_13-10-2022;Рязанская область;90_105_days;AllVaccines;12536;6383;18919;600731;301318;902049
2021.12_13-10-2022;Рязанская область;90_105_days;CoviVac;58;11;69;600731;301318;902049
2021.12_13-10-2022;Рязанская область;90_105_days;EpiVacCorona;73;31;104;600731;301318;902049
2021.12_13-10-2022;Рязанская область;90_105_days;SputnikLite;8151;5027;13178;600731;301318;902049
2021.12_13-10-2022;Рязанская область;90_105_days;SputnikV;4254;1314;5568;600731;301318;902049
2021.12_13-10-2022;Самарская область;105_165_days;AllVaccines;352197;74203;426400;1769846;769791;2539637
2021.12_13-10-2022;Самарская область;105_165_days;CoviVac;4999;955;5954;1769846;769791;2539637
2021.12_13-10-2022;Самарская область;105_165_days;EpiVacCorona;6920;1809;8729;1769846;769791;2539637
2021.12_13-10-2022;Самарская область;105_165_days;SputnikLite;100300;26924;127224;1769846;769791;2539637
2021.12_13-10-2022;Самарская область;105_165_days;SputnikV;239978;44515;284493;1769846;769791;2539637
2021.12_13-10-2022;Самарская область;165_195_days;AllVaccines;187578;41177;228755;1769846;769791;2539637
2021.12_13-10-2022;Самарская область;165_195_days;CoviVac;4931;812;5743;1769846;769791;2539637
2021.12_13-10-2022;Самарская область;165_195_days;EpiVacCorona;8158;2321;10479;1769846;769791;2539637
2021.12_13-10-2022;Самарская область;165_195_days;SputnikLite;8072;716;8788;1769846;769791;2539637
2021.12_13-10-2022;Самарская область;165_195_days;SputnikV;166417;37328;203745;1769846;769791;2539637
2021.12_13-10-2022;Самарская область;21_45_days;AllVaccines;149161;84736;233897;1769846;769791;2539637
2021.12_13-10-2022;Самарская область;21_45_days;CoviVac;1117;391;1508;1769846;769791;2539637
2021.12_13-10-2022;Самарская область;21_45_days;EpiVacCorona;2155;1603;3758;1769846;769791;2539637
2021.12_13-10-2022;Самарская область;21_45_days;SputnikLite;35163;29404;64567;1769846;769791;2539637
2021.12_13-10-2022;Самарская область;21_45_days;SputnikV;110726;53338;164064;1769846;769791;2539637
2021.12_13-10-2022;Самарская область;45_75_days;AllVaccines;194119;96690;290809;1769846;769791;2539637
2021.12_13-10-2022;Самарская область;45_75_days;CoviVac;975;336;1311;1769846;769791;2539637
2021.12_13-10-2022;Самарская область;45_75_days;EpiVacCorona;2527;1543;4070;1769846;769791;2539637
2021.12_13-10-2022;Самарская область;45_75_days;SputnikLite;29318;23936;53254;1769846;769791;2539637
2021.12_13-10-2022;Самарская область;45_75_days;SputnikV;161299;70875;232174;1769846;769791;2539637
2021.12_13-10-2022;Самарская область;75_90_days;AllVaccines;59751;24820;84571;1769846;769791;2539637
2021.12_13-10-2022;Самарская область;75_90_days;CoviVac;432;139;571;1769846;769791;2539637
2021.12_13-10-2022;Самарская область;75_90_days;EpiVacCorona;274;217;491;1769846;769791;2539637
2021.12_13-10-2022;Самарская область;75_90_days;SputnikLite;35413;16417;51830;1769846;769791;2539637
2021.12_13-10-2022;Самарская область;75_90_days;SputnikV;23632;8047;31679;1769846;769791;2539637
2021.12_13-10-2022;Самарская область;90_105_days;AllVaccines;43579;20528;64107;1769846;769791;2539637
2021.12_13-10-2022;Самарская область;90_105_days;CoviVac;405;123;528;1769846;769791;2539637
2021.12_13-10-2022;Самарская область;90_105_days;EpiVacCorona;163;476;639;1769846;769791;2539637
2021.12_13-10-2022;Самарская область;90_105_days;SputnikLite;29330;15009;44339;1769846;769791;2539637
2021.12_13-10-2022;Самарская область;90_105_days;SputnikV;13681;4920;18601;1769846;769791;2539637
2021.12_13-10-2022;Саратовская область;105_165_days;AllVaccines;164010;49850;213860;1348454;599954;1948408
2021.12_13-10-2022;Саратовская область;105_165_days;CoviVac;2508;430;2938;1348454;599954;1948408
2021.12_13-10-2022;Саратовская область;105_165_days;EpiVacCorona;2315;1330;3645;1348454;599954;1948408
2021.12_13-10-2022;Саратовская область;105_165_days;SputnikLite;37220;16183;53403;1348454;599954;1948408
2021.12_13-10-2022;Саратовская область;105_165_days;SputnikV;121967;31907;153874;1348454;599954;1948408
2021.12_13-10-2022;Саратовская область;165_195_days;AllVaccines;125765;33428;159193;1348454;599954;1948408
2021.12_13-10-2022;Саратовская область;165_195_days;CoviVac;2948;337;3285;1348454;599954;1948408
2021.12_13-10-2022;Саратовская область;165_195_days;EpiVacCorona;1246;576;1822;1348454;599954;1948408
2021.12_13-10-2022;Саратовская область;165_195_days;SputnikLite;155;46;201;1348454;599954;1948408
2021.12_13-10-2022;Саратовская область;165_195_days;SputnikV;121416;32469;153885;1348454;599954;1948408
2021.12_13-10-2022;Саратовская область;21_45_days;AllVaccines;124411;55083;179494;1348454;599954;1948408
2021.12_13-10-2022;Саратовская область;21_45_days;CoviVac;811;176;987;1348454;599954;1948408
2021.12_13-10-2022;Саратовская область;21_45_days;EpiVacCorona;5420;2334;7754;1348454;599954;1948408
2021.12_13-10-2022;Саратовская область;21_45_days;SputnikLite;26323;18504;44827;1348454;599954;1948408
2021.12_13-10-2022;Саратовская область;21_45_days;SputnikV;91857;34069;125926;1348454;599954;1948408
2021.12_13-10-2022;Саратовская область;45_75_days;AllVaccines;136885;57533;194418;1348454;599954;1948408
2021.12_13-10-2022;Саратовская область;45_75_days;CoviVac;1020;151;1171;1348454;599954;1948408
2021.12_13-10-2022;Саратовская область;45_75_days;EpiVacCorona;5445;1841;7286;1348454;599954;1948408
2021.12_13-10-2022;Саратовская область;45_75_days;SputnikLite;27542;16488;44030;1348454;599954;1948408
2021.12_13-10-2022;Саратовская область;45_75_days;SputnikV;102878;39053;141931;1348454;599954;1948408
2021.12_13-10-2022;Саратовская область;75_90_days;AllVaccines;40064;17955;58019;1348454;599954;1948408
2021.12_13-10-2022;Саратовская область;75_90_days;CoviVac;474;81;555;1348454;599954;1948408
2021.12_13-10-2022;Саратовская область;75_90_days;EpiVacCorona;331;160;491;1348454;599954;1948408
2021.12_13-10-2022;Саратовская область;75_90_days;SputnikLite;28175;10950;39125;1348454;599954;1948408
2021.12_13-10-2022;Саратовская область;75_90_days;SputnikV;11084;6764;17848;1348454;599954;1948408
2021.12_13-10-2022;Саратовская область;90_105_days;AllVaccines;23812;11968;35780;1348454;599954;1948408
2021.12_13-10-2022;Саратовская область;90_105_days;CoviVac;388;114;502;1348454;599954;1948408
2021.12_13-10-2022;Саратовская область;90_105_days;EpiVacCorona;156;92;248;1348454;599954;1948408
2021.12_13-10-2022;Саратовская область;90_105_days;SputnikLite;14161;6762;20923;1348454;599954;1948408
2021.12_13-10-2022;Саратовская область;90_105_days;SputnikV;9107;5000;14107;1348454;599954;1948408
2021.12_13-10-2022;Сахалинская область;105_165_days;AllVaccines;36656;6857;43513;276677;101794;378471
2021.12_13-10-2022;Сахалинская область;105_165_days;CoviVac;172;31;203;276677;101794;378471
2021.12_13-10-2022;Сахалинская область;105_165_days;EpiVacCorona;133;33;166;276677;101794;378471
2021.12_13-10-2022;Сахалинская область;105_165_days;SputnikLite;7478;1304;8782;276677;101794;378471
2021.12_13-10-2022;Сахалинская область;105_165_days;SputnikV;28873;5489;34362;276677;101794;378471
2021.12_13-10-2022;Сахалинская область;165_195_days;AllVaccines;34268;7502;41770;276677;101794;378471
2021.12_13-10-2022;Сахалинская область;165_195_days;CoviVac;1213;190;1403;276677;101794;378471
2021.12_13-10-2022;Сахалинская область;165_195_days;EpiVacCorona;392;78;470;276677;101794;378471
2021.12_13-10-2022;Сахалинская область;165_195_days;SputnikLite;447;20;467;276677;101794;378471
2021.12_13-10-2022;Сахалинская область;165_195_days;SputnikV;32216;7214;39430;276677;101794;378471
2021.12_13-10-2022;Сахалинская область;21_45_days;AllVaccines;19138;7074;26212;276677;101794;378471
2021.12_13-10-2022;Сахалинская область;21_45_days;CoviVac;365;57;422;276677;101794;378471
2021.12_13-10-2022;Сахалинская область;21_45_days;EpiVacCorona;1904;443;2347;276677;101794;378471
2021.12_13-10-2022;Сахалинская область;21_45_days;SputnikLite;6723;4200;10923;276677;101794;378471
2021.12_13-10-2022;Сахалинская область;21_45_days;SputnikV;10146;2374;12520;276677;101794;378471
2021.12_13-10-2022;Сахалинская область;45_75_days;AllVaccines;20218;11687;31905;276677;101794;378471
2021.12_13-10-2022;Сахалинская область;45_75_days;CoviVac;60;8;68;276677;101794;378471
2021.12_13-10-2022;Сахалинская область;45_75_days;EpiVacCorona;1909;647;2556;276677;101794;378471
2021.12_13-10-2022;Сахалинская область;45_75_days;SputnikLite;10388;8698;19086;276677;101794;378471
2021.12_13-10-2022;Сахалинская область;45_75_days;SputnikV;7861;2334;10195;276677;101794;378471
2021.12_13-10-2022;Сахалинская область;75_90_days;AllVaccines;4460;3855;8315;276677;101794;378471
2021.12_13-10-2022;Сахалинская область;75_90_days;CoviVac;7;3;10;276677;101794;378471
2021.12_13-10-2022;Сахалинская область;75_90_days;EpiVacCorona;46;23;69;276677;101794;378471
2021.12_13-10-2022;Сахалинская область;75_90_days;SputnikLite;2767;3382;6149;276677;101794;378471
2021.12_13-10-2022;Сахалинская область;75_90_days;SputnikV;1640;447;2087;276677;101794;378471
2021.12_13-10-2022;Сахалинская область;90_105_days;AllVaccines;2892;2048;4940;276677;101794;378471
2021.12_13-10-2022;Сахалинская область;90_105_days;CoviVac;1;1;2;276677;101794;378471
2021.12_13-10-2022;Сахалинская область;90_105_days;EpiVacCorona;27;5;32;276677;101794;378471
2021.12_13-10-2022;Сахалинская область;90_105_days;SputnikLite;1344;1628;2972;276677;101794;378471
2021.12_13-10-2022;Сахалинская область;90_105_days;SputnikV;1520;414;1934;276677;101794;378471
2021.12_13-10-2022;Свердловская область;105_165_days;AllVaccines;342271;95408;437679;2364046;987486;3351532
2021.12_13-10-2022;Свердловская область;105_165_days;CoviVac;2852;509;3361;2364046;987486;3351532
2021.12_13-10-2022;Свердловская область;105_165_days;EpiVacCorona;8572;3415;11987;2364046;987486;3351532
2021.12_13-10-2022;Свердловская область;105_165_days;SputnikLite;135428;29249;164677;2364046;987486;3351532
2021.12_13-10-2022;Свердловская область;105_165_days;SputnikV;195419;62235;257654;2364046;987486;3351532
2021.12_13-10-2022;Свердловская область;165_195_days;AllVaccines;185555;52239;237794;2364046;987486;3351532
2021.12_13-10-2022;Свердловская область;165_195_days;CoviVac;3133;397;3530;2364046;987486;3351532
2021.12_13-10-2022;Свердловская область;165_195_days;EpiVacCorona;5356;1804;7160;2364046;987486;3351532
2021.12_13-10-2022;Свердловская область;165_195_days;SputnikLite;4013;420;4433;2364046;987486;3351532
2021.12_13-10-2022;Свердловская область;165_195_days;SputnikV;173053;49618;222671;2364046;987486;3351532
2021.12_13-10-2022;Свердловская область;21_45_days;AllVaccines;259738;114753;374491;2364046;987486;3351532
2021.12_13-10-2022;Свердловская область;21_45_days;CoviVac;742;189;931;2364046;987486;3351532
2021.12_13-10-2022;Свердловская область;21_45_days;EpiVacCorona;4113;2102;6215;2364046;987486;3351532
2021.12_13-10-2022;Свердловская область;21_45_days;SputnikLite;58784;38574;97358;2364046;987486;3351532
2021.12_13-10-2022;Свердловская область;21_45_days;SputnikV;196099;73888;269987;2364046;987486;3351532
2021.12_13-10-2022;Свердловская область;45_75_days;AllVaccines;314953;107483;422436;2364046;987486;3351532
2021.12_13-10-2022;Свердловская область;45_75_days;CoviVac;3597;669;4266;2364046;987486;3351532
2021.12_13-10-2022;Свердловская область;45_75_days;EpiVacCorona;7965;2900;10865;2364046;987486;3351532
2021.12_13-10-2022;Свердловская область;45_75_days;SputnikLite;56925;32080;89005;2364046;987486;3351532
2021.12_13-10-2022;Свердловская область;45_75_days;SputnikV;246466;71834;318300;2364046;987486;3351532
2021.12_13-10-2022;Свердловская область;75_90_days;AllVaccines;110693;32725;143418;2364046;987486;3351532
2021.12_13-10-2022;Свердловская область;75_90_days;CoviVac;1789;379;2168;2364046;987486;3351532
2021.12_13-10-2022;Свердловская область;75_90_days;EpiVacCorona;609;273;882;2364046;987486;3351532
2021.12_13-10-2022;Свердловская область;75_90_days;SputnikLite;76726;21913;98639;2364046;987486;3351532
2021.12_13-10-2022;Свердловская область;75_90_days;SputnikV;31569;10160;41729;2364046;987486;3351532
2021.12_13-10-2022;Свердловская область;90_105_days;AllVaccines;58770;20972;79742;2364046;987486;3351532
2021.12_13-10-2022;Свердловская область;90_105_days;CoviVac;809;245;1054;2364046;987486;3351532
2021.12_13-10-2022;Свердловская область;90_105_days;EpiVacCorona;158;75;233;2364046;987486;3351532
2021.12_13-10-2022;Свердловская область;90_105_days;SputnikLite;41135;13532;54667;2364046;987486;3351532
2021.12_13-10-2022;Свердловская область;90_105_days;SputnikV;16668;7120;23788;2364046;987486;3351532
2021.12_13-10-2022;Смоленская область;105_165_days;AllVaccines;86700;21915;108615;521379;238479;759858
2021.12_13-10-2022;Смоленская область;105_165_days;CoviVac;676;80;756;521379;238479;759858
2021.12_13-10-2022;Смоленская область;105_165_days;EpiVacCorona;1180;365;1545;521379;238479;759858
2021.12_13-10-2022;Смоленская область;105_165_days;SputnikLite;13106;5974;19080;521379;238479;759858
2021.12_13-10-2022;Смоленская область;105_165_days;SputnikV;71738;15496;87234;521379;238479;759858
2021.12_13-10-2022;Смоленская область;165_195_days;AllVaccines;52152;12512;64664;521379;238479;759858
2021.12_13-10-2022;Смоленская область;165_195_days;CoviVac;834;79;913;521379;238479;759858
2021.12_13-10-2022;Смоленская область;165_195_days;EpiVacCorona;131;40;171;521379;238479;759858
2021.12_13-10-2022;Смоленская область;165_195_days;SputnikLite;114;15;129;521379;238479;759858
2021.12_13-10-2022;Смоленская область;165_195_days;SputnikV;51073;12378;63451;521379;238479;759858
2021.12_13-10-2022;Смоленская область;21_45_days;AllVaccines;29740;19852;49592;521379;238479;759858
2021.12_13-10-2022;Смоленская область;21_45_days;CoviVac;236;61;297;521379;238479;759858
2021.12_13-10-2022;Смоленская область;21_45_days;EpiVacCorona;1249;634;1883;521379;238479;759858
2021.12_13-10-2022;Смоленская область;21_45_days;SputnikLite;9395;8767;18162;521379;238479;759858
2021.12_13-10-2022;Смоленская область;21_45_days;SputnikV;18860;10390;29250;521379;238479;759858
2021.12_13-10-2022;Смоленская область;45_75_days;AllVaccines;35296;19888;55184;521379;238479;759858
2021.12_13-10-2022;Смоленская область;45_75_days;CoviVac;147;33;180;521379;238479;759858
2021.12_13-10-2022;Смоленская область;45_75_days;EpiVacCorona;332;149;481;521379;238479;759858
2021.12_13-10-2022;Смоленская область;45_75_days;SputnikLite;12593;11205;23798;521379;238479;759858
2021.12_13-10-2022;Смоленская область;45_75_days;SputnikV;22224;8501;30725;521379;238479;759858
2021.12_13-10-2022;Смоленская область;75_90_days;AllVaccines;17066;8295;25361;521379;238479;759858
2021.12_13-10-2022;Смоленская область;75_90_days;CoviVac;31;2;33;521379;238479;759858
2021.12_13-10-2022;Смоленская область;75_90_days;EpiVacCorona;78;32;110;521379;238479;759858
2021.12_13-10-2022;Смоленская область;75_90_days;SputnikLite;13692;6523;20215;521379;238479;759858
2021.12_13-10-2022;Смоленская область;75_90_days;SputnikV;3265;1738;5003;521379;238479;759858
2021.12_13-10-2022;Смоленская область;90_105_days;AllVaccines;7424;3877;11301;521379;238479;759858
2021.12_13-10-2022;Смоленская область;90_105_days;CoviVac;14;6;20;521379;238479;759858
2021.12_13-10-2022;Смоленская область;90_105_days;EpiVacCorona;74;31;105;521379;238479;759858
2021.12_13-10-2022;Смоленская область;90_105_days;SputnikLite;4347;2744;7091;521379;238479;759858
2021.12_13-10-2022;Смоленская область;90_105_days;SputnikV;2989;1096;4085;521379;238479;759858
2021.12_13-10-2022;Ставропольский край;105_165_days;AllVaccines;192372;50377;242749;1590669;616030;2206699
2021.12_13-10-2022;Ставропольский край;105_165_days;CoviVac;2253;487;2740;1590669;616030;2206699
2021.12_13-10-2022;Ставропольский край;105_165_days;EpiVacCorona;2840;1116;3956;1590669;616030;2206699
2021.12_13-10-2022;Ставропольский край;105_165_days;SputnikLite;42500;19417;61917;1590669;616030;2206699
2021.12_13-10-2022;Ставропольский край;105_165_days;SputnikV;144779;29357;174136;1590669;616030;2206699
2021.12_13-10-2022;Ставропольский край;165_195_days;AllVaccines;134406;30228;164634;1590669;616030;2206699
2021.12_13-10-2022;Ставропольский край;165_195_days;CoviVac;3407;552;3959;1590669;616030;2206699
2021.12_13-10-2022;Ставропольский край;165_195_days;EpiVacCorona;4661;1698;6359;1590669;616030;2206699
2021.12_13-10-2022;Ставропольский край;165_195_days;SputnikLite;1830;312;2142;1590669;616030;2206699
2021.12_13-10-2022;Ставропольский край;165_195_days;SputnikV;124508;27666;152174;1590669;616030;2206699
2021.12_13-10-2022;Ставропольский край;21_45_days;AllVaccines;138772;49465;188237;1590669;616030;2206699
2021.12_13-10-2022;Ставропольский край;21_45_days;CoviVac;714;233;947;1590669;616030;2206699
2021.12_13-10-2022;Ставропольский край;21_45_days;EpiVacCorona;3050;1337;4387;1590669;616030;2206699
2021.12_13-10-2022;Ставропольский край;21_45_days;SputnikLite;35768;17944;53712;1590669;616030;2206699
2021.12_13-10-2022;Ставропольский край;21_45_days;SputnikV;99240;29951;129191;1590669;616030;2206699
2021.12_13-10-2022;Ставропольский край;45_75_days;AllVaccines;134266;50958;185224;1590669;616030;2206699
2021.12_13-10-2022;Ставропольский край;45_75_days;CoviVac;1535;424;1959;1590669;616030;2206699
2021.12_13-10-2022;Ставропольский край;45_75_days;EpiVacCorona;3362;1294;4656;1590669;616030;2206699
2021.12_13-10-2022;Ставропольский край;45_75_days;SputnikLite;32726;18701;51427;1590669;616030;2206699
2021.12_13-10-2022;Ставропольский край;45_75_days;SputnikV;96643;30539;127182;1590669;616030;2206699
2021.12_13-10-2022;Ставропольский край;75_90_days;AllVaccines;38356;19262;57618;1590669;616030;2206699
2021.12_13-10-2022;Ставропольский край;75_90_days;CoviVac;231;74;305;1590669;616030;2206699
2021.12_13-10-2022;Ставропольский край;75_90_days;EpiVacCorona;107;84;191;1590669;616030;2206699
2021.12_13-10-2022;Ставропольский край;75_90_days;SputnikLite;28398;13099;41497;1590669;616030;2206699
2021.12_13-10-2022;Ставропольский край;75_90_days;SputnikV;9620;6005;15625;1590669;616030;2206699
2021.12_13-10-2022;Ставропольский край;90_105_days;AllVaccines;16294;11647;27941;1590669;616030;2206699
2021.12_13-10-2022;Ставропольский край;90_105_days;CoviVac;236;96;332;1590669;616030;2206699
2021.12_13-10-2022;Ставропольский край;90_105_days;EpiVacCorona;176;87;263;1590669;616030;2206699
2021.12_13-10-2022;Ставропольский край;90_105_days;SputnikLite;8759;7060;15819;1590669;616030;2206699
2021.12_13-10-2022;Ставропольский край;90_105_days;SputnikV;7123;4404;11527;1590669;616030;2206699
2021.12_13-10-2022;Тамбовская область;105_165_days;AllVaccines;111264;36748;148012;545785;279936;825721
2021.12_13-10-2022;Тамбовская область;105_165_days;CoviVac;158;21;179;545785;279936;825721
2021.12_13-10-2022;Тамбовская область;105_165_days;EpiVacCorona;1046;861;1907;545785;279936;825721
2021.12_13-10-2022;Тамбовская область;105_165_days;SputnikLite;52624;14912;67536;545785;279936;825721
2021.12_13-10-2022;Тамбовская область;105_165_days;SputnikV;57436;20954;78390;545785;279936;825721
2021.12_13-10-2022;Тамбовская область;165_195_days;AllVaccines;55896;11946;67842;545785;279936;825721
2021.12_13-10-2022;Тамбовская область;165_195_days;CoviVac;590;57;647;545785;279936;825721
2021.12_13-10-2022;Тамбовская область;165_195_days;EpiVacCorona;167;119;286;545785;279936;825721
2021.12_13-10-2022;Тамбовская область;165_195_days;SputnikLite;3915;297;4212;545785;279936;825721
2021.12_13-10-2022;Тамбовская область;165_195_days;SputnikV;51224;11473;62697;545785;279936;825721
2021.12_13-10-2022;Тамбовская область;21_45_days;AllVaccines;31036;21040;52076;545785;279936;825721
2021.12_13-10-2022;Тамбовская область;21_45_days;CoviVac;764;152;916;545785;279936;825721
2021.12_13-10-2022;Тамбовская область;21_45_days;EpiVacCorona;781;512;1293;545785;279936;825721
2021.12_13-10-2022;Тамбовская область;21_45_days;SputnikLite;16275;9219;25494;545785;279936;825721
2021.12_13-10-2022;Тамбовская область;21_45_days;SputnikV;13216;11157;24373;545785;279936;825721
2021.12_13-10-2022;Тамбовская область;45_75_days;AllVaccines;41148;29720;70868;545785;279936;825721
2021.12_13-10-2022;Тамбовская область;45_75_days;CoviVac;1048;231;1279;545785;279936;825721
2021.12_13-10-2022;Тамбовская область;45_75_days;EpiVacCorona;633;358;991;545785;279936;825721
2021.12_13-10-2022;Тамбовская область;45_75_days;SputnikLite;22834;13935;36769;545785;279936;825721
2021.12_13-10-2022;Тамбовская область;45_75_days;SputnikV;16633;15196;31829;545785;279936;825721
2021.12_13-10-2022;Тамбовская область;75_90_days;AllVaccines;20273;10394;30667;545785;279936;825721
2021.12_13-10-2022;Тамбовская область;75_90_days;CoviVac;58;5;63;545785;279936;825721
2021.12_13-10-2022;Тамбовская область;75_90_days;EpiVacCorona;73;154;227;545785;279936;825721
2021.12_13-10-2022;Тамбовская область;75_90_days;SputnikLite;16745;7350;24095;545785;279936;825721
2021.12_13-10-2022;Тамбовская область;75_90_days;SputnikV;3397;2885;6282;545785;279936;825721
2021.12_13-10-2022;Тамбовская область;90_105_days;AllVaccines;10343;6915;17258;545785;279936;825721
2021.12_13-10-2022;Тамбовская область;90_105_days;CoviVac;4;1;5;545785;279936;825721
2021.12_13-10-2022;Тамбовская область;90_105_days;EpiVacCorona;15;44;59;545785;279936;825721
2021.12_13-10-2022;Тамбовская область;90_105_days;SputnikLite;7901;4270;12171;545785;279936;825721
2021.12_13-10-2022;Тамбовская область;90_105_days;SputnikV;2423;2600;5023;545785;279936;825721
2021.12_13-10-2022;Тверская область;105_165_days;AllVaccines;104815;37329;142144;681519;330234;1011753
2021.12_13-10-2022;Тверская область;105_165_days;CoviVac;1485;248;1733;681519;330234;1011753
2021.12_13-10-2022;Тверская область;105_165_days;EpiVacCorona;2359;871;3230;681519;330234;1011753
2021.12_13-10-2022;Тверская область;105_165_days;SputnikLite;12835;9913;22748;681519;330234;1011753
2021.12_13-10-2022;Тверская область;105_165_days;SputnikV;88136;26297;114433;681519;330234;1011753
2021.12_13-10-2022;Тверская область;165_195_days;AllVaccines;77915;19363;97278;681519;330234;1011753
2021.12_13-10-2022;Тверская область;165_195_days;CoviVac;1018;211;1229;681519;330234;1011753
2021.12_13-10-2022;Тверская область;165_195_days;EpiVacCorona;496;176;672;681519;330234;1011753
2021.12_13-10-2022;Тверская область;165_195_days;SputnikLite;262;53;315;681519;330234;1011753
2021.12_13-10-2022;Тверская область;165_195_days;SputnikV;76139;18923;95062;681519;330234;1011753
2021.12_13-10-2022;Тверская область;21_45_days;AllVaccines;36519;25036;61555;681519;330234;1011753
2021.12_13-10-2022;Тверская область;21_45_days;CoviVac;958;265;1223;681519;330234;1011753
2021.12_13-10-2022;Тверская область;21_45_days;EpiVacCorona;2593;1774;4367;681519;330234;1011753
2021.12_13-10-2022;Тверская область;21_45_days;SputnikLite;10681;10150;20831;681519;330234;1011753
2021.12_13-10-2022;Тверская область;21_45_days;SputnikV;22287;12847;35134;681519;330234;1011753
2021.12_13-10-2022;Тверская область;45_75_days;AllVaccines;51971;32100;84071;681519;330234;1011753
2021.12_13-10-2022;Тверская область;45_75_days;CoviVac;845;220;1065;681519;330234;1011753
2021.12_13-10-2022;Тверская область;45_75_days;EpiVacCorona;2611;1140;3751;681519;330234;1011753
2021.12_13-10-2022;Тверская область;45_75_days;SputnikLite;17275;16509;33784;681519;330234;1011753
2021.12_13-10-2022;Тверская область;45_75_days;SputnikV;31240;14231;45471;681519;330234;1011753
2021.12_13-10-2022;Тверская область;75_90_days;AllVaccines;18169;12811;30980;681519;330234;1011753
2021.12_13-10-2022;Тверская область;75_90_days;CoviVac;76;24;100;681519;330234;1011753
2021.12_13-10-2022;Тверская область;75_90_days;EpiVacCorona;166;110;276;681519;330234;1011753
2021.12_13-10-2022;Тверская область;75_90_days;SputnikLite;13772;10148;23920;681519;330234;1011753
2021.12_13-10-2022;Тверская область;75_90_days;SputnikV;4155;2529;6684;681519;330234;1011753
2021.12_13-10-2022;Тверская область;90_105_days;AllVaccines;8337;7944;16281;681519;330234;1011753
2021.12_13-10-2022;Тверская область;90_105_days;CoviVac;106;27;133;681519;330234;1011753
2021.12_13-10-2022;Тверская область;90_105_days;EpiVacCorona;114;53;167;681519;330234;1011753
2021.12_13-10-2022;Тверская область;90_105_days;SputnikLite;4498;5837;10335;681519;330234;1011753
2021.12_13-10-2022;Тверская область;90_105_days;SputnikV;3619;2027;5646;681519;330234;1011753
2021.12_13-10-2022;Томская область;105_165_days;AllVaccines;63313;19965;83278;621613;222482;844095
2021.12_13-10-2022;Томская область;105_165_days;CoviVac;552;44;596;621613;222482;844095
2021.12_13-10-2022;Томская область;105_165_days;EpiVacCorona;1363;356;1719;621613;222482;844095
2021.12_13-10-2022;Томская область;105_165_days;SputnikLite;11639;5922;17561;621613;222482;844095
2021.12_13-10-2022;Томская область;105_165_days;SputnikV;49759;13643;63402;621613;222482;844095
2021.12_13-10-2022;Томская область;165_195_days;AllVaccines;55595;17899;73494;621613;222482;844095
2021.12_13-10-2022;Томская область;165_195_days;CoviVac;411;70;481;621613;222482;844095
2021.12_13-10-2022;Томская область;165_195_days;EpiVacCorona;2926;1113;4039;621613;222482;844095
2021.12_13-10-2022;Томская область;165_195_days;SputnikLite;330;38;368;621613;222482;844095
2021.12_13-10-2022;Томская область;165_195_days;SputnikV;51928;16678;68606;621613;222482;844095
2021.12_13-10-2022;Томская область;21_45_days;AllVaccines;64757;22648;87405;621613;222482;844095
2021.12_13-10-2022;Томская область;21_45_days;CoviVac;1404;199;1603;621613;222482;844095
2021.12_13-10-2022;Томская область;21_45_days;EpiVacCorona;732;261;993;621613;222482;844095
2021.12_13-10-2022;Томская область;21_45_days;SputnikLite;15020;10612;25632;621613;222482;844095
2021.12_13-10-2022;Томская область;21_45_days;SputnikV;47601;11576;59177;621613;222482;844095
2021.12_13-10-2022;Томская область;45_75_days;AllVaccines;66726;22686;89412;621613;222482;844095
2021.12_13-10-2022;Томская область;45_75_days;CoviVac;1783;229;2012;621613;222482;844095
2021.12_13-10-2022;Томская область;45_75_days;EpiVacCorona;948;259;1207;621613;222482;844095
2021.12_13-10-2022;Томская область;45_75_days;SputnikLite;23085;13251;36336;621613;222482;844095
2021.12_13-10-2022;Томская область;45_75_days;SputnikV;40910;8947;49857;621613;222482;844095
2021.12_13-10-2022;Томская область;75_90_days;AllVaccines;18858;8692;27550;621613;222482;844095
2021.12_13-10-2022;Томская область;75_90_days;CoviVac;29;4;33;621613;222482;844095
2021.12_13-10-2022;Томская область;75_90_days;EpiVacCorona;71;22;93;621613;222482;844095
2021.12_13-10-2022;Томская область;75_90_days;SputnikLite;15656;7336;22992;621613;222482;844095
2021.12_13-10-2022;Томская область;75_90_days;SputnikV;3102;1330;4432;621613;222482;844095
2021.12_13-10-2022;Томская область;90_105_days;AllVaccines;6551;4371;10922;621613;222482;844095
2021.12_13-10-2022;Томская область;90_105_days;CoviVac;17;4;21;621613;222482;844095
2021.12_13-10-2022;Томская область;90_105_days;EpiVacCorona;46;19;65;621613;222482;844095
2021.12_13-10-2022;Томская область;90_105_days;SputnikLite;3413;3285;6698;621613;222482;844095
2021.12_13-10-2022;Томская область;90_105_days;SputnikV;3075;1063;4138;621613;222482;844095
2021.12_13-10-2022;Тульская область;105_165_days;AllVaccines;136326;37800;174126;804510;401385;1205895
2021.12_13-10-2022;Тульская область;105_165_days;CoviVac;636;110;746;804510;401385;1205895
2021.12_13-10-2022;Тульская область;105_165_days;EpiVacCorona;1408;739;2147;804510;401385;1205895
2021.12_13-10-2022;Тульская область;105_165_days;SputnikLite;16347;6504;22851;804510;401385;1205895
2021.12_13-10-2022;Тульская область;105_165_days;SputnikV;117935;30447;148382;804510;401385;1205895
2021.12_13-10-2022;Тульская область;165_195_days;AllVaccines;158895;31670;190565;804510;401385;1205895
2021.12_13-10-2022;Тульская область;165_195_days;CoviVac;709;110;819;804510;401385;1205895
2021.12_13-10-2022;Тульская область;165_195_days;EpiVacCorona;1107;494;1601;804510;401385;1205895
2021.12_13-10-2022;Тульская область;165_195_days;SputnikLite;58;4;62;804510;401385;1205895
2021.12_13-10-2022;Тульская область;165_195_days;SputnikV;157021;31062;188083;804510;401385;1205895
2021.12_13-10-2022;Тульская область;21_45_days;AllVaccines;53278;31269;84547;804510;401385;1205895
2021.12_13-10-2022;Тульская область;21_45_days;CoviVac;439;172;611;804510;401385;1205895
2021.12_13-10-2022;Тульская область;21_45_days;EpiVacCorona;2121;1383;3504;804510;401385;1205895
2021.12_13-10-2022;Тульская область;21_45_days;SputnikLite;13575;11246;24821;804510;401385;1205895
2021.12_13-10-2022;Тульская область;21_45_days;SputnikV;37143;18468;55611;804510;401385;1205895
2021.12_13-10-2022;Тульская область;45_75_days;AllVaccines;57942;37917;95859;804510;401385;1205895
2021.12_13-10-2022;Тульская область;45_75_days;CoviVac;1224;440;1664;804510;401385;1205895
2021.12_13-10-2022;Тульская область;45_75_days;EpiVacCorona;2790;2758;5548;804510;401385;1205895
2021.12_13-10-2022;Тульская область;45_75_days;SputnikLite;28917;17991;46908;804510;401385;1205895
2021.12_13-10-2022;Тульская область;45_75_days;SputnikV;25011;16728;41739;804510;401385;1205895
2021.12_13-10-2022;Тульская область;75_90_days;AllVaccines;19270;12609;31879;804510;401385;1205895
2021.12_13-10-2022;Тульская область;75_90_days;CoviVac;169;70;239;804510;401385;1205895
2021.12_13-10-2022;Тульская область;75_90_days;EpiVacCorona;255;242;497;804510;401385;1205895
2021.12_13-10-2022;Тульская область;75_90_days;SputnikLite;14125;8991;23116;804510;401385;1205895
2021.12_13-10-2022;Тульская область;75_90_days;SputnikV;4721;3306;8027;804510;401385;1205895
2021.12_13-10-2022;Тульская область;90_105_days;AllVaccines;9368;6948;16316;804510;401385;1205895
2021.12_13-10-2022;Тульская область;90_105_days;CoviVac;165;66;231;804510;401385;1205895
2021.12_13-10-2022;Тульская область;90_105_days;EpiVacCorona;189;156;345;804510;401385;1205895
2021.12_13-10-2022;Тульская область;90_105_days;SputnikLite;5031;4178;9209;804510;401385;1205895
2021.12_13-10-2022;Тульская область;90_105_days;SputnikV;3983;2548;6531;804510;401385;1205895
2021.12_13-10-2022;Тюменская область;105_165_days;AllVaccines;142573;36089;178662;870789;301209;1171998
2021.12_13-10-2022;Тюменская область;105_165_days;CoviVac;472;95;567;870789;301209;1171998
2021.12_13-10-2022;Тюменская область;105_165_days;EpiVacCorona;1804;631;2435;870789;301209;1171998
2021.12_13-10-2022;Тюменская область;105_165_days;SputnikLite;44765;13300;58065;870789;301209;1171998
2021.12_13-10-2022;Тюменская область;105_165_days;SputnikV;95532;22063;117595;870789;301209;1171998
2021.12_13-10-2022;Тюменская область;165_195_days;AllVaccines;117018;27719;144737;870789;301209;1171998
2021.12_13-10-2022;Тюменская область;165_195_days;CoviVac;188;45;233;870789;301209;1171998
2021.12_13-10-2022;Тюменская область;165_195_days;EpiVacCorona;10247;3196;13443;870789;301209;1171998
2021.12_13-10-2022;Тюменская область;165_195_days;SputnikLite;2993;533;3526;870789;301209;1171998
2021.12_13-10-2022;Тюменская область;165_195_days;SputnikV;103590;23945;127535;870789;301209;1171998
2021.12_13-10-2022;Тюменская область;21_45_days;AllVaccines;103894;41273;145167;870789;301209;1171998
2021.12_13-10-2022;Тюменская область;21_45_days;CoviVac;381;93;474;870789;301209;1171998
2021.12_13-10-2022;Тюменская область;21_45_days;EpiVacCorona;419;157;576;870789;301209;1171998
2021.12_13-10-2022;Тюменская область;21_45_days;SputnikLite;28834;20016;48850;870789;301209;1171998
2021.12_13-10-2022;Тюменская область;21_45_days;SputnikV;74260;21007;95267;870789;301209;1171998
2021.12_13-10-2022;Тюменская область;45_75_days;AllVaccines;87425;31963;119388;870789;301209;1171998
2021.12_13-10-2022;Тюменская область;45_75_days;CoviVac;1167;201;1368;870789;301209;1171998
2021.12_13-10-2022;Тюменская область;45_75_days;EpiVacCorona;1058;267;1325;870789;301209;1171998
2021.12_13-10-2022;Тюменская область;45_75_days;SputnikLite;28197;17244;45441;870789;301209;1171998
2021.12_13-10-2022;Тюменская область;45_75_days;SputnikV;57003;14251;71254;870789;301209;1171998
2021.12_13-10-2022;Тюменская область;75_90_days;AllVaccines;50690;13485;64175;870789;301209;1171998
2021.12_13-10-2022;Тюменская область;75_90_days;CoviVac;64;13;77;870789;301209;1171998
2021.12_13-10-2022;Тюменская область;75_90_days;EpiVacCorona;108;88;196;870789;301209;1171998
2021.12_13-10-2022;Тюменская область;75_90_days;SputnikLite;44142;11485;55627;870789;301209;1171998
2021.12_13-10-2022;Тюменская область;75_90_days;SputnikV;6376;1899;8275;870789;301209;1171998
2021.12_13-10-2022;Тюменская область;90_105_days;AllVaccines;14213;6921;21134;870789;301209;1171998
2021.12_13-10-2022;Тюменская область;90_105_days;CoviVac;39;10;49;870789;301209;1171998
2021.12_13-10-2022;Тюменская область;90_105_days;EpiVacCorona;95;46;141;870789;301209;1171998
2021.12_13-10-2022;Тюменская область;90_105_days;SputnikLite;9314;5317;14631;870789;301209;1171998
2021.12_13-10-2022;Тюменская область;90_105_days;SputnikV;4765;1548;6313;870789;301209;1171998
2021.12_13-10-2022;Удмуртская Республика;105_165_days;AllVaccines;114732;34743;149475;818861;336450;1155311
2021.12_13-10-2022;Удмуртская Республика;105_165_days;CoviVac;590;71;661;818861;336450;1155311
2021.12_13-10-2022;Удмуртская Республика;105_165_days;EpiVacCorona;6404;3872;10276;818861;336450;1155311
2021.12_13-10-2022;Удмуртская Республика;105_165_days;SputnikLite;38036;10130;48166;818861;336450;1155311
2021.12_13-10-2022;Удмуртская Республика;105_165_days;SputnikV;69702;20670;90372;818861;336450;1155311
2021.12_13-10-2022;Удмуртская Республика;165_195_days;AllVaccines;73511;25826;99337;818861;336450;1155311
2021.12_13-10-2022;Удмуртская Республика;165_195_days;CoviVac;96;11;107;818861;336450;1155311
2021.12_13-10-2022;Удмуртская Республика;165_195_days;EpiVacCorona;2257;1279;3536;818861;336450;1155311
2021.12_13-10-2022;Удмуртская Республика;165_195_days;SputnikLite;209;3;212;818861;336450;1155311
2021.12_13-10-2022;Удмуртская Республика;165_195_days;SputnikV;70949;24533;95482;818861;336450;1155311
2021.12_13-10-2022;Удмуртская Республика;21_45_days;AllVaccines;62327;30430;92757;818861;336450;1155311
2021.12_13-10-2022;Удмуртская Республика;21_45_days;CoviVac;1797;269;2066;818861;336450;1155311
2021.12_13-10-2022;Удмуртская Республика;21_45_days;EpiVacCorona;2273;1210;3483;818861;336450;1155311
2021.12_13-10-2022;Удмуртская Республика;21_45_days;SputnikLite;10871;11374;22245;818861;336450;1155311
2021.12_13-10-2022;Удмуртская Республика;21_45_days;SputnikV;47386;17577;64963;818861;336450;1155311
2021.12_13-10-2022;Удмуртская Республика;45_75_days;AllVaccines;100626;37186;137812;818861;336450;1155311
2021.12_13-10-2022;Удмуртская Республика;45_75_days;CoviVac;1469;210;1679;818861;336450;1155311
2021.12_13-10-2022;Удмуртская Республика;45_75_days;EpiVacCorona;5596;2617;8213;818861;336450;1155311
2021.12_13-10-2022;Удмуртская Республика;45_75_days;SputnikLite;13294;11470;24764;818861;336450;1155311
2021.12_13-10-2022;Удмуртская Республика;45_75_days;SputnikV;80267;22889;103156;818861;336450;1155311
2021.12_13-10-2022;Удмуртская Республика;75_90_days;AllVaccines;40293;12160;52453;818861;336450;1155311
2021.12_13-10-2022;Удмуртская Республика;75_90_days;CoviVac;33;3;36;818861;336450;1155311
2021.12_13-10-2022;Удмуртская Республика;75_90_days;EpiVacCorona;1304;837;2141;818861;336450;1155311
2021.12_13-10-2022;Удмуртская Республика;75_90_days;SputnikLite;30584;7545;38129;818861;336450;1155311
2021.12_13-10-2022;Удмуртская Республика;75_90_days;SputnikV;8372;3775;12147;818861;336450;1155311
2021.12_13-10-2022;Удмуртская Республика;90_105_days;AllVaccines;23981;8287;32268;818861;336450;1155311
2021.12_13-10-2022;Удмуртская Республика;90_105_days;CoviVac;15;1;16;818861;336450;1155311
2021.12_13-10-2022;Удмуртская Республика;90_105_days;EpiVacCorona;681;514;1195;818861;336450;1155311
2021.12_13-10-2022;Удмуртская Республика;90_105_days;SputnikLite;18626;5745;24371;818861;336450;1155311
2021.12_13-10-2022;Удмуртская Республика;90_105_days;SputnikV;4659;2027;6686;818861;336450;1155311
2021.12_13-10-2022;Ульяновская область;105_165_days;AllVaccines;99723;27366;127089;672149;320065;992214
2021.12_13-10-2022;Ульяновская область;105_165_days;CoviVac;310;44;354;672149;320065;992214
2021.12_13-10-2022;Ульяновская область;105_165_days;EpiVacCorona;2117;545;2662;672149;320065;992214
2021.12_13-10-2022;Ульяновская область;105_165_days;SputnikLite;25231;9970;35201;672149;320065;992214
2021.12_13-10-2022;Ульяновская область;105_165_days;SputnikV;72065;16807;88872;672149;320065;992214
2021.12_13-10-2022;Ульяновская область;165_195_days;AllVaccines;60357;13847;74204;672149;320065;992214
2021.12_13-10-2022;Ульяновская область;165_195_days;CoviVac;540;77;617;672149;320065;992214
2021.12_13-10-2022;Ульяновская область;165_195_days;EpiVacCorona;3571;758;4329;672149;320065;992214
2021.12_13-10-2022;Ульяновская область;165_195_days;SputnikLite;188;30;218;672149;320065;992214
2021.12_13-10-2022;Ульяновская область;165_195_days;SputnikV;56058;12982;69040;672149;320065;992214
2021.12_13-10-2022;Ульяновская область;21_45_days;AllVaccines;57264;31097;88361;672149;320065;992214
2021.12_13-10-2022;Ульяновская область;21_45_days;CoviVac;783;164;947;672149;320065;992214
2021.12_13-10-2022;Ульяновская область;21_45_days;EpiVacCorona;1766;845;2611;672149;320065;992214
2021.12_13-10-2022;Ульяновская область;21_45_days;SputnikLite;12218;11988;24206;672149;320065;992214
2021.12_13-10-2022;Ульяновская область;21_45_days;SputnikV;42497;18100;60597;672149;320065;992214
2021.12_13-10-2022;Ульяновская область;45_75_days;AllVaccines;65022;32321;97343;672149;320065;992214
2021.12_13-10-2022;Ульяновская область;45_75_days;CoviVac;1511;358;1869;672149;320065;992214
2021.12_13-10-2022;Ульяновская область;45_75_days;EpiVacCorona;1609;569;2178;672149;320065;992214
2021.12_13-10-2022;Ульяновская область;45_75_days;SputnikLite;14643;14146;28789;672149;320065;992214
2021.12_13-10-2022;Ульяновская область;45_75_days;SputnikV;47259;17248;64507;672149;320065;992214
2021.12_13-10-2022;Ульяновская область;75_90_days;AllVaccines;23397;13454;36851;672149;320065;992214
2021.12_13-10-2022;Ульяновская область;75_90_days;CoviVac;6;1;7;672149;320065;992214
2021.12_13-10-2022;Ульяновская область;75_90_days;EpiVacCorona;229;73;302;672149;320065;992214
2021.12_13-10-2022;Ульяновская область;75_90_days;SputnikLite;16354;10918;27272;672149;320065;992214
2021.12_13-10-2022;Ульяновская область;75_90_days;SputnikV;6808;2462;9270;672149;320065;992214
2021.12_13-10-2022;Ульяновская область;90_105_days;AllVaccines;12322;7091;19413;672149;320065;992214
2021.12_13-10-2022;Ульяновская область;90_105_days;CoviVac;7;2;9;672149;320065;992214
2021.12_13-10-2022;Ульяновская область;90_105_days;EpiVacCorona;44;16;60;672149;320065;992214
2021.12_13-10-2022;Ульяновская область;90_105_days;SputnikLite;7188;5281;12469;672149;320065;992214
2021.12_13-10-2022;Ульяновская область;90_105_days;SputnikV;5083;1792;6875;672149;320065;992214
2021.12_13-10-2022;Хабаровский край;105_165_days;AllVaccines;100588;23587;124175;757169;265178;1022347
2021.12_13-10-2022;Хабаровский край;105_165_days;CoviVac;377;31;408;757169;265178;1022347
2021.12_13-10-2022;Хабаровский край;105_165_days;EpiVacCorona;31;43;74;757169;265178;1022347
2021.12_13-10-2022;Хабаровский край;105_165_days;SputnikLite;25838;6700;32538;757169;265178;1022347
2021.12_13-10-2022;Хабаровский край;105_165_days;SputnikV;74342;16813;91155;757169;265178;1022347
2021.12_13-10-2022;Хабаровский край;165_195_days;AllVaccines;58404;16474;74878;757169;265178;1022347
2021.12_13-10-2022;Хабаровский край;165_195_days;CoviVac;361;80;441;757169;265178;1022347
2021.12_13-10-2022;Хабаровский край;165_195_days;EpiVacCorona;292;120;412;757169;265178;1022347
2021.12_13-10-2022;Хабаровский край;165_195_days;SputnikLite;299;52;351;757169;265178;1022347
2021.12_13-10-2022;Хабаровский край;165_195_days;SputnikV;57452;16222;73674;757169;265178;1022347
2021.12_13-10-2022;Хабаровский край;21_45_days;AllVaccines;64065;22727;86792;757169;265178;1022347
2021.12_13-10-2022;Хабаровский край;21_45_days;CoviVac;1192;241;1433;757169;265178;1022347
2021.12_13-10-2022;Хабаровский край;21_45_days;EpiVacCorona;3773;1204;4977;757169;265178;1022347
2021.12_13-10-2022;Хабаровский край;21_45_days;SputnikLite;18533;8687;27220;757169;265178;1022347
2021.12_13-10-2022;Хабаровский край;21_45_days;SputnikV;40567;12595;53162;757169;265178;1022347
2021.12_13-10-2022;Хабаровский край;45_75_days;AllVaccines;51270;19412;70682;757169;265178;1022347
2021.12_13-10-2022;Хабаровский край;45_75_days;CoviVac;1181;252;1433;757169;265178;1022347
2021.12_13-10-2022;Хабаровский край;45_75_days;EpiVacCorona;1237;336;1573;757169;265178;1022347
2021.12_13-10-2022;Хабаровский край;45_75_days;SputnikLite;28316;10894;39210;757169;265178;1022347
2021.12_13-10-2022;Хабаровский край;45_75_days;SputnikV;20536;7930;28466;757169;265178;1022347
2021.12_13-10-2022;Хабаровский край;75_90_days;AllVaccines;14356;7129;21485;757169;265178;1022347
2021.12_13-10-2022;Хабаровский край;75_90_days;CoviVac;13;5;18;757169;265178;1022347
2021.12_13-10-2022;Хабаровский край;75_90_days;EpiVacCorona;1;0;1;757169;265178;1022347
2021.12_13-10-2022;Хабаровский край;75_90_days;SputnikLite;9922;5587;15509;757169;265178;1022347
2021.12_13-10-2022;Хабаровский край;75_90_days;SputnikV;4420;1537;5957;757169;265178;1022347
2021.12_13-10-2022;Хабаровский край;90_105_days;AllVaccines;7867;3969;11836;757169;265178;1022347
2021.12_13-10-2022;Хабаровский край;90_105_days;CoviVac;2;1;3;757169;265178;1022347
2021.12_13-10-2022;Хабаровский край;90_105_days;SputnikLite;4323;2499;6822;757169;265178;1022347
2021.12_13-10-2022;Хабаровский край;90_105_days;SputnikV;3542;1469;5011;757169;265178;1022347
2021.12_13-10-2022;Ханты-Мансийский автономный округ - Югра;105_165_days;AllVaccines;132398;18151;150549;1019471;240107;1259578
2021.12_13-10-2022;Ханты-Мансийский автономный округ - Югра;105_165_days;CoviVac;561;91;652;1019471;240107;1259578
2021.12_13-10-2022;Ханты-Мансийский автономный округ - Югра;105_165_days;EpiVacCorona;1625;342;1967;1019471;240107;1259578
2021.12_13-10-2022;Ханты-Мансийский автономный округ - Югра;105_165_days;SputnikLite;31788;5430;37218;1019471;240107;1259578
2021.12_13-10-2022;Ханты-Мансийский автономный округ - Югра;105_165_days;SputnikV;98424;12288;110712;1019471;240107;1259578
2021.12_13-10-2022;Ханты-Мансийский автономный округ - Югра;165_195_days;AllVaccines;112654;14812;127466;1019471;240107;1259578
2021.12_13-10-2022;Ханты-Мансийский автономный округ - Югра;165_195_days;CoviVac;354;49;403;1019471;240107;1259578
2021.12_13-10-2022;Ханты-Мансийский автономный округ - Югра;165_195_days;EpiVacCorona;5161;859;6020;1019471;240107;1259578
2021.12_13-10-2022;Ханты-Мансийский автономный округ - Югра;165_195_days;SputnikLite;287;37;324;1019471;240107;1259578
2021.12_13-10-2022;Ханты-Мансийский автономный округ - Югра;165_195_days;SputnikV;106852;13867;120719;1019471;240107;1259578
2021.12_13-10-2022;Ханты-Мансийский автономный округ - Югра;21_45_days;AllVaccines;86921;22642;109563;1019471;240107;1259578
2021.12_13-10-2022;Ханты-Мансийский автономный округ - Югра;21_45_days;CoviVac;306;57;363;1019471;240107;1259578
2021.12_13-10-2022;Ханты-Мансийский автономный округ - Югра;21_45_days;EpiVacCorona;1176;494;1670;1019471;240107;1259578
2021.12_13-10-2022;Ханты-Мансийский автономный округ - Югра;21_45_days;SputnikLite;31945;9971;41916;1019471;240107;1259578
2021.12_13-10-2022;Ханты-Мансийский автономный округ - Югра;21_45_days;SputnikV;53494;12120;65614;1019471;240107;1259578
2021.12_13-10-2022;Ханты-Мансийский автономный округ - Югра;45_75_days;AllVaccines;131269;27587;158856;1019471;240107;1259578
2021.12_13-10-2022;Ханты-Мансийский автономный округ - Югра;45_75_days;CoviVac;1189;208;1397;1019471;240107;1259578
2021.12_13-10-2022;Ханты-Мансийский автономный округ - Югра;45_75_days;EpiVacCorona;1439;398;1837;1019471;240107;1259578
2021.12_13-10-2022;Ханты-Мансийский автономный округ - Югра;45_75_days;SputnikLite;29450;11121;40571;1019471;240107;1259578
2021.12_13-10-2022;Ханты-Мансийский автономный округ - Югра;45_75_days;SputnikV;99191;15860;115051;1019471;240107;1259578
2021.12_13-10-2022;Ханты-Мансийский автономный округ - Югра;75_90_days;AllVaccines;36670;7990;44660;1019471;240107;1259578
2021.12_13-10-2022;Ханты-Мансийский автономный округ - Югра;75_90_days;CoviVac;202;44;246;1019471;240107;1259578
2021.12_13-10-2022;Ханты-Мансийский автономный округ - Югра;75_90_days;EpiVacCorona;80;8;88;1019471;240107;1259578
2021.12_13-10-2022;Ханты-Мансийский автономный округ - Югра;75_90_days;SputnikLite;27988;6218;34206;1019471;240107;1259578
2021.12_13-10-2022;Ханты-Мансийский автономный округ - Югра;75_90_days;SputnikV;8400;1720;10120;1019471;240107;1259578
2021.12_13-10-2022;Ханты-Мансийский автономный округ - Югра;90_105_days;AllVaccines;23743;5013;28756;1019471;240107;1259578
2021.12_13-10-2022;Ханты-Мансийский автономный округ - Югра;90_105_days;CoviVac;176;29;205;1019471;240107;1259578
2021.12_13-10-2022;Ханты-Мансийский автономный округ - Югра;90_105_days;EpiVacCorona;80;21;101;1019471;240107;1259578
2021.12_13-10-2022;Ханты-Мансийский автономный округ - Югра;90_105_days;SputnikLite;15900;3729;19629;1019471;240107;1259578
2021.12_13-10-2022;Ханты-Мансийский автономный округ - Югра;90_105_days;SputnikV;7587;1234;8821;1019471;240107;1259578
2021.12_13-10-2022;Челябинская область;105_165_days;AllVaccines;243994;67410;311404;1901705;795956;2697661
2021.12_13-10-2022;Челябинская область;105_165_days;CoviVac;3545;776;4321;1901705;795956;2697661
2021.12_13-10-2022;Челябинская область;105_165_days;EpiVacCorona;6162;2888;9050;1901705;795956;2697661
2021.12_13-10-2022;Челябинская область;105_165_days;SputnikLite;75007;19933;94940;1901705;795956;2697661
2021.12_13-10-2022;Челябинская область;105_165_days;SputnikV;159280;43813;203093;1901705;795956;2697661
2021.12_13-10-2022;Челябинская область;165_195_days;AllVaccines;156114;44898;201012;1901705;795956;2697661
2021.12_13-10-2022;Челябинская область;165_195_days;CoviVac;1384;280;1664;1901705;795956;2697661
2021.12_13-10-2022;Челябинская область;165_195_days;EpiVacCorona;3442;762;4204;1901705;795956;2697661
2021.12_13-10-2022;Челябинская область;165_195_days;SputnikLite;3655;299;3954;1901705;795956;2697661
2021.12_13-10-2022;Челябинская область;165_195_days;SputnikV;147633;43557;191190;1901705;795956;2697661
2021.12_13-10-2022;Челябинская область;21_45_days;AllVaccines;179953;82275;262228;1901705;795956;2697661
2021.12_13-10-2022;Челябинская область;21_45_days;CoviVac;1032;305;1337;1901705;795956;2697661
2021.12_13-10-2022;Челябинская область;21_45_days;EpiVacCorona;5031;2537;7568;1901705;795956;2697661
2021.12_13-10-2022;Челябинская область;21_45_days;SputnikLite;47232;27141;74373;1901705;795956;2697661
2021.12_13-10-2022;Челябинская область;21_45_days;SputnikV;126658;52292;178950;1901705;795956;2697661
2021.12_13-10-2022;Челябинская область;45_75_days;AllVaccines;284875;98370;383245;1901705;795956;2697661
2021.12_13-10-2022;Челябинская область;45_75_days;CoviVac;3217;577;3794;1901705;795956;2697661
2021.12_13-10-2022;Челябинская область;45_75_days;EpiVacCorona;10024;3520;13544;1901705;795956;2697661
2021.12_13-10-2022;Челябинская область;45_75_days;SputnikLite;44079;23240;67319;1901705;795956;2697661
2021.12_13-10-2022;Челябинская область;45_75_days;SputnikV;227555;71033;298588;1901705;795956;2697661
2021.12_13-10-2022;Челябинская область;75_90_days;AllVaccines;70286;23044;93330;1901705;795956;2697661
2021.12_13-10-2022;Челябинская область;75_90_days;CoviVac;1069;293;1362;1901705;795956;2697661
2021.12_13-10-2022;Челябинская область;75_90_days;EpiVacCorona;450;219;669;1901705;795956;2697661
2021.12_13-10-2022;Челябинская область;75_90_days;SputnikLite;47391;13645;61036;1901705;795956;2697661
2021.12_13-10-2022;Челябинская область;75_90_days;SputnikV;21376;8887;30263;1901705;795956;2697661
2021.12_13-10-2022;Челябинская область;90_105_days;AllVaccines;42913;16670;59583;1901705;795956;2697661
2021.12_13-10-2022;Челябинская область;90_105_days;CoviVac;630;246;876;1901705;795956;2697661
2021.12_13-10-2022;Челябинская область;90_105_days;EpiVacCorona;251;165;416;1901705;795956;2697661
2021.12_13-10-2022;Челябинская область;90_105_days;SputnikLite;27966;10339;38305;1901705;795956;2697661
2021.12_13-10-2022;Челябинская область;90_105_days;SputnikV;14066;5920;19986;1901705;795956;2697661
2021.12_13-10-2022;Чеченская Республика;105_165_days;AllVaccines;158256;37919;196175;809759;137234;946993
2021.12_13-10-2022;Чеченская Республика;105_165_days;CoviVac;418;135;553;809759;137234;946993
2021.12_13-10-2022;Чеченская Республика;105_165_days;EpiVacCorona;453;111;564;809759;137234;946993
2021.12_13-10-2022;Чеченская Республика;105_165_days;SputnikLite;1988;394;2382;809759;137234;946993
2021.12_13-10-2022;Чеченская Республика;105_165_days;SputnikV;155397;37279;192676;809759;137234;946993
2021.12_13-10-2022;Чеченская Республика;165_195_days;AllVaccines;205044;32995;238039;809759;137234;946993
2021.12_13-10-2022;Чеченская Республика;165_195_days;CoviVac;1664;323;1987;809759;137234;946993
2021.12_13-10-2022;Чеченская Республика;165_195_days;EpiVacCorona;3929;612;4541;809759;137234;946993
2021.12_13-10-2022;Чеченская Республика;165_195_days;SputnikLite;9;2;11;809759;137234;946993
2021.12_13-10-2022;Чеченская Республика;165_195_days;SputnikV;199442;32058;231500;809759;137234;946993
2021.12_13-10-2022;Чеченская Республика;21_45_days;AllVaccines;19515;2225;21740;809759;137234;946993
2021.12_13-10-2022;Чеченская Республика;21_45_days;CoviVac;117;22;139;809759;137234;946993
2021.12_13-10-2022;Чеченская Республика;21_45_days;EpiVacCorona;1815;290;2105;809759;137234;946993
2021.12_13-10-2022;Чеченская Республика;21_45_days;SputnikLite;11429;1012;12441;809759;137234;946993
2021.12_13-10-2022;Чеченская Республика;21_45_days;SputnikV;6154;901;7055;809759;137234;946993
2021.12_13-10-2022;Чеченская Республика;45_75_days;AllVaccines;18792;3083;21875;809759;137234;946993
2021.12_13-10-2022;Чеченская Республика;45_75_days;CoviVac;364;67;431;809759;137234;946993
2021.12_13-10-2022;Чеченская Республика;45_75_days;EpiVacCorona;1944;313;2257;809759;137234;946993
2021.12_13-10-2022;Чеченская Республика;45_75_days;SputnikLite;2953;192;3145;809759;137234;946993
2021.12_13-10-2022;Чеченская Республика;45_75_days;SputnikV;13531;2511;16042;809759;137234;946993
2021.12_13-10-2022;Чеченская Республика;75_90_days;AllVaccines;18479;3213;21692;809759;137234;946993
2021.12_13-10-2022;Чеченская Республика;75_90_days;CoviVac;248;57;305;809759;137234;946993
2021.12_13-10-2022;Чеченская Республика;75_90_days;EpiVacCorona;736;163;899;809759;137234;946993
2021.12_13-10-2022;Чеченская Республика;75_90_days;SputnikLite;4955;377;5332;809759;137234;946993
2021.12_13-10-2022;Чеченская Республика;75_90_days;SputnikV;12540;2616;15156;809759;137234;946993
2021.12_13-10-2022;Чеченская Республика;90_105_days;AllVaccines;15241;3473;18714;809759;137234;946993
2021.12_13-10-2022;Чеченская Республика;90_105_days;CoviVac;222;51;273;809759;137234;946993
2021.12_13-10-2022;Чеченская Республика;90_105_days;EpiVacCorona;194;52;246;809759;137234;946993
2021.12_13-10-2022;Чеченская Республика;90_105_days;SputnikLite;3023;393;3416;809759;137234;946993
2021.12_13-10-2022;Чеченская Республика;90_105_days;SputnikV;11802;2977;14779;809759;137234;946993
2021.12_13-10-2022;Чувашская Республика;105_165_days;AllVaccines;85204;23912;109116;674689;275580;950269
2021.12_13-10-2022;Чувашская Республика;105_165_days;CoviVac;431;52;483;674689;275580;950269
2021.12_13-10-2022;Чувашская Республика;105_165_days;EpiVacCorona;1856;496;2352;674689;275580;950269
2021.12_13-10-2022;Чувашская Республика;105_165_days;SputnikLite;22005;7981;29986;674689;275580;950269
2021.12_13-10-2022;Чувашская Республика;105_165_days;SputnikV;60912;15383;76295;674689;275580;950269
2021.12_13-10-2022;Чувашская Республика;165_195_days;AllVaccines;62842;14201;77043;674689;275580;950269
2021.12_13-10-2022;Чувашская Республика;165_195_days;CoviVac;567;65;632;674689;275580;950269
2021.12_13-10-2022;Чувашская Республика;165_195_days;EpiVacCorona;6547;1577;8124;674689;275580;950269
2021.12_13-10-2022;Чувашская Республика;165_195_days;SputnikLite;603;103;706;674689;275580;950269
2021.12_13-10-2022;Чувашская Республика;165_195_days;SputnikV;55125;12456;67581;674689;275580;950269
2021.12_13-10-2022;Чувашская Республика;21_45_days;AllVaccines;59433;30170;89603;674689;275580;950269
2021.12_13-10-2022;Чувашская Республика;21_45_days;CoviVac;738;87;825;674689;275580;950269
2021.12_13-10-2022;Чувашская Республика;21_45_days;EpiVacCorona;1510;547;2057;674689;275580;950269
2021.12_13-10-2022;Чувашская Республика;21_45_days;SputnikLite;11562;11972;23534;674689;275580;950269
2021.12_13-10-2022;Чувашская Республика;21_45_days;SputnikV;45623;17564;63187;674689;275580;950269
2021.12_13-10-2022;Чувашская Республика;45_75_days;AllVaccines;70456;27820;98276;674689;275580;950269
2021.12_13-10-2022;Чувашская Республика;45_75_days;CoviVac;1172;175;1347;674689;275580;950269
2021.12_13-10-2022;Чувашская Республика;45_75_days;EpiVacCorona;2041;499;2540;674689;275580;950269
2021.12_13-10-2022;Чувашская Республика;45_75_days;SputnikLite;9884;9383;19267;674689;275580;950269
2021.12_13-10-2022;Чувашская Республика;45_75_days;SputnikV;57359;17763;75122;674689;275580;950269
2021.12_13-10-2022;Чувашская Республика;75_90_days;AllVaccines;21459;6420;27879;674689;275580;950269
2021.12_13-10-2022;Чувашская Республика;75_90_days;CoviVac;174;30;204;674689;275580;950269
2021.12_13-10-2022;Чувашская Республика;75_90_days;EpiVacCorona;175;59;234;674689;275580;950269
2021.12_13-10-2022;Чувашская Республика;75_90_days;SputnikLite;15438;4534;19972;674689;275580;950269
2021.12_13-10-2022;Чувашская Республика;75_90_days;SputnikV;5672;1797;7469;674689;275580;950269
2021.12_13-10-2022;Чувашская Республика;90_105_days;AllVaccines;22430;6289;28719;674689;275580;950269
2021.12_13-10-2022;Чувашская Республика;90_105_days;CoviVac;109;33;142;674689;275580;950269
2021.12_13-10-2022;Чувашская Республика;90_105_days;EpiVacCorona;73;40;113;674689;275580;950269
2021.12_13-10-2022;Чувашская Республика;90_105_days;SputnikLite;18783;5056;23839;674689;275580;950269
2021.12_13-10-2022;Чувашская Республика;90_105_days;SputnikV;3465;1160;4625;674689;275580;950269
2021.12_13-10-2022;Чукотский автономный округ;105_165_days;AllVaccines;4130;575;4705;30806;6299;37105
2021.12_13-10-2022;Чукотский автономный округ;105_165_days;CoviVac;671;50;721;30806;6299;37105
2021.12_13-10-2022;Чукотский автономный округ;105_165_days;EpiVacCorona;4;2;6;30806;6299;37105
2021.12_13-10-2022;Чукотский автономный округ;105_165_days;SputnikLite;1650;262;1912;30806;6299;37105
2021.12_13-10-2022;Чукотский автономный округ;105_165_days;SputnikV;1805;261;2066;30806;6299;37105
2021.12_13-10-2022;Чукотский автономный округ;165_195_days;AllVaccines;3029;363;3392;30806;6299;37105
2021.12_13-10-2022;Чукотский автономный округ;165_195_days;CoviVac;381;42;423;30806;6299;37105
2021.12_13-10-2022;Чукотский автономный округ;165_195_days;EpiVacCorona;56;22;78;30806;6299;37105
2021.12_13-10-2022;Чукотский автономный округ;165_195_days;SputnikLite;71;2;73;30806;6299;37105
2021.12_13-10-2022;Чукотский автономный округ;165_195_days;SputnikV;2521;297;2818;30806;6299;37105
2021.12_13-10-2022;Чукотский автономный округ;21_45_days;AllVaccines;2351;413;2764;30806;6299;37105
2021.12_13-10-2022;Чукотский автономный округ;21_45_days;CoviVac;47;7;54;30806;6299;37105
2021.12_13-10-2022;Чукотский автономный округ;21_45_days;EpiVacCorona;287;40;327;30806;6299;37105
2021.12_13-10-2022;Чукотский автономный округ;21_45_days;SputnikLite;1559;310;1869;30806;6299;37105
2021.12_13-10-2022;Чукотский автономный округ;21_45_days;SputnikV;458;56;514;30806;6299;37105
2021.12_13-10-2022;Чукотский автономный округ;45_75_days;AllVaccines;4435;746;5181;30806;6299;37105
2021.12_13-10-2022;Чукотский автономный округ;45_75_days;CoviVac;526;33;559;30806;6299;37105
2021.12_13-10-2022;Чукотский автономный округ;45_75_days;EpiVacCorona;255;34;289;30806;6299;37105
2021.12_13-10-2022;Чукотский автономный округ;45_75_days;SputnikLite;3214;615;3829;30806;6299;37105
2021.12_13-10-2022;Чукотский автономный округ;45_75_days;SputnikV;440;64;504;30806;6299;37105
2021.12_13-10-2022;Чукотский автономный округ;75_90_days;AllVaccines;3579;550;4129;30806;6299;37105
2021.12_13-10-2022;Чукотский автономный округ;75_90_days;CoviVac;114;14;128;30806;6299;37105
2021.12_13-10-2022;Чукотский автономный округ;75_90_days;EpiVacCorona;2;1;3;30806;6299;37105
2021.12_13-10-2022;Чукотский автономный округ;75_90_days;SputnikLite;3354;509;3863;30806;6299;37105
2021.12_13-10-2022;Чукотский автономный округ;75_90_days;SputnikV;109;26;135;30806;6299;37105
2021.12_13-10-2022;Чукотский автономный округ;90_105_days;AllVaccines;964;181;1145;30806;6299;37105
2021.12_13-10-2022;Чукотский автономный округ;90_105_days;CoviVac;39;9;48;30806;6299;37105
2021.12_13-10-2022;Чукотский автономный округ;90_105_days;SputnikLite;849;152;1001;30806;6299;37105
2021.12_13-10-2022;Чукотский автономный округ;90_105_days;SputnikV;76;20;96;30806;6299;37105
2021.12_13-10-2022;Ямало-Ненецкий автономный округ;105_165_days;AllVaccines;47937;3783;51720;346064;56429;402493
2021.12_13-10-2022;Ямало-Ненецкий автономный округ;105_165_days;CoviVac;507;37;544;346064;56429;402493
2021.12_13-10-2022;Ямало-Ненецкий автономный округ;105_165_days;EpiVacCorona;79;10;89;346064;56429;402493
2021.12_13-10-2022;Ямало-Ненецкий автономный округ;105_165_days;SputnikLite;22208;1809;24017;346064;56429;402493
2021.12_13-10-2022;Ямало-Ненецкий автономный округ;105_165_days;SputnikV;25143;1927;27070;346064;56429;402493
2021.12_13-10-2022;Ямало-Ненецкий автономный округ;165_195_days;AllVaccines;31120;2310;33430;346064;56429;402493
2021.12_13-10-2022;Ямало-Ненецкий автономный округ;165_195_days;CoviVac;279;39;318;346064;56429;402493
2021.12_13-10-2022;Ямало-Ненецкий автономный округ;165_195_days;EpiVacCorona;285;28;313;346064;56429;402493
2021.12_13-10-2022;Ямало-Ненецкий автономный округ;165_195_days;SputnikLite;283;22;305;346064;56429;402493
2021.12_13-10-2022;Ямало-Ненецкий автономный округ;165_195_days;SputnikV;30273;2221;32494;346064;56429;402493
2021.12_13-10-2022;Ямало-Ненецкий автономный округ;21_45_days;AllVaccines;24108;3186;27294;346064;56429;402493
2021.12_13-10-2022;Ямало-Ненецкий автономный округ;21_45_days;CoviVac;271;44;315;346064;56429;402493
2021.12_13-10-2022;Ямало-Ненецкий автономный округ;21_45_days;EpiVacCorona;117;21;138;346064;56429;402493
2021.12_13-10-2022;Ямало-Ненецкий автономный округ;21_45_days;SputnikLite;10285;1765;12050;346064;56429;402493
2021.12_13-10-2022;Ямало-Ненецкий автономный округ;21_45_days;SputnikV;13435;1356;14791;346064;56429;402493
2021.12_13-10-2022;Ямало-Ненецкий автономный округ;45_75_days;AllVaccines;43082;5144;48226;346064;56429;402493
2021.12_13-10-2022;Ямало-Ненецкий автономный округ;45_75_days;CoviVac;536;50;586;346064;56429;402493
2021.12_13-10-2022;Ямало-Ненецкий автономный округ;45_75_days;EpiVacCorona;222;19;241;346064;56429;402493
2021.12_13-10-2022;Ямало-Ненецкий автономный округ;45_75_days;SputnikLite;18905;3320;22225;346064;56429;402493
2021.12_13-10-2022;Ямало-Ненецкий автономный округ;45_75_days;SputnikV;23419;1755;25174;346064;56429;402493
2021.12_13-10-2022;Ямало-Ненецкий автономный округ;75_90_days;AllVaccines;13719;1872;15591;346064;56429;402493
2021.12_13-10-2022;Ямало-Ненецкий автономный округ;75_90_days;CoviVac;18;2;20;346064;56429;402493
2021.12_13-10-2022;Ямало-Ненецкий автономный округ;75_90_days;EpiVacCorona;129;13;142;346064;56429;402493
2021.12_13-10-2022;Ямало-Ненецкий автономный округ;75_90_days;SputnikLite;11469;1620;13089;346064;56429;402493
2021.12_13-10-2022;Ямало-Ненецкий автономный округ;75_90_days;SputnikV;2103;237;2340;346064;56429;402493
2021.12_13-10-2022;Ямало-Ненецкий автономный округ;90_105_days;AllVaccines;10631;1182;11813;346064;56429;402493
2021.12_13-10-2022;Ямало-Ненецкий автономный округ;90_105_days;CoviVac;9;1;10;346064;56429;402493
2021.12_13-10-2022;Ямало-Ненецкий автономный округ;90_105_days;EpiVacCorona;1;0;1;346064;56429;402493
2021.12_13-10-2022;Ямало-Ненецкий автономный округ;90_105_days;SputnikLite;9259;1025;10284;346064;56429;402493
2021.12_13-10-2022;Ямало-Ненецкий автономный округ;90_105_days;SputnikV;1362;156;1518;346064;56429;402493
2021.12_13-10-2022;Ярославская область;105_165_days;AllVaccines;117832;30248;148080;682586;317712;1000298
2021.12_13-10-2022;Ярославская область;105_165_days;CoviVac;982;113;1095;682586;317712;1000298
2021.12_13-10-2022;Ярославская область;105_165_days;EpiVacCorona;3511;879;4390;682586;317712;1000298
2021.12_13-10-2022;Ярославская область;105_165_days;SputnikLite;41301;9806;51107;682586;317712;1000298
2021.12_13-10-2022;Ярославская область;105_165_days;SputnikV;72038;19450;91488;682586;317712;1000298
2021.12_13-10-2022;Ярославская область;165_195_days;AllVaccines;53624;14582;68206;682586;317712;1000298
2021.12_13-10-2022;Ярославская область;165_195_days;CoviVac;496;49;545;682586;317712;1000298
2021.12_13-10-2022;Ярославская область;165_195_days;EpiVacCorona;2685;754;3439;682586;317712;1000298
2021.12_13-10-2022;Ярославская область;165_195_days;SputnikLite;1764;201;1965;682586;317712;1000298
2021.12_13-10-2022;Ярославская область;165_195_days;SputnikV;48679;13578;62257;682586;317712;1000298
2021.12_13-10-2022;Ярославская область;21_45_days;AllVaccines;43181;23731;66912;682586;317712;1000298
2021.12_13-10-2022;Ярославская область;21_45_days;CoviVac;773;145;918;682586;317712;1000298
2021.12_13-10-2022;Ярославская область;21_45_days;EpiVacCorona;1029;503;1532;682586;317712;1000298
2021.12_13-10-2022;Ярославская область;21_45_days;SputnikLite;16766;11061;27827;682586;317712;1000298
2021.12_13-10-2022;Ярославская область;21_45_days;SputnikV;24613;12022;36635;682586;317712;1000298
2021.12_13-10-2022;Ярославская область;45_75_days;AllVaccines;53100;29542;82642;682586;317712;1000298
2021.12_13-10-2022;Ярославская область;45_75_days;CoviVac;484;37;521;682586;317712;1000298
2021.12_13-10-2022;Ярославская область;45_75_days;EpiVacCorona;565;236;801;682586;317712;1000298
2021.12_13-10-2022;Ярославская область;45_75_days;SputnikLite;30471;16815;47286;682586;317712;1000298
2021.12_13-10-2022;Ярославская область;45_75_days;SputnikV;21580;12454;34034;682586;317712;1000298
2021.12_13-10-2022;Ярославская область;75_90_days;AllVaccines;19973;9973;29946;682586;317712;1000298
2021.12_13-10-2022;Ярославская область;75_90_days;CoviVac;23;8;31;682586;317712;1000298
2021.12_13-10-2022;Ярославская область;75_90_days;EpiVacCorona;94;55;149;682586;317712;1000298
2021.12_13-10-2022;Ярославская область;75_90_days;SputnikLite;14145;6887;21032;682586;317712;1000298
2021.12_13-10-2022;Ярославская область;75_90_days;SputnikV;5711;3023;8734;682586;317712;1000298
2021.12_13-10-2022;Ярославская область;90_105_days;AllVaccines;13560;6996;20556;682586;317712;1000298
2021.12_13-10-2022;Ярославская область;90_105_days;CoviVac;26;3;29;682586;317712;1000298
2021.12_13-10-2022;Ярославская область;90_105_days;EpiVacCorona;87;31;118;682586;317712;1000298
2021.12_13-10-2022;Ярославская область;90_105_days;SputnikLite;9279;4668;13947;682586;317712;1000298
2021.12_13-10-2022;Ярославская область;90_105_days;SputnikV;4168;2294;6462;682586;317712;1000298
2021.12_13-10-2022;г. Москва;105_165_days;AllVaccines;948830;284750;1233580;7299088;3167729;10466817
2021.12_13-10-2022;г. Москва;105_165_days;CoviVac;27752;2861;30613;7299088;3167729;10466817
2021.12_13-10-2022;г. Москва;105_165_days;EpiVacCorona;4899;1813;6712;7299088;3167729;10466817
2021.12_13-10-2022;г. Москва;105_165_days;SputnikLite;121599;80449;202048;7299088;3167729;10466817
2021.12_13-10-2022;г. Москва;105_165_days;SputnikV;794580;199627;994207;7299088;3167729;10466817
2021.12_13-10-2022;г. Москва;165_195_days;AllVaccines;1573070;199654;1772724;7299088;3167729;10466817
2021.12_13-10-2022;г. Москва;165_195_days;CoviVac;39694;2496;42190;7299088;3167729;10466817
2021.12_13-10-2022;г. Москва;165_195_days;EpiVacCorona;52336;11412;63748;7299088;3167729;10466817
2021.12_13-10-2022;г. Москва;165_195_days;SputnikLite;201827;9051;210878;7299088;3167729;10466817
2021.12_13-10-2022;г. Москва;165_195_days;SputnikV;1279213;176695;1455908;7299088;3167729;10466817
2021.12_13-10-2022;г. Москва;21_45_days;AllVaccines;317594;186818;504412;7299088;3167729;10466817
2021.12_13-10-2022;г. Москва;21_45_days;CoviVac;16055;1650;17705;7299088;3167729;10466817
2021.12_13-10-2022;г. Москва;21_45_days;EpiVacCorona;986;638;1624;7299088;3167729;10466817
2021.12_13-10-2022;г. Москва;21_45_days;SputnikLite;88624;75690;164314;7299088;3167729;10466817
2021.12_13-10-2022;г. Москва;21_45_days;SputnikV;211929;108840;320769;7299088;3167729;10466817
2021.12_13-10-2022;г. Москва;45_75_days;AllVaccines;402287;289823;692110;7299088;3167729;10466817
2021.12_13-10-2022;г. Москва;45_75_days;CoviVac;14326;2879;17205;7299088;3167729;10466817
2021.12_13-10-2022;г. Москва;45_75_days;EpiVacCorona;1354;988;2342;7299088;3167729;10466817
2021.12_13-10-2022;г. Москва;45_75_days;SputnikLite;152160;120086;272246;7299088;3167729;10466817
2021.12_13-10-2022;г. Москва;45_75_days;SputnikV;234447;165870;400317;7299088;3167729;10466817
2021.12_13-10-2022;г. Москва;75_90_days;AllVaccines;136288;103795;240083;7299088;3167729;10466817
2021.12_13-10-2022;г. Москва;75_90_days;CoviVac;1974;448;2422;7299088;3167729;10466817
2021.12_13-10-2022;г. Москва;75_90_days;EpiVacCorona;732;595;1327;7299088;3167729;10466817
2021.12_13-10-2022;г. Москва;75_90_days;SputnikLite;78708;68546;147254;7299088;3167729;10466817
2021.12_13-10-2022;г. Москва;75_90_days;SputnikV;54874;34206;89080;7299088;3167729;10466817
2021.12_13-10-2022;г. Москва;90_105_days;AllVaccines;85405;67040;152445;7299088;3167729;10466817
2021.12_13-10-2022;г. Москва;90_105_days;CoviVac;2182;422;2604;7299088;3167729;10466817
2021.12_13-10-2022;г. Москва;90_105_days;EpiVacCorona;602;424;1026;7299088;3167729;10466817
2021.12_13-10-2022;г. Москва;90_105_days;SputnikLite;38636;40106;78742;7299088;3167729;10466817
2021.12_13-10-2022;г. Москва;90_105_days;SputnikV;43985;26088;70073;7299088;3167729;10466817
2021.12_13-10-2022;г. Санкт-Петербург;105_165_days;AllVaccines;574992;136371;711363;3114778;1306302;4421080
2021.12_13-10-2022;г. Санкт-Петербург;105_165_days;CoviVac;13101;623;13724;3114778;1306302;4421080
2021.12_13-10-2022;г. Санкт-Петербург;105_165_days;EpiVacCorona;1876;789;2665;3114778;1306302;4421080
2021.12_13-10-2022;г. Санкт-Петербург;105_165_days;SputnikLite;228984;42629;271613;3114778;1306302;4421080
2021.12_13-10-2022;г. Санкт-Петербург;105_165_days;SputnikV;331031;92330;423361;3114778;1306302;4421080
2021.12_13-10-2022;г. Санкт-Петербург;165_195_days;AllVaccines;272808;52252;325060;3114778;1306302;4421080
2021.12_13-10-2022;г. Санкт-Петербург;165_195_days;CoviVac;9517;444;9961;3114778;1306302;4421080
2021.12_13-10-2022;г. Санкт-Петербург;165_195_days;EpiVacCorona;2347;1058;3405;3114778;1306302;4421080
2021.12_13-10-2022;г. Санкт-Петербург;165_195_days;SputnikLite;7184;267;7451;3114778;1306302;4421080
2021.12_13-10-2022;г. Санкт-Петербург;165_195_days;SputnikV;253760;50483;304243;3114778;1306302;4421080
2021.12_13-10-2022;г. Санкт-Петербург;21_45_days;AllVaccines;347962;125421;473383;3114778;1306302;4421080
2021.12_13-10-2022;г. Санкт-Петербург;21_45_days;CoviVac;2221;170;2391;3114778;1306302;4421080
2021.12_13-10-2022;г. Санкт-Петербург;21_45_days;EpiVacCorona;4197;1811;6008;3114778;1306302;4421080
2021.12_13-10-2022;г. Санкт-Петербург;21_45_days;SputnikLite;107828;56185;164013;3114778;1306302;4421080
2021.12_13-10-2022;г. Санкт-Петербург;21_45_days;SputnikV;233716;67255;300971;3114778;1306302;4421080
2021.12_13-10-2022;г. Санкт-Петербург;45_75_days;AllVaccines;332836;125729;458565;3114778;1306302;4421080
2021.12_13-10-2022;г. Санкт-Петербург;45_75_days;CoviVac;3633;279;3912;3114778;1306302;4421080
2021.12_13-10-2022;г. Санкт-Петербург;45_75_days;EpiVacCorona;2753;1278;4031;3114778;1306302;4421080
2021.12_13-10-2022;г. Санкт-Петербург;45_75_days;SputnikLite;134124;57882;192006;3114778;1306302;4421080
2021.12_13-10-2022;г. Санкт-Петербург;45_75_days;SputnikV;192326;66290;258616;3114778;1306302;4421080
2021.12_13-10-2022;г. Санкт-Петербург;75_90_days;AllVaccines;106596;37789;144385;3114778;1306302;4421080
2021.12_13-10-2022;г. Санкт-Петербург;75_90_days;CoviVac;1888;137;2025;3114778;1306302;4421080
2021.12_13-10-2022;г. Санкт-Петербург;75_90_days;EpiVacCorona;75;39;114;3114778;1306302;4421080
2021.12_13-10-2022;г. Санкт-Петербург;75_90_days;SputnikLite;71623;23745;95368;3114778;1306302;4421080
2021.12_13-10-2022;г. Санкт-Петербург;75_90_days;SputnikV;33010;13868;46878;3114778;1306302;4421080
2021.12_13-10-2022;г. Санкт-Петербург;90_105_days;AllVaccines;80504;31827;112331;3114778;1306302;4421080
2021.12_13-10-2022;г. Санкт-Петербург;90_105_days;CoviVac;2459;161;2620;3114778;1306302;4421080
2021.12_13-10-2022;г. Санкт-Петербург;90_105_days;EpiVacCorona;31;16;47;3114778;1306302;4421080
2021.12_13-10-2022;г. Санкт-Петербург;90_105_days;SputnikLite;50664;20685;71349;3114778;1306302;4421080
2021.12_13-10-2022;г. Санкт-Петербург;90_105_days;SputnikV;27350;10965;38315;3114778;1306302;4421080
2021.12_13-10-2022;г. Севастополь;105_165_days;AllVaccines;22703;7678;30381;293051;116400;409451
2021.12_13-10-2022;г. Севастополь;105_165_days;CoviVac;304;81;385;293051;116400;409451
2021.12_13-10-2022;г. Севастополь;105_165_days;EpiVacCorona;531;316;847;293051;116400;409451
2021.12_13-10-2022;г. Севастополь;105_165_days;SputnikLite;2060;2218;4278;293051;116400;409451
2021.12_13-10-2022;г. Севастополь;105_165_days;SputnikV;19808;5063;24871;293051;116400;409451
2021.12_13-10-2022;г. Севастополь;165_195_days;AllVaccines;25908;8887;34795;293051;116400;409451
2021.12_13-10-2022;г. Севастополь;165_195_days;CoviVac;496;143;639;293051;116400;409451
2021.12_13-10-2022;г. Севастополь;165_195_days;EpiVacCorona;1305;707;2012;293051;116400;409451
2021.12_13-10-2022;г. Севастополь;165_195_days;SputnikLite;53;25;78;293051;116400;409451
2021.12_13-10-2022;г. Севастополь;165_195_days;SputnikV;24054;8012;32066;293051;116400;409451
2021.12_13-10-2022;г. Севастополь;21_45_days;AllVaccines;22501;9863;32364;293051;116400;409451
2021.12_13-10-2022;г. Севастополь;21_45_days;CoviVac;117;38;155;293051;116400;409451
2021.12_13-10-2022;г. Севастополь;21_45_days;EpiVacCorona;281;141;422;293051;116400;409451
2021.12_13-10-2022;г. Севастополь;21_45_days;SputnikLite;6074;5325;11399;293051;116400;409451
2021.12_13-10-2022;г. Севастополь;21_45_days;SputnikV;16029;4359;20388;293051;116400;409451
2021.12_13-10-2022;г. Севастополь;45_75_days;AllVaccines;44369;15497;59866;293051;116400;409451
2021.12_13-10-2022;г. Севастополь;45_75_days;CoviVac;501;132;633;293051;116400;409451
2021.12_13-10-2022;г. Севастополь;45_75_days;EpiVacCorona;937;305;1242;293051;116400;409451
2021.12_13-10-2022;г. Севастополь;45_75_days;SputnikLite;9861;8608;18469;293051;116400;409451
2021.12_13-10-2022;г. Севастополь;45_75_days;SputnikV;33070;6452;39522;293051;116400;409451
2021.12_13-10-2022;г. Севастополь;75_90_days;AllVaccines;12788;4888;17676;293051;116400;409451
2021.12_13-10-2022;г. Севастополь;75_90_days;CoviVac;30;5;35;293051;116400;409451
2021.12_13-10-2022;г. Севастополь;75_90_days;EpiVacCorona;98;42;140;293051;116400;409451
2021.12_13-10-2022;г. Севастополь;75_90_days;SputnikLite;8741;3887;12628;293051;116400;409451
2021.12_13-10-2022;г. Севастополь;75_90_days;SputnikV;3919;954;4873;293051;116400;409451
2021.12_13-10-2022;г. Севастополь;90_105_days;AllVaccines;5138;2764;7902;293051;116400;409451
2021.12_13-10-2022;г. Севастополь;90_105_days;CoviVac;22;7;29;293051;116400;409451
2021.12_13-10-2022;г. Севастополь;90_105_days;EpiVacCorona;87;33;120;293051;116400;409451
2021.12_13-10-2022;г. Севастополь;90_105_days;SputnikLite;2493;2131;4624;293051;116400;409451
2021.12_13-10-2022;г. Севастополь;90_105_days;SputnikV;2536;593;3129;293051;116400;409451
2022.01_13-10-2022;Алтайский край;105_165_days;AllVaccines;108324;52839;161163;1240936;570412;1811348
2022.01_13-10-2022;Алтайский край;105_165_days;CoviVac;1014;156;1170;1240936;570412;1811348
2022.01_13-10-2022;Алтайский край;105_165_days;EpiVacCorona;1533;479;2012;1240936;570412;1811348
2022.01_13-10-2022;Алтайский край;105_165_days;SputnikLite;51873;32214;84087;1240936;570412;1811348
2022.01_13-10-2022;Алтайский край;105_165_days;SputnikV;53904;19990;73894;1240936;570412;1811348
2022.01_13-10-2022;Алтайский край;165_195_days;AllVaccines;136648;26399;163047;1240936;570412;1811348
2022.01_13-10-2022;Алтайский край;165_195_days;CoviVac;1835;146;1981;1240936;570412;1811348
2022.01_13-10-2022;Алтайский край;165_195_days;EpiVacCorona;3077;646;3723;1240936;570412;1811348
2022.01_13-10-2022;Алтайский край;165_195_days;SputnikLite;38558;4139;42697;1240936;570412;1811348
2022.01_13-10-2022;Алтайский край;165_195_days;SputnikV;93178;21468;114646;1240936;570412;1811348
2022.01_13-10-2022;Алтайский край;21_45_days;AllVaccines;43741;25359;69100;1240936;570412;1811348
2022.01_13-10-2022;Алтайский край;21_45_days;CoviVac;283;112;395;1240936;570412;1811348
2022.01_13-10-2022;Алтайский край;21_45_days;EpiVacCorona;1571;857;2428;1240936;570412;1811348
2022.01_13-10-2022;Алтайский край;21_45_days;SputnikLite;28484;16238;44722;1240936;570412;1811348
2022.01_13-10-2022;Алтайский край;21_45_days;SputnikV;13403;8152;21555;1240936;570412;1811348
2022.01_13-10-2022;Алтайский край;45_75_days;AllVaccines;101046;62651;163697;1240936;570412;1811348
2022.01_13-10-2022;Алтайский край;45_75_days;CoviVac;1327;239;1566;1240936;570412;1811348
2022.01_13-10-2022;Алтайский край;45_75_days;EpiVacCorona;4945;2055;7000;1240936;570412;1811348
2022.01_13-10-2022;Алтайский край;45_75_days;SputnikLite;26885;22678;49563;1240936;570412;1811348
2022.01_13-10-2022;Алтайский край;45_75_days;SputnikV;67889;37679;105568;1240936;570412;1811348
2022.01_13-10-2022;Алтайский край;75_90_days;AllVaccines;58566;33336;91902;1240936;570412;1811348
2022.01_13-10-2022;Алтайский край;75_90_days;CoviVac;1210;239;1449;1240936;570412;1811348
2022.01_13-10-2022;Алтайский край;75_90_days;EpiVacCorona;5316;2267;7583;1240936;570412;1811348
2022.01_13-10-2022;Алтайский край;75_90_days;SputnikLite;15118;12318;27436;1240936;570412;1811348
2022.01_13-10-2022;Алтайский край;75_90_days;SputnikV;36922;18512;55434;1240936;570412;1811348
2022.01_13-10-2022;Алтайский край;90_105_days;AllVaccines;36475;23559;60034;1240936;570412;1811348
2022.01_13-10-2022;Алтайский край;90_105_days;CoviVac;852;212;1064;1240936;570412;1811348
2022.01_13-10-2022;Алтайский край;90_105_days;EpiVacCorona;2608;1850;4458;1240936;570412;1811348
2022.01_13-10-2022;Алтайский край;90_105_days;SputnikLite;18451;10331;28782;1240936;570412;1811348
2022.01_13-10-2022;Алтайский край;90_105_days;SputnikV;14564;11166;25730;1240936;570412;1811348
2022.01_13-10-2022;Амурская область;105_165_days;AllVaccines;45234;17229;62463;444961;159780;604741
2022.01_13-10-2022;Амурская область;105_165_days;CoviVac;615;199;814;444961;159780;604741
2022.01_13-10-2022;Амурская область;105_165_days;EpiVacCorona;346;155;501;444961;159780;604741
2022.01_13-10-2022;Амурская область;105_165_days;SputnikLite;21851;11534;33385;444961;159780;604741
2022.01_13-10-2022;Амурская область;105_165_days;SputnikV;22422;5341;27763;444961;159780;604741
2022.01_13-10-2022;Амурская область;165_195_days;AllVaccines;62350;8160;70510;444961;159780;604741
2022.01_13-10-2022;Амурская область;165_195_days;CoviVac;22;2;24;444961;159780;604741
2022.01_13-10-2022;Амурская область;165_195_days;EpiVacCorona;934;212;1146;444961;159780;604741
2022.01_13-10-2022;Амурская область;165_195_days;SputnikLite;20205;2367;22572;444961;159780;604741
2022.01_13-10-2022;Амурская область;165_195_days;SputnikV;41189;5579;46768;444961;159780;604741
2022.01_13-10-2022;Амурская область;21_45_days;AllVaccines;18494;6090;24584;444961;159780;604741
2022.01_13-10-2022;Амурская область;21_45_days;CoviVac;150;31;181;444961;159780;604741
2022.01_13-10-2022;Амурская область;21_45_days;EpiVacCorona;1127;355;1482;444961;159780;604741
2022.01_13-10-2022;Амурская область;21_45_days;SputnikLite;10234;4105;14339;444961;159780;604741
2022.01_13-10-2022;Амурская область;21_45_days;SputnikV;6983;1599;8582;444961;159780;604741
2022.01_13-10-2022;Амурская область;45_75_days;AllVaccines;44023;14668;58691;444961;159780;604741
2022.01_13-10-2022;Амурская область;45_75_days;CoviVac;384;117;501;444961;159780;604741
2022.01_13-10-2022;Амурская область;45_75_days;EpiVacCorona;3429;1245;4674;444961;159780;604741
2022.01_13-10-2022;Амурская область;45_75_days;SputnikLite;9635;5208;14843;444961;159780;604741
2022.01_13-10-2022;Амурская область;45_75_days;SputnikV;30575;8098;38673;444961;159780;604741
2022.01_13-10-2022;Амурская область;75_90_days;AllVaccines;25434;9508;34942;444961;159780;604741
2022.01_13-10-2022;Амурская область;75_90_days;CoviVac;481;139;620;444961;159780;604741
2022.01_13-10-2022;Амурская область;75_90_days;EpiVacCorona;1731;556;2287;444961;159780;604741
2022.01_13-10-2022;Амурская область;75_90_days;SputnikLite;5673;3742;9415;444961;159780;604741
2022.01_13-10-2022;Амурская область;75_90_days;SputnikV;17549;5071;22620;444961;159780;604741
2022.01_13-10-2022;Амурская область;90_105_days;AllVaccines;21756;9440;31196;444961;159780;604741
2022.01_13-10-2022;Амурская область;90_105_days;CoviVac;735;199;934;444961;159780;604741
2022.01_13-10-2022;Амурская область;90_105_days;EpiVacCorona;1744;923;2667;444961;159780;604741
2022.01_13-10-2022;Амурская область;90_105_days;SputnikLite;11208;5252;16460;444961;159780;604741
2022.01_13-10-2022;Амурская область;90_105_days;SputnikV;8069;3066;11135;444961;159780;604741
2022.01_13-10-2022;Архангельская область;105_165_days;AllVaccines;68896;29767;98663;595439;264499;859938
2022.01_13-10-2022;Архангельская область;105_165_days;CoviVac;380;83;463;595439;264499;859938
2022.01_13-10-2022;Архангельская область;105_165_days;EpiVacCorona;831;330;1161;595439;264499;859938
2022.01_13-10-2022;Архангельская область;105_165_days;SputnikLite;42979;19591;62570;595439;264499;859938
2022.01_13-10-2022;Архангельская область;105_165_days;SputnikV;24706;9763;34469;595439;264499;859938
2022.01_13-10-2022;Архангельская область;165_195_days;AllVaccines;77507;17547;95054;595439;264499;859938
2022.01_13-10-2022;Архангельская область;165_195_days;CoviVac;453;45;498;595439;264499;859938
2022.01_13-10-2022;Архангельская область;165_195_days;EpiVacCorona;2006;534;2540;595439;264499;859938
2022.01_13-10-2022;Архангельская область;165_195_days;SputnikLite;15643;2378;18021;595439;264499;859938
2022.01_13-10-2022;Архангельская область;165_195_days;SputnikV;59405;14590;73995;595439;264499;859938
2022.01_13-10-2022;Архангельская область;21_45_days;AllVaccines;15243;10113;25356;595439;264499;859938
2022.01_13-10-2022;Архангельская область;21_45_days;CoviVac;137;16;153;595439;264499;859938
2022.01_13-10-2022;Архангельская область;21_45_days;EpiVacCorona;448;234;682;595439;264499;859938
2022.01_13-10-2022;Архангельская область;21_45_days;SputnikLite;9098;7264;16362;595439;264499;859938
2022.01_13-10-2022;Архангельская область;21_45_days;SputnikV;5560;2599;8159;595439;264499;859938
2022.01_13-10-2022;Архангельская область;45_75_days;AllVaccines;46149;32019;78168;595439;264499;859938
2022.01_13-10-2022;Архангельская область;45_75_days;CoviVac;767;94;861;595439;264499;859938
2022.01_13-10-2022;Архангельская область;45_75_days;EpiVacCorona;2588;1376;3964;595439;264499;859938
2022.01_13-10-2022;Архангельская область;45_75_days;SputnikLite;13970;12781;26751;595439;264499;859938
2022.01_13-10-2022;Архангельская область;45_75_days;SputnikV;28824;17768;46592;595439;264499;859938
2022.01_13-10-2022;Архангельская область;75_90_days;AllVaccines;30596;16557;47153;595439;264499;859938
2022.01_13-10-2022;Архангельская область;75_90_days;CoviVac;440;79;519;595439;264499;859938
2022.01_13-10-2022;Архангельская область;75_90_days;EpiVacCorona;2363;942;3305;595439;264499;859938
2022.01_13-10-2022;Архангельская область;75_90_days;SputnikLite;7966;6985;14951;595439;264499;859938
2022.01_13-10-2022;Архангельская область;75_90_days;SputnikV;19827;8551;28378;595439;264499;859938
2022.01_13-10-2022;Архангельская область;90_105_days;AllVaccines;23215;11303;34518;595439;264499;859938
2022.01_13-10-2022;Архангельская область;90_105_days;CoviVac;597;122;719;595439;264499;859938
2022.01_13-10-2022;Архангельская область;90_105_days;EpiVacCorona;1261;496;1757;595439;264499;859938
2022.01_13-10-2022;Архангельская область;90_105_days;SputnikLite;10698;5317;16015;595439;264499;859938
2022.01_13-10-2022;Архангельская область;90_105_days;SputnikV;10659;5368;16027;595439;264499;859938
2022.01_13-10-2022;Астраханская область;105_165_days;AllVaccines;52843;18785;71628;550968;219749;770717
2022.01_13-10-2022;Астраханская область;105_165_days;CoviVac;398;164;562;550968;219749;770717
2022.01_13-10-2022;Астраханская область;105_165_days;EpiVacCorona;833;427;1260;550968;219749;770717
2022.01_13-10-2022;Астраханская область;105_165_days;SputnikLite;25860;11047;36907;550968;219749;770717
2022.01_13-10-2022;Астраханская область;105_165_days;SputnikV;25752;7147;32899;550968;219749;770717
2022.01_13-10-2022;Астраханская область;165_195_days;AllVaccines;59059;9292;68351;550968;219749;770717
2022.01_13-10-2022;Астраханская область;165_195_days;CoviVac;200;48;248;550968;219749;770717
2022.01_13-10-2022;Астраханская область;165_195_days;EpiVacCorona;680;204;884;550968;219749;770717
2022.01_13-10-2022;Астраханская область;165_195_days;SputnikLite;7275;1092;8367;550968;219749;770717
2022.01_13-10-2022;Астраханская область;165_195_days;SputnikV;50904;7948;58852;550968;219749;770717
2022.01_13-10-2022;Астраханская область;21_45_days;AllVaccines;17507;6605;24112;550968;219749;770717
2022.01_13-10-2022;Астраханская область;21_45_days;CoviVac;183;57;240;550968;219749;770717
2022.01_13-10-2022;Астраханская область;21_45_days;EpiVacCorona;315;91;406;550968;219749;770717
2022.01_13-10-2022;Астраханская область;21_45_days;SputnikLite;10396;4405;14801;550968;219749;770717
2022.01_13-10-2022;Астраханская область;21_45_days;SputnikV;6613;2052;8665;550968;219749;770717
2022.01_13-10-2022;Астраханская область;45_75_days;AllVaccines;43475;15439;58914;550968;219749;770717
2022.01_13-10-2022;Астраханская область;45_75_days;CoviVac;697;228;925;550968;219749;770717
2022.01_13-10-2022;Астраханская область;45_75_days;EpiVacCorona;2644;939;3583;550968;219749;770717
2022.01_13-10-2022;Астраханская область;45_75_days;SputnikLite;12636;5872;18508;550968;219749;770717
2022.01_13-10-2022;Астраханская область;45_75_days;SputnikV;27498;8400;35898;550968;219749;770717
2022.01_13-10-2022;Астраханская область;75_90_days;AllVaccines;24661;9590;34251;550968;219749;770717
2022.01_13-10-2022;Астраханская область;75_90_days;CoviVac;319;142;461;550968;219749;770717
2022.01_13-10-2022;Астраханская область;75_90_days;EpiVacCorona;1251;428;1679;550968;219749;770717
2022.01_13-10-2022;Астраханская область;75_90_days;SputnikLite;7409;4168;11577;550968;219749;770717
2022.01_13-10-2022;Астраханская область;75_90_days;SputnikV;15682;4852;20534;550968;219749;770717
2022.01_13-10-2022;Астраханская область;90_105_days;AllVaccines;23064;8430;31494;550968;219749;770717
2022.01_13-10-2022;Астраханская область;90_105_days;CoviVac;244;105;349;550968;219749;770717
2022.01_13-10-2022;Астраханская область;90_105_days;EpiVacCorona;991;373;1364;550968;219749;770717
2022.01_13-10-2022;Астраханская область;90_105_days;SputnikLite;9565;4381;13946;550968;219749;770717
2022.01_13-10-2022;Астраханская область;90_105_days;SputnikV;12264;3571;15835;550968;219749;770717
2022.01_13-10-2022;Белгородская область;105_165_days;AllVaccines;90726;55823;146549;867731;383871;1251602
2022.01_13-10-2022;Белгородская область;105_165_days;CoviVac;1142;378;1520;867731;383871;1251602
2022.01_13-10-2022;Белгородская область;105_165_days;EpiVacCorona;652;350;1002;867731;383871;1251602
2022.01_13-10-2022;Белгородская область;105_165_days;SputnikLite;50782;37769;88551;867731;383871;1251602
2022.01_13-10-2022;Белгородская область;105_165_days;SputnikV;38150;17326;55476;867731;383871;1251602
2022.01_13-10-2022;Белгородская область;165_195_days;AllVaccines;102785;23827;126612;867731;383871;1251602
2022.01_13-10-2022;Белгородская область;165_195_days;CoviVac;1804;338;2142;867731;383871;1251602
2022.01_13-10-2022;Белгородская область;165_195_days;EpiVacCorona;2576;1034;3610;867731;383871;1251602
2022.01_13-10-2022;Белгородская область;165_195_days;SputnikLite;13551;3355;16906;867731;383871;1251602
2022.01_13-10-2022;Белгородская область;165_195_days;SputnikV;84854;19100;103954;867731;383871;1251602
2022.01_13-10-2022;Белгородская область;21_45_days;AllVaccines;42755;18407;61162;867731;383871;1251602
2022.01_13-10-2022;Белгородская область;21_45_days;CoviVac;191;76;267;867731;383871;1251602
2022.01_13-10-2022;Белгородская область;21_45_days;EpiVacCorona;346;195;541;867731;383871;1251602
2022.01_13-10-2022;Белгородская область;21_45_days;SputnikLite;32517;14719;47236;867731;383871;1251602
2022.01_13-10-2022;Белгородская область;21_45_days;SputnikV;9701;3417;13118;867731;383871;1251602
2022.01_13-10-2022;Белгородская область;45_75_days;AllVaccines;95986;40447;136433;867731;383871;1251602
2022.01_13-10-2022;Белгородская область;45_75_days;CoviVac;591;209;800;867731;383871;1251602
2022.01_13-10-2022;Белгородская область;45_75_days;EpiVacCorona;863;388;1251;867731;383871;1251602
2022.01_13-10-2022;Белгородская область;45_75_days;SputnikLite;36557;20450;57007;867731;383871;1251602
2022.01_13-10-2022;Белгородская область;45_75_days;SputnikV;57975;19400;77375;867731;383871;1251602
2022.01_13-10-2022;Белгородская область;75_90_days;AllVaccines;57109;29317;86426;867731;383871;1251602
2022.01_13-10-2022;Белгородская область;75_90_days;CoviVac;382;123;505;867731;383871;1251602
2022.01_13-10-2022;Белгородская область;75_90_days;EpiVacCorona;661;284;945;867731;383871;1251602
2022.01_13-10-2022;Белгородская область;75_90_days;SputnikLite;25004;16159;41163;867731;383871;1251602
2022.01_13-10-2022;Белгородская область;75_90_days;SputnikV;31062;12751;43813;867731;383871;1251602
2022.01_13-10-2022;Белгородская область;90_105_days;AllVaccines;40056;20737;60793;867731;383871;1251602
2022.01_13-10-2022;Белгородская область;90_105_days;CoviVac;600;246;846;867731;383871;1251602
2022.01_13-10-2022;Белгородская область;90_105_days;EpiVacCorona;787;394;1181;867731;383871;1251602
2022.01_13-10-2022;Белгородская область;90_105_days;SputnikLite;19635;11680;31315;867731;383871;1251602
2022.01_13-10-2022;Белгородская область;90_105_days;SputnikV;19034;8417;27451;867731;383871;1251602
2022.01_13-10-2022;Брянская область;105_165_days;AllVaccines;69635;28978;98613;659625;298625;958250
2022.01_13-10-2022;Брянская область;105_165_days;CoviVac;574;155;729;659625;298625;958250
2022.01_13-10-2022;Брянская область;105_165_days;EpiVacCorona;407;206;613;659625;298625;958250
2022.01_13-10-2022;Брянская область;105_165_days;SputnikLite;35836;19241;55077;659625;298625;958250
2022.01_13-10-2022;Брянская область;105_165_days;SputnikV;32818;9376;42194;659625;298625;958250
2022.01_13-10-2022;Брянская область;165_195_days;AllVaccines;58826;13760;72586;659625;298625;958250
2022.01_13-10-2022;Брянская область;165_195_days;CoviVac;252;55;307;659625;298625;958250
2022.01_13-10-2022;Брянская область;165_195_days;EpiVacCorona;894;288;1182;659625;298625;958250
2022.01_13-10-2022;Брянская область;165_195_days;SputnikLite;7466;1573;9039;659625;298625;958250
2022.01_13-10-2022;Брянская область;165_195_days;SputnikV;50214;11844;62058;659625;298625;958250
2022.01_13-10-2022;Брянская область;21_45_days;AllVaccines;21792;12940;34732;659625;298625;958250
2022.01_13-10-2022;Брянская область;21_45_days;CoviVac;236;70;306;659625;298625;958250
2022.01_13-10-2022;Брянская область;21_45_days;EpiVacCorona;628;325;953;659625;298625;958250
2022.01_13-10-2022;Брянская область;21_45_days;SputnikLite;15587;9716;25303;659625;298625;958250
2022.01_13-10-2022;Брянская область;21_45_days;SputnikV;5341;2829;8170;659625;298625;958250
2022.01_13-10-2022;Брянская область;45_75_days;AllVaccines;48389;29139;77528;659625;298625;958250
2022.01_13-10-2022;Брянская область;45_75_days;CoviVac;1071;285;1356;659625;298625;958250
2022.01_13-10-2022;Брянская область;45_75_days;EpiVacCorona;3895;1970;5865;659625;298625;958250
2022.01_13-10-2022;Брянская область;45_75_days;SputnikLite;12006;10446;22452;659625;298625;958250
2022.01_13-10-2022;Брянская область;45_75_days;SputnikV;31417;16438;47855;659625;298625;958250
2022.01_13-10-2022;Брянская область;75_90_days;AllVaccines;35359;21826;57185;659625;298625;958250
2022.01_13-10-2022;Брянская область;75_90_days;CoviVac;873;239;1112;659625;298625;958250
2022.01_13-10-2022;Брянская область;75_90_days;EpiVacCorona;2854;1208;4062;659625;298625;958250
2022.01_13-10-2022;Брянская область;75_90_days;SputnikLite;11361;9579;20940;659625;298625;958250
2022.01_13-10-2022;Брянская область;75_90_days;SputnikV;20271;10800;31071;659625;298625;958250
2022.01_13-10-2022;Брянская область;90_105_days;AllVaccines;16901;10747;27648;659625;298625;958250
2022.01_13-10-2022;Брянская область;90_105_days;CoviVac;474;148;622;659625;298625;958250
2022.01_13-10-2022;Брянская область;90_105_days;EpiVacCorona;1530;705;2235;659625;298625;958250
2022.01_13-10-2022;Брянская область;90_105_days;SputnikLite;4283;2829;7112;659625;298625;958250
2022.01_13-10-2022;Брянская область;90_105_days;SputnikV;10614;7065;17679;659625;298625;958250
2022.01_13-10-2022;Владимирская область;105_165_days;AllVaccines;66271;34696;100967;739166;354521;1093687
2022.01_13-10-2022;Владимирская область;105_165_days;CoviVac;667;142;809;739166;354521;1093687
2022.01_13-10-2022;Владимирская область;105_165_days;EpiVacCorona;771;335;1106;739166;354521;1093687
2022.01_13-10-2022;Владимирская область;105_165_days;SputnikLite;35755;22498;58253;739166;354521;1093687
2022.01_13-10-2022;Владимирская область;105_165_days;SputnikV;29078;11721;40799;739166;354521;1093687
2022.01_13-10-2022;Владимирская область;165_195_days;AllVaccines;70775;17081;87856;739166;354521;1093687
2022.01_13-10-2022;Владимирская область;165_195_days;CoviVac;603;109;712;739166;354521;1093687
2022.01_13-10-2022;Владимирская область;165_195_days;EpiVacCorona;1474;474;1948;739166;354521;1093687
2022.01_13-10-2022;Владимирская область;165_195_days;SputnikLite;24164;5362;29526;739166;354521;1093687
2022.01_13-10-2022;Владимирская область;165_195_days;SputnikV;44534;11136;55670;739166;354521;1093687
2022.01_13-10-2022;Владимирская область;21_45_days;AllVaccines;16105;10564;26669;739166;354521;1093687
2022.01_13-10-2022;Владимирская область;21_45_days;CoviVac;93;27;120;739166;354521;1093687
2022.01_13-10-2022;Владимирская область;21_45_days;EpiVacCorona;802;583;1385;739166;354521;1093687
2022.01_13-10-2022;Владимирская область;21_45_days;SputnikLite;9795;7576;17371;739166;354521;1093687
2022.01_13-10-2022;Владимирская область;21_45_days;SputnikV;5415;2378;7793;739166;354521;1093687
2022.01_13-10-2022;Владимирская область;45_75_days;AllVaccines;59212;29739;88951;739166;354521;1093687
2022.01_13-10-2022;Владимирская область;45_75_days;CoviVac;737;202;939;739166;354521;1093687
2022.01_13-10-2022;Владимирская область;45_75_days;EpiVacCorona;3987;2354;6341;739166;354521;1093687
2022.01_13-10-2022;Владимирская область;45_75_days;SputnikLite;15148;11078;26226;739166;354521;1093687
2022.01_13-10-2022;Владимирская область;45_75_days;SputnikV;39340;16105;55445;739166;354521;1093687
2022.01_13-10-2022;Владимирская область;75_90_days;AllVaccines;41259;20746;62005;739166;354521;1093687
2022.01_13-10-2022;Владимирская область;75_90_days;CoviVac;1071;229;1300;739166;354521;1093687
2022.01_13-10-2022;Владимирская область;75_90_days;EpiVacCorona;2519;1205;3724;739166;354521;1093687
2022.01_13-10-2022;Владимирская область;75_90_days;SputnikLite;13437;9743;23180;739166;354521;1093687
2022.01_13-10-2022;Владимирская область;75_90_days;SputnikV;24232;9569;33801;739166;354521;1093687
2022.01_13-10-2022;Владимирская область;90_105_days;AllVaccines;28502;15331;43833;739166;354521;1093687
2022.01_13-10-2022;Владимирская область;90_105_days;CoviVac;681;172;853;739166;354521;1093687
2022.01_13-10-2022;Владимирская область;90_105_days;EpiVacCorona;1072;554;1626;739166;354521;1093687
2022.01_13-10-2022;Владимирская область;90_105_days;SputnikLite;16692;9080;25772;739166;354521;1093687
2022.01_13-10-2022;Владимирская область;90_105_days;SputnikV;10057;5525;15582;739166;354521;1093687
2022.01_13-10-2022;Волгоградская область;105_165_days;AllVaccines;141166;58709;199875;1387837;615020;2002857
2022.01_13-10-2022;Волгоградская область;105_165_days;CoviVac;1800;413;2213;1387837;615020;2002857
2022.01_13-10-2022;Волгоградская область;105_165_days;EpiVacCorona;2478;958;3436;1387837;615020;2002857
2022.01_13-10-2022;Волгоградская область;105_165_days;SputnikLite;59371;34065;93436;1387837;615020;2002857
2022.01_13-10-2022;Волгоградская область;105_165_days;SputnikV;77517;23273;100790;1387837;615020;2002857
2022.01_13-10-2022;Волгоградская область;165_195_days;AllVaccines;173726;31783;205509;1387837;615020;2002857
2022.01_13-10-2022;Волгоградская область;165_195_days;CoviVac;2507;269;2776;1387837;615020;2002857
2022.01_13-10-2022;Волгоградская область;165_195_days;EpiVacCorona;4214;1005;5219;1387837;615020;2002857
2022.01_13-10-2022;Волгоградская область;165_195_days;SputnikLite;46138;8344;54482;1387837;615020;2002857
2022.01_13-10-2022;Волгоградская область;165_195_days;SputnikV;120867;22165;143032;1387837;615020;2002857
2022.01_13-10-2022;Волгоградская область;21_45_days;AllVaccines;50498;28782;79280;1387837;615020;2002857
2022.01_13-10-2022;Волгоградская область;21_45_days;CoviVac;286;114;400;1387837;615020;2002857
2022.01_13-10-2022;Волгоградская область;21_45_days;EpiVacCorona;1240;2183;3423;1387837;615020;2002857
2022.01_13-10-2022;Волгоградская область;21_45_days;SputnikLite;34426;17737;52163;1387837;615020;2002857
2022.01_13-10-2022;Волгоградская область;21_45_days;SputnikV;14546;8748;23294;1387837;615020;2002857
2022.01_13-10-2022;Волгоградская область;45_75_days;AllVaccines;121478;69913;191391;1387837;615020;2002857
2022.01_13-10-2022;Волгоградская область;45_75_days;CoviVac;833;261;1094;1387837;615020;2002857
2022.01_13-10-2022;Волгоградская область;45_75_days;EpiVacCorona;2833;1505;4338;1387837;615020;2002857
2022.01_13-10-2022;Волгоградская область;45_75_days;SputnikLite;39338;26800;66138;1387837;615020;2002857
2022.01_13-10-2022;Волгоградская область;45_75_days;SputnikV;78474;41347;119821;1387837;615020;2002857
2022.01_13-10-2022;Волгоградская область;75_90_days;AllVaccines;88869;48595;137464;1387837;615020;2002857
2022.01_13-10-2022;Волгоградская область;75_90_days;CoviVac;247;61;308;1387837;615020;2002857
2022.01_13-10-2022;Волгоградская область;75_90_days;EpiVacCorona;2164;858;3022;1387837;615020;2002857
2022.01_13-10-2022;Волгоградская область;75_90_days;SputnikLite;19088;15224;34312;1387837;615020;2002857
2022.01_13-10-2022;Волгоградская область;75_90_days;SputnikV;67370;32452;99822;1387837;615020;2002857
2022.01_13-10-2022;Волгоградская область;90_105_days;AllVaccines;43897;22216;66113;1387837;615020;2002857
2022.01_13-10-2022;Волгоградская область;90_105_days;CoviVac;393;129;522;1387837;615020;2002857
2022.01_13-10-2022;Волгоградская область;90_105_days;EpiVacCorona;1487;721;2208;1387837;615020;2002857
2022.01_13-10-2022;Волгоградская область;90_105_days;SputnikLite;8080;3213;11293;1387837;615020;2002857
2022.01_13-10-2022;Волгоградская область;90_105_days;SputnikV;33937;18153;52090;1387837;615020;2002857
2022.01_13-10-2022;Вологодская область;105_165_days;AllVaccines;72934;29514;102448;628100;275171;903271
2022.01_13-10-2022;Вологодская область;105_165_days;CoviVac;76;9;85;628100;275171;903271
2022.01_13-10-2022;Вологодская область;105_165_days;EpiVacCorona;259;191;450;628100;275171;903271
2022.01_13-10-2022;Вологодская область;105_165_days;SputnikLite;59760;19795;79555;628100;275171;903271
2022.01_13-10-2022;Вологодская область;105_165_days;SputnikV;12839;9519;22358;628100;275171;903271
2022.01_13-10-2022;Вологодская область;165_195_days;AllVaccines;61490;14507;75997;628100;275171;903271
2022.01_13-10-2022;Вологодская область;165_195_days;CoviVac;429;46;475;628100;275171;903271
2022.01_13-10-2022;Вологодская область;165_195_days;EpiVacCorona;557;363;920;628100;275171;903271
2022.01_13-10-2022;Вологодская область;165_195_days;SputnikLite;26025;2737;28762;628100;275171;903271
2022.01_13-10-2022;Вологодская область;165_195_days;SputnikV;34479;11361;45840;628100;275171;903271
2022.01_13-10-2022;Вологодская область;21_45_days;AllVaccines;20809;10985;31794;628100;275171;903271
2022.01_13-10-2022;Вологодская область;21_45_days;CoviVac;506;98;604;628100;275171;903271
2022.01_13-10-2022;Вологодская область;21_45_days;EpiVacCorona;843;437;1280;628100;275171;903271
2022.01_13-10-2022;Вологодская область;21_45_days;SputnikLite;9820;6717;16537;628100;275171;903271
2022.01_13-10-2022;Вологодская область;21_45_days;SputnikV;9640;3733;13373;628100;275171;903271
2022.01_13-10-2022;Вологодская область;45_75_days;AllVaccines;68885;32031;100916;628100;275171;903271
2022.01_13-10-2022;Вологодская область;45_75_days;CoviVac;1752;284;2036;628100;275171;903271
2022.01_13-10-2022;Вологодская область;45_75_days;EpiVacCorona;3005;1061;4066;628100;275171;903271
2022.01_13-10-2022;Вологодская область;45_75_days;SputnikLite;13777;11345;25122;628100;275171;903271
2022.01_13-10-2022;Вологодская область;45_75_days;SputnikV;50351;19341;69692;628100;275171;903271
2022.01_13-10-2022;Вологодская область;75_90_days;AllVaccines;34409;20142;54551;628100;275171;903271
2022.01_13-10-2022;Вологодская область;75_90_days;CoviVac;1085;169;1254;628100;275171;903271
2022.01_13-10-2022;Вологодская область;75_90_days;EpiVacCorona;1339;635;1974;628100;275171;903271
2022.01_13-10-2022;Вологодская область;75_90_days;SputnikLite;8602;7457;16059;628100;275171;903271
2022.01_13-10-2022;Вологодская область;75_90_days;SputnikV;23383;11881;35264;628100;275171;903271
2022.01_13-10-2022;Вологодская область;90_105_days;AllVaccines;14448;8331;22779;628100;275171;903271
2022.01_13-10-2022;Вологодская область;90_105_days;CoviVac;664;117;781;628100;275171;903271
2022.01_13-10-2022;Вологодская область;90_105_days;EpiVacCorona;650;285;935;628100;275171;903271
2022.01_13-10-2022;Вологодская область;90_105_days;SputnikLite;5009;1573;6582;628100;275171;903271
2022.01_13-10-2022;Вологодская область;90_105_days;SputnikV;8125;6356;14481;628100;275171;903271
2022.01_13-10-2022;Воронежская область;105_165_days;AllVaccines;141379;74911;216290;1293123;602333;1895456
2022.01_13-10-2022;Воронежская область;105_165_days;CoviVac;2354;800;3154;1293123;602333;1895456
2022.01_13-10-2022;Воронежская область;105_165_days;EpiVacCorona;1441;792;2233;1293123;602333;1895456
2022.01_13-10-2022;Воронежская область;105_165_days;SputnikLite;77869;47841;125710;1293123;602333;1895456
2022.01_13-10-2022;Воронежская область;105_165_days;SputnikV;59715;25478;85193;1293123;602333;1895456
2022.01_13-10-2022;Воронежская область;165_195_days;AllVaccines;121407;27766;149173;1293123;602333;1895456
2022.01_13-10-2022;Воронежская область;165_195_days;CoviVac;2323;534;2857;1293123;602333;1895456
2022.01_13-10-2022;Воронежская область;165_195_days;EpiVacCorona;3482;1340;4822;1293123;602333;1895456
2022.01_13-10-2022;Воронежская область;165_195_days;SputnikLite;30177;8412;38589;1293123;602333;1895456
2022.01_13-10-2022;Воронежская область;165_195_days;SputnikV;85425;17480;102905;1293123;602333;1895456
2022.01_13-10-2022;Воронежская область;21_45_days;AllVaccines;37434;21111;58545;1293123;602333;1895456
2022.01_13-10-2022;Воронежская область;21_45_days;CoviVac;342;146;488;1293123;602333;1895456
2022.01_13-10-2022;Воронежская область;21_45_days;EpiVacCorona;1204;700;1904;1293123;602333;1895456
2022.01_13-10-2022;Воронежская область;21_45_days;SputnikLite;25162;15303;40465;1293123;602333;1895456
2022.01_13-10-2022;Воронежская область;21_45_days;SputnikV;10726;4962;15688;1293123;602333;1895456
2022.01_13-10-2022;Воронежская область;45_75_days;AllVaccines;107032;52385;159417;1293123;602333;1895456
2022.01_13-10-2022;Воронежская область;45_75_days;CoviVac;650;198;848;1293123;602333;1895456
2022.01_13-10-2022;Воронежская область;45_75_days;EpiVacCorona;4975;2873;7848;1293123;602333;1895456
2022.01_13-10-2022;Воронежская область;45_75_days;SputnikLite;25648;20766;46414;1293123;602333;1895456
2022.01_13-10-2022;Воронежская область;45_75_days;SputnikV;75759;28548;104307;1293123;602333;1895456
2022.01_13-10-2022;Воронежская область;75_90_days;AllVaccines;81836;40039;121875;1293123;602333;1895456
2022.01_13-10-2022;Воронежская область;75_90_days;CoviVac;460;130;590;1293123;602333;1895456
2022.01_13-10-2022;Воронежская область;75_90_days;EpiVacCorona;2383;1165;3548;1293123;602333;1895456
2022.01_13-10-2022;Воронежская область;75_90_days;SputnikLite;24915;19944;44859;1293123;602333;1895456
2022.01_13-10-2022;Воронежская область;75_90_days;SputnikV;54078;18800;72878;1293123;602333;1895456
2022.01_13-10-2022;Воронежская область;90_105_days;AllVaccines;86989;24433;111422;1293123;602333;1895456
2022.01_13-10-2022;Воронежская область;90_105_days;CoviVac;494;163;657;1293123;602333;1895456
2022.01_13-10-2022;Воронежская область;90_105_days;EpiVacCorona;3347;1052;4399;1293123;602333;1895456
2022.01_13-10-2022;Воронежская область;90_105_days;SputnikLite;8619;6164;14783;1293123;602333;1895456
2022.01_13-10-2022;Воронежская область;90_105_days;SputnikV;74529;17054;91583;1293123;602333;1895456
2022.01_13-10-2022;Еврейская автономная область;105_165_days;AllVaccines;4745;2577;7322;88207;31969;120176
2022.01_13-10-2022;Еврейская автономная область;105_165_days;CoviVac;17;2;19;88207;31969;120176
2022.01_13-10-2022;Еврейская автономная область;105_165_days;EpiVacCorona;76;24;100;88207;31969;120176
2022.01_13-10-2022;Еврейская автономная область;105_165_days;SputnikLite;2205;1626;3831;88207;31969;120176
2022.01_13-10-2022;Еврейская автономная область;105_165_days;SputnikV;2447;925;3372;88207;31969;120176
2022.01_13-10-2022;Еврейская автономная область;165_195_days;AllVaccines;5257;1038;6295;88207;31969;120176
2022.01_13-10-2022;Еврейская автономная область;165_195_days;CoviVac;49;1;50;88207;31969;120176
2022.01_13-10-2022;Еврейская автономная область;165_195_days;EpiVacCorona;465;94;559;88207;31969;120176
2022.01_13-10-2022;Еврейская автономная область;165_195_days;SputnikLite;235;102;337;88207;31969;120176
2022.01_13-10-2022;Еврейская автономная область;165_195_days;SputnikV;4508;841;5349;88207;31969;120176
2022.01_13-10-2022;Еврейская автономная область;21_45_days;AllVaccines;4080;1450;5530;88207;31969;120176
2022.01_13-10-2022;Еврейская автономная область;21_45_days;CoviVac;341;54;395;88207;31969;120176
2022.01_13-10-2022;Еврейская автономная область;21_45_days;EpiVacCorona;771;211;982;88207;31969;120176
2022.01_13-10-2022;Еврейская автономная область;21_45_days;SputnikLite;1889;935;2824;88207;31969;120176
2022.01_13-10-2022;Еврейская автономная область;21_45_days;SputnikV;1079;250;1329;88207;31969;120176
2022.01_13-10-2022;Еврейская автономная область;45_75_days;AllVaccines;12377;3518;15895;88207;31969;120176
2022.01_13-10-2022;Еврейская автономная область;45_75_days;CoviVac;298;54;352;88207;31969;120176
2022.01_13-10-2022;Еврейская автономная область;45_75_days;EpiVacCorona;707;159;866;88207;31969;120176
2022.01_13-10-2022;Еврейская автономная область;45_75_days;SputnikLite;2324;1219;3543;88207;31969;120176
2022.01_13-10-2022;Еврейская автономная область;45_75_days;SputnikV;9048;2086;11134;88207;31969;120176
2022.01_13-10-2022;Еврейская автономная область;75_90_days;AllVaccines;4239;1296;5535;88207;31969;120176
2022.01_13-10-2022;Еврейская автономная область;75_90_days;CoviVac;2;0;2;88207;31969;120176
2022.01_13-10-2022;Еврейская автономная область;75_90_days;EpiVacCorona;665;85;750;88207;31969;120176
2022.01_13-10-2022;Еврейская автономная область;75_90_days;SputnikLite;1020;615;1635;88207;31969;120176
2022.01_13-10-2022;Еврейская автономная область;75_90_days;SputnikV;2552;596;3148;88207;31969;120176
2022.01_13-10-2022;Еврейская автономная область;90_105_days;AllVaccines;2988;1031;4019;88207;31969;120176
2022.01_13-10-2022;Еврейская автономная область;90_105_days;CoviVac;4;1;5;88207;31969;120176
2022.01_13-10-2022;Еврейская автономная область;90_105_days;EpiVacCorona;482;75;557;88207;31969;120176
2022.01_13-10-2022;Еврейская автономная область;90_105_days;SputnikLite;1079;525;1604;88207;31969;120176
2022.01_13-10-2022;Еврейская автономная область;90_105_days;SputnikV;1423;430;1853;88207;31969;120176
2022.01_13-10-2022;Забайкальский край;105_165_days;AllVaccines;60664;23115;83779;596322;191826;788148
2022.01_13-10-2022;Забайкальский край;105_165_days;CoviVac;354;27;381;596322;191826;788148
2022.01_13-10-2022;Забайкальский край;105_165_days;EpiVacCorona;285;77;362;596322;191826;788148
2022.01_13-10-2022;Забайкальский край;105_165_days;SputnikLite;42314;16404;58718;596322;191826;788148
2022.01_13-10-2022;Забайкальский край;105_165_days;SputnikV;17711;6607;24318;596322;191826;788148
2022.01_13-10-2022;Забайкальский край;165_195_days;AllVaccines;65852;10781;76633;596322;191826;788148
2022.01_13-10-2022;Забайкальский край;165_195_days;CoviVac;302;11;313;596322;191826;788148
2022.01_13-10-2022;Забайкальский край;165_195_days;EpiVacCorona;1152;369;1521;596322;191826;788148
2022.01_13-10-2022;Забайкальский край;165_195_days;SputnikLite;19017;710;19727;596322;191826;788148
2022.01_13-10-2022;Забайкальский край;165_195_days;SputnikV;45381;9691;55072;596322;191826;788148
2022.01_13-10-2022;Забайкальский край;21_45_days;AllVaccines;25386;8232;33618;596322;191826;788148
2022.01_13-10-2022;Забайкальский край;21_45_days;CoviVac;195;36;231;596322;191826;788148
2022.01_13-10-2022;Забайкальский край;21_45_days;EpiVacCorona;2226;694;2920;596322;191826;788148
2022.01_13-10-2022;Забайкальский край;21_45_days;SputnikLite;13555;4581;18136;596322;191826;788148
2022.01_13-10-2022;Забайкальский край;21_45_days;SputnikV;9410;2921;12331;596322;191826;788148
2022.01_13-10-2022;Забайкальский край;45_75_days;AllVaccines;61200;23260;84460;596322;191826;788148
2022.01_13-10-2022;Забайкальский край;45_75_days;CoviVac;536;41;577;596322;191826;788148
2022.01_13-10-2022;Забайкальский край;45_75_days;EpiVacCorona;4382;1457;5839;596322;191826;788148
2022.01_13-10-2022;Забайкальский край;45_75_days;SputnikLite;18181;8129;26310;596322;191826;788148
2022.01_13-10-2022;Забайкальский край;45_75_days;SputnikV;38101;13633;51734;596322;191826;788148
2022.01_13-10-2022;Забайкальский край;75_90_days;AllVaccines;37441;15244;52685;596322;191826;788148
2022.01_13-10-2022;Забайкальский край;75_90_days;CoviVac;499;52;551;596322;191826;788148
2022.01_13-10-2022;Забайкальский край;75_90_days;EpiVacCorona;1609;570;2179;596322;191826;788148
2022.01_13-10-2022;Забайкальский край;75_90_days;SputnikLite;12714;5953;18667;596322;191826;788148
2022.01_13-10-2022;Забайкальский край;75_90_days;SputnikV;22619;8669;31288;596322;191826;788148
2022.01_13-10-2022;Забайкальский край;90_105_days;AllVaccines;21744;10131;31875;596322;191826;788148
2022.01_13-10-2022;Забайкальский край;90_105_days;CoviVac;303;25;328;596322;191826;788148
2022.01_13-10-2022;Забайкальский край;90_105_days;EpiVacCorona;426;164;590;596322;191826;788148
2022.01_13-10-2022;Забайкальский край;90_105_days;SputnikLite;13156;5700;18856;596322;191826;788148
2022.01_13-10-2022;Забайкальский край;90_105_days;SputnikV;7859;4242;12101;596322;191826;788148
2022.01_13-10-2022;Ивановская область;105_165_days;AllVaccines;36342;24142;60484;549803;255947;805750
2022.01_13-10-2022;Ивановская область;105_165_days;CoviVac;155;27;182;549803;255947;805750
2022.01_13-10-2022;Ивановская область;105_165_days;EpiVacCorona;255;191;446;549803;255947;805750
2022.01_13-10-2022;Ивановская область;105_165_days;SputnikLite;21987;16513;38500;549803;255947;805750
2022.01_13-10-2022;Ивановская область;105_165_days;SputnikV;13945;7411;21356;549803;255947;805750
2022.01_13-10-2022;Ивановская область;165_195_days;AllVaccines;52444;9696;62140;549803;255947;805750
2022.01_13-10-2022;Ивановская область;165_195_days;CoviVac;363;35;398;549803;255947;805750
2022.01_13-10-2022;Ивановская область;165_195_days;EpiVacCorona;506;328;834;549803;255947;805750
2022.01_13-10-2022;Ивановская область;165_195_days;SputnikLite;7991;1838;9829;549803;255947;805750
2022.01_13-10-2022;Ивановская область;165_195_days;SputnikV;43584;7495;51079;549803;255947;805750
2022.01_13-10-2022;Ивановская область;21_45_days;AllVaccines;11890;7025;18915;549803;255947;805750
2022.01_13-10-2022;Ивановская область;21_45_days;CoviVac;90;17;107;549803;255947;805750
2022.01_13-10-2022;Ивановская область;21_45_days;EpiVacCorona;574;274;848;549803;255947;805750
2022.01_13-10-2022;Ивановская область;21_45_days;SputnikLite;8425;4987;13412;549803;255947;805750
2022.01_13-10-2022;Ивановская область;21_45_days;SputnikV;2801;1747;4548;549803;255947;805750
2022.01_13-10-2022;Ивановская область;45_75_days;AllVaccines;20965;16555;37520;549803;255947;805750
2022.01_13-10-2022;Ивановская область;45_75_days;CoviVac;387;65;452;549803;255947;805750
2022.01_13-10-2022;Ивановская область;45_75_days;EpiVacCorona;1173;1053;2226;549803;255947;805750
2022.01_13-10-2022;Ивановская область;45_75_days;SputnikLite;7399;6752;14151;549803;255947;805750
2022.01_13-10-2022;Ивановская область;45_75_days;SputnikV;12006;8685;20691;549803;255947;805750
2022.01_13-10-2022;Ивановская область;75_90_days;AllVaccines;15736;12641;28377;549803;255947;805750
2022.01_13-10-2022;Ивановская область;75_90_days;CoviVac;95;19;114;549803;255947;805750
2022.01_13-10-2022;Ивановская область;75_90_days;EpiVacCorona;335;257;592;549803;255947;805750
2022.01_13-10-2022;Ивановская область;75_90_days;SputnikLite;6152;6445;12597;549803;255947;805750
2022.01_13-10-2022;Ивановская область;75_90_days;SputnikV;9154;5920;15074;549803;255947;805750
2022.01_13-10-2022;Ивановская область;90_105_days;AllVaccines;15515;12645;28160;549803;255947;805750
2022.01_13-10-2022;Ивановская область;90_105_days;CoviVac;222;44;266;549803;255947;805750
2022.01_13-10-2022;Ивановская область;90_105_days;EpiVacCorona;256;209;465;549803;255947;805750
2022.01_13-10-2022;Ивановская область;90_105_days;SputnikLite;8729;7061;15790;549803;255947;805750
2022.01_13-10-2022;Ивановская область;90_105_days;SputnikV;6308;5331;11639;549803;255947;805750
2022.01_13-10-2022;Иркутская область;105_165_days;AllVaccines;107691;51105;158796;1316761;480655;1797416
2022.01_13-10-2022;Иркутская область;105_165_days;CoviVac;1395;387;1782;1316761;480655;1797416
2022.01_13-10-2022;Иркутская область;105_165_days;EpiVacCorona;3963;1353;5316;1316761;480655;1797416
2022.01_13-10-2022;Иркутская область;105_165_days;SputnikLite;44794;32623;77417;1316761;480655;1797416
2022.01_13-10-2022;Иркутская область;105_165_days;SputnikV;57539;16742;74281;1316761;480655;1797416
2022.01_13-10-2022;Иркутская область;165_195_days;AllVaccines;87442;22000;109442;1316761;480655;1797416
2022.01_13-10-2022;Иркутская область;165_195_days;CoviVac;1696;372;2068;1316761;480655;1797416
2022.01_13-10-2022;Иркутская область;165_195_days;EpiVacCorona;4849;1300;6149;1316761;480655;1797416
2022.01_13-10-2022;Иркутская область;165_195_days;SputnikLite;10175;3911;14086;1316761;480655;1797416
2022.01_13-10-2022;Иркутская область;165_195_days;SputnikV;70722;16417;87139;1316761;480655;1797416
2022.01_13-10-2022;Иркутская область;21_45_days;AllVaccines;50432;22203;72635;1316761;480655;1797416
2022.01_13-10-2022;Иркутская область;21_45_days;CoviVac;255;75;330;1316761;480655;1797416
2022.01_13-10-2022;Иркутская область;21_45_days;EpiVacCorona;1221;654;1875;1316761;480655;1797416
2022.01_13-10-2022;Иркутская область;21_45_days;SputnikLite;25542;16329;41871;1316761;480655;1797416
2022.01_13-10-2022;Иркутская область;21_45_days;SputnikV;23414;5145;28559;1316761;480655;1797416
2022.01_13-10-2022;Иркутская область;45_75_days;AllVaccines;176114;55101;231215;1316761;480655;1797416
2022.01_13-10-2022;Иркутская область;45_75_days;CoviVac;1636;361;1997;1316761;480655;1797416
2022.01_13-10-2022;Иркутская область;45_75_days;EpiVacCorona;3282;1109;4391;1316761;480655;1797416
2022.01_13-10-2022;Иркутская область;45_75_days;SputnikLite;37966;26934;64900;1316761;480655;1797416
2022.01_13-10-2022;Иркутская область;45_75_days;SputnikV;133230;26697;159927;1316761;480655;1797416
2022.01_13-10-2022;Иркутская область;75_90_days;AllVaccines;102855;32545;135400;1316761;480655;1797416
2022.01_13-10-2022;Иркутская область;75_90_days;CoviVac;1408;288;1696;1316761;480655;1797416
2022.01_13-10-2022;Иркутская область;75_90_days;EpiVacCorona;1841;548;2389;1316761;480655;1797416
2022.01_13-10-2022;Иркутская область;75_90_days;SputnikLite;22910;17106;40016;1316761;480655;1797416
2022.01_13-10-2022;Иркутская область;75_90_days;SputnikV;76696;14603;91299;1316761;480655;1797416
2022.01_13-10-2022;Иркутская область;90_105_days;AllVaccines;45894;16768;62662;1316761;480655;1797416
2022.01_13-10-2022;Иркутская область;90_105_days;CoviVac;1089;206;1295;1316761;480655;1797416
2022.01_13-10-2022;Иркутская область;90_105_days;EpiVacCorona;1524;475;1999;1316761;480655;1797416
2022.01_13-10-2022;Иркутская область;90_105_days;SputnikLite;10889;7405;18294;1316761;480655;1797416
2022.01_13-10-2022;Иркутская область;90_105_days;SputnikV;32392;8682;41074;1316761;480655;1797416
2022.01_13-10-2022;Кабардино-Балкарская Республика;105_165_days;AllVaccines;36514;11146;47660;502388;159241;661629
2022.01_13-10-2022;Кабардино-Балкарская Республика;105_165_days;CoviVac;228;72;300;502388;159241;661629
2022.01_13-10-2022;Кабардино-Балкарская Республика;105_165_days;EpiVacCorona;108;51;159;502388;159241;661629
2022.01_13-10-2022;Кабардино-Балкарская Республика;105_165_days;SputnikLite;23571;6902;30473;502388;159241;661629
2022.01_13-10-2022;Кабардино-Балкарская Республика;105_165_days;SputnikV;12607;4121;16728;502388;159241;661629
2022.01_13-10-2022;Кабардино-Балкарская Республика;165_195_days;AllVaccines;45843;9720;55563;502388;159241;661629
2022.01_13-10-2022;Кабардино-Балкарская Республика;165_195_days;CoviVac;319;47;366;502388;159241;661629
2022.01_13-10-2022;Кабардино-Балкарская Республика;165_195_days;EpiVacCorona;911;198;1109;502388;159241;661629
2022.01_13-10-2022;Кабардино-Балкарская Республика;165_195_days;SputnikLite;8738;1671;10409;502388;159241;661629
2022.01_13-10-2022;Кабардино-Балкарская Республика;165_195_days;SputnikV;35875;7804;43679;502388;159241;661629
2022.01_13-10-2022;Кабардино-Балкарская Республика;21_45_days;AllVaccines;12515;4730;17245;502388;159241;661629
2022.01_13-10-2022;Кабардино-Балкарская Республика;21_45_days;CoviVac;80;35;115;502388;159241;661629
2022.01_13-10-2022;Кабардино-Балкарская Республика;21_45_days;EpiVacCorona;748;189;937;502388;159241;661629
2022.01_13-10-2022;Кабардино-Балкарская Республика;21_45_days;SputnikLite;8744;3422;12166;502388;159241;661629
2022.01_13-10-2022;Кабардино-Балкарская Республика;21_45_days;SputnikV;2943;1084;4027;502388;159241;661629
2022.01_13-10-2022;Кабардино-Балкарская Республика;45_75_days;AllVaccines;18495;6620;25115;502388;159241;661629
2022.01_13-10-2022;Кабардино-Балкарская Республика;45_75_days;CoviVac;177;50;227;502388;159241;661629
2022.01_13-10-2022;Кабардино-Балкарская Республика;45_75_days;EpiVacCorona;906;257;1163;502388;159241;661629
2022.01_13-10-2022;Кабардино-Балкарская Республика;45_75_days;SputnikLite;9019;2823;11842;502388;159241;661629
2022.01_13-10-2022;Кабардино-Балкарская Республика;45_75_days;SputnikV;8393;3490;11883;502388;159241;661629
2022.01_13-10-2022;Кабардино-Балкарская Республика;75_90_days;AllVaccines;13486;4088;17574;502388;159241;661629
2022.01_13-10-2022;Кабардино-Балкарская Республика;75_90_days;CoviVac;73;15;88;502388;159241;661629
2022.01_13-10-2022;Кабардино-Балкарская Республика;75_90_days;EpiVacCorona;470;120;590;502388;159241;661629
2022.01_13-10-2022;Кабардино-Балкарская Республика;75_90_days;SputnikLite;5639;1834;7473;502388;159241;661629
2022.01_13-10-2022;Кабардино-Балкарская Республика;75_90_days;SputnikV;7304;2119;9423;502388;159241;661629
2022.01_13-10-2022;Кабардино-Балкарская Республика;90_105_days;AllVaccines;18053;5349;23402;502388;159241;661629
2022.01_13-10-2022;Кабардино-Балкарская Республика;90_105_days;CoviVac;85;25;110;502388;159241;661629
2022.01_13-10-2022;Кабардино-Балкарская Республика;90_105_days;EpiVacCorona;132;36;168;502388;159241;661629
2022.01_13-10-2022;Кабардино-Балкарская Республика;90_105_days;SputnikLite;13394;3528;16922;502388;159241;661629
2022.01_13-10-2022;Кабардино-Балкарская Республика;90_105_days;SputnikV;4442;1760;6202;502388;159241;661629
2022.01_13-10-2022;Калининградская область;105_165_days;AllVaccines;70817;27586;98403;585700;231702;817402
2022.01_13-10-2022;Калининградская область;105_165_days;CoviVac;529;134;663;585700;231702;817402
2022.01_13-10-2022;Калининградская область;105_165_days;EpiVacCorona;1143;409;1552;585700;231702;817402
2022.01_13-10-2022;Калининградская область;105_165_days;SputnikLite;40727;15785;56512;585700;231702;817402
2022.01_13-10-2022;Калининградская область;105_165_days;SputnikV;28418;11258;39676;585700;231702;817402
2022.01_13-10-2022;Калининградская область;165_195_days;AllVaccines;63857;11739;75596;585700;231702;817402
2022.01_13-10-2022;Калининградская область;165_195_days;CoviVac;259;48;307;585700;231702;817402
2022.01_13-10-2022;Калининградская область;165_195_days;EpiVacCorona;7417;1419;8836;585700;231702;817402
2022.01_13-10-2022;Калининградская область;165_195_days;SputnikLite;19190;3083;22273;585700;231702;817402
2022.01_13-10-2022;Калининградская область;165_195_days;SputnikV;36991;7189;44180;585700;231702;817402
2022.01_13-10-2022;Калининградская область;21_45_days;AllVaccines;20656;11434;32090;585700;231702;817402
2022.01_13-10-2022;Калининградская область;21_45_days;CoviVac;295;88;383;585700;231702;817402
2022.01_13-10-2022;Калининградская область;21_45_days;EpiVacCorona;680;320;1000;585700;231702;817402
2022.01_13-10-2022;Калининградская область;21_45_days;SputnikLite;11844;7820;19664;585700;231702;817402
2022.01_13-10-2022;Калининградская область;21_45_days;SputnikV;7837;3206;11043;585700;231702;817402
2022.01_13-10-2022;Калининградская область;45_75_days;AllVaccines;50785;26028;76813;585700;231702;817402
2022.01_13-10-2022;Калининградская область;45_75_days;CoviVac;997;276;1273;585700;231702;817402
2022.01_13-10-2022;Калининградская область;45_75_days;EpiVacCorona;1524;498;2022;585700;231702;817402
2022.01_13-10-2022;Калининградская область;45_75_days;SputnikLite;11214;10250;21464;585700;231702;817402
2022.01_13-10-2022;Калининградская область;45_75_days;SputnikV;37050;15004;52054;585700;231702;817402
2022.01_13-10-2022;Калининградская область;75_90_days;AllVaccines;32594;17243;49837;585700;231702;817402
2022.01_13-10-2022;Калининградская область;75_90_days;CoviVac;547;97;644;585700;231702;817402
2022.01_13-10-2022;Калининградская область;75_90_days;EpiVacCorona;977;347;1324;585700;231702;817402
2022.01_13-10-2022;Калининградская область;75_90_days;SputnikLite;6858;6798;13656;585700;231702;817402
2022.01_13-10-2022;Калининградская область;75_90_days;SputnikV;24212;10001;34213;585700;231702;817402
2022.01_13-10-2022;Калининградская область;90_105_days;AllVaccines;28577;12123;40700;585700;231702;817402
2022.01_13-10-2022;Калининградская область;90_105_days;CoviVac;170;56;226;585700;231702;817402
2022.01_13-10-2022;Калининградская область;90_105_days;EpiVacCorona;895;348;1243;585700;231702;817402
2022.01_13-10-2022;Калининградская область;90_105_days;SputnikLite;4912;4068;8980;585700;231702;817402
2022.01_13-10-2022;Калининградская область;90_105_days;SputnikV;22600;7651;30251;585700;231702;817402
2022.01_13-10-2022;Калужская область;105_165_days;AllVaccines;56504;25338;81842;559789;253023;812812
2022.01_13-10-2022;Калужская область;105_165_days;CoviVac;545;122;667;559789;253023;812812
2022.01_13-10-2022;Калужская область;105_165_days;EpiVacCorona;1181;615;1796;559789;253023;812812
2022.01_13-10-2022;Калужская область;105_165_days;SputnikLite;34954;17023;51977;559789;253023;812812
2022.01_13-10-2022;Калужская область;105_165_days;SputnikV;19824;7578;27402;559789;253023;812812
2022.01_13-10-2022;Калужская область;165_195_days;AllVaccines;48297;12552;60849;559789;253023;812812
2022.01_13-10-2022;Калужская область;165_195_days;CoviVac;266;48;314;559789;253023;812812
2022.01_13-10-2022;Калужская область;165_195_days;EpiVacCorona;2059;696;2755;559789;253023;812812
2022.01_13-10-2022;Калужская область;165_195_days;SputnikLite;7526;2888;10414;559789;253023;812812
2022.01_13-10-2022;Калужская область;165_195_days;SputnikV;38446;8920;47366;559789;253023;812812
2022.01_13-10-2022;Калужская область;21_45_days;AllVaccines;18611;10364;28975;559789;253023;812812
2022.01_13-10-2022;Калужская область;21_45_days;CoviVac;123;40;163;559789;253023;812812
2022.01_13-10-2022;Калужская область;21_45_days;EpiVacCorona;497;266;763;559789;253023;812812
2022.01_13-10-2022;Калужская область;21_45_days;SputnikLite;9711;7180;16891;559789;253023;812812
2022.01_13-10-2022;Калужская область;21_45_days;SputnikV;8280;2878;11158;559789;253023;812812
2022.01_13-10-2022;Калужская область;45_75_days;AllVaccines;67917;25893;93810;559789;253023;812812
2022.01_13-10-2022;Калужская область;45_75_days;CoviVac;495;126;621;559789;253023;812812
2022.01_13-10-2022;Калужская область;45_75_days;EpiVacCorona;2645;992;3637;559789;253023;812812
2022.01_13-10-2022;Калужская область;45_75_days;SputnikLite;12119;9295;21414;559789;253023;812812
2022.01_13-10-2022;Калужская область;45_75_days;SputnikV;52658;15480;68138;559789;253023;812812
2022.01_13-10-2022;Калужская область;75_90_days;AllVaccines;56768;17001;73769;559789;253023;812812
2022.01_13-10-2022;Калужская область;75_90_days;CoviVac;1503;344;1847;559789;253023;812812
2022.01_13-10-2022;Калужская область;75_90_days;EpiVacCorona;2110;600;2710;559789;253023;812812
2022.01_13-10-2022;Калужская область;75_90_days;SputnikLite;7357;5750;13107;559789;253023;812812
2022.01_13-10-2022;Калужская область;75_90_days;SputnikV;45798;10307;56105;559789;253023;812812
2022.01_13-10-2022;Калужская область;90_105_days;AllVaccines;23205;8591;31796;559789;253023;812812
2022.01_13-10-2022;Калужская область;90_105_days;CoviVac;971;244;1215;559789;253023;812812
2022.01_13-10-2022;Калужская область;90_105_days;EpiVacCorona;1356;505;1861;559789;253023;812812
2022.01_13-10-2022;Калужская область;90_105_days;SputnikLite;5101;2330;7431;559789;253023;812812
2022.01_13-10-2022;Калужская область;90_105_days;SputnikV;15777;5512;21289;559789;253023;812812
2022.01_13-10-2022;Камчатский край;105_165_days;AllVaccines;18306;5436;23742;189425;56856;246281
2022.01_13-10-2022;Камчатский край;105_165_days;CoviVac;20;7;27;189425;56856;246281
2022.01_13-10-2022;Камчатский край;105_165_days;EpiVacCorona;1141;259;1400;189425;56856;246281
2022.01_13-10-2022;Камчатский край;105_165_days;SputnikLite;8975;3558;12533;189425;56856;246281
2022.01_13-10-2022;Камчатский край;105_165_days;SputnikV;8170;1612;9782;189425;56856;246281
2022.01_13-10-2022;Камчатский край;165_195_days;AllVaccines;16651;3038;19689;189425;56856;246281
2022.01_13-10-2022;Камчатский край;165_195_days;CoviVac;36;14;50;189425;56856;246281
2022.01_13-10-2022;Камчатский край;165_195_days;EpiVacCorona;985;191;1176;189425;56856;246281
2022.01_13-10-2022;Камчатский край;165_195_days;SputnikLite;3284;604;3888;189425;56856;246281
2022.01_13-10-2022;Камчатский край;165_195_days;SputnikV;12346;2229;14575;189425;56856;246281
2022.01_13-10-2022;Камчатский край;21_45_days;AllVaccines;4902;1688;6590;189425;56856;246281
2022.01_13-10-2022;Камчатский край;21_45_days;CoviVac;15;3;18;189425;56856;246281
2022.01_13-10-2022;Камчатский край;21_45_days;EpiVacCorona;126;57;183;189425;56856;246281
2022.01_13-10-2022;Камчатский край;21_45_days;SputnikLite;3128;1324;4452;189425;56856;246281
2022.01_13-10-2022;Камчатский край;21_45_days;SputnikV;1633;304;1937;189425;56856;246281
2022.01_13-10-2022;Камчатский край;45_75_days;AllVaccines;14910;4166;19076;189425;56856;246281
2022.01_13-10-2022;Камчатский край;45_75_days;CoviVac;206;51;257;189425;56856;246281
2022.01_13-10-2022;Камчатский край;45_75_days;EpiVacCorona;460;179;639;189425;56856;246281
2022.01_13-10-2022;Камчатский край;45_75_days;SputnikLite;5612;2002;7614;189425;56856;246281
2022.01_13-10-2022;Камчатский край;45_75_days;SputnikV;8632;1934;10566;189425;56856;246281
2022.01_13-10-2022;Камчатский край;75_90_days;AllVaccines;8972;2629;11601;189425;56856;246281
2022.01_13-10-2022;Камчатский край;75_90_days;CoviVac;166;25;191;189425;56856;246281
2022.01_13-10-2022;Камчатский край;75_90_days;EpiVacCorona;315;91;406;189425;56856;246281
2022.01_13-10-2022;Камчатский край;75_90_days;SputnikLite;3815;1553;5368;189425;56856;246281
2022.01_13-10-2022;Камчатский край;75_90_days;SputnikV;4676;960;5636;189425;56856;246281
2022.01_13-10-2022;Камчатский край;90_105_days;AllVaccines;7912;2670;10582;189425;56856;246281
2022.01_13-10-2022;Камчатский край;90_105_days;CoviVac;63;9;72;189425;56856;246281
2022.01_13-10-2022;Камчатский край;90_105_days;EpiVacCorona;148;40;188;189425;56856;246281
2022.01_13-10-2022;Камчатский край;90_105_days;SputnikLite;5751;1996;7747;189425;56856;246281
2022.01_13-10-2022;Камчатский край;90_105_days;SputnikV;1950;625;2575;189425;56856;246281
2022.01_13-10-2022;Карачаево-Черкесская Республика;105_165_days;AllVaccines;17144;5884;23028;266261;94005;360266
2022.01_13-10-2022;Карачаево-Черкесская Республика;105_165_days;CoviVac;98;35;133;266261;94005;360266
2022.01_13-10-2022;Карачаево-Черкесская Республика;105_165_days;EpiVacCorona;425;54;479;266261;94005;360266
2022.01_13-10-2022;Карачаево-Черкесская Республика;105_165_days;SputnikLite;8423;3279;11702;266261;94005;360266
2022.01_13-10-2022;Карачаево-Черкесская Республика;105_165_days;SputnikV;8198;2516;10714;266261;94005;360266
2022.01_13-10-2022;Карачаево-Черкесская Республика;165_195_days;AllVaccines;21705;4324;26029;266261;94005;360266
2022.01_13-10-2022;Карачаево-Черкесская Республика;165_195_days;CoviVac;362;85;447;266261;94005;360266
2022.01_13-10-2022;Карачаево-Черкесская Республика;165_195_days;EpiVacCorona;1308;170;1478;266261;94005;360266
2022.01_13-10-2022;Карачаево-Черкесская Республика;165_195_days;SputnikLite;5145;1108;6253;266261;94005;360266
2022.01_13-10-2022;Карачаево-Черкесская Республика;165_195_days;SputnikV;14890;2961;17851;266261;94005;360266
2022.01_13-10-2022;Карачаево-Черкесская Республика;21_45_days;AllVaccines;8290;2875;11165;266261;94005;360266
2022.01_13-10-2022;Карачаево-Черкесская Республика;21_45_days;CoviVac;62;20;82;266261;94005;360266
2022.01_13-10-2022;Карачаево-Черкесская Республика;21_45_days;EpiVacCorona;488;129;617;266261;94005;360266
2022.01_13-10-2022;Карачаево-Черкесская Республика;21_45_days;SputnikLite;4916;1907;6823;266261;94005;360266
2022.01_13-10-2022;Карачаево-Черкесская Республика;21_45_days;SputnikV;2824;819;3643;266261;94005;360266
2022.01_13-10-2022;Карачаево-Черкесская Республика;45_75_days;AllVaccines;12239;4220;16459;266261;94005;360266
2022.01_13-10-2022;Карачаево-Черкесская Республика;45_75_days;CoviVac;121;46;167;266261;94005;360266
2022.01_13-10-2022;Карачаево-Черкесская Республика;45_75_days;EpiVacCorona;231;74;305;266261;94005;360266
2022.01_13-10-2022;Карачаево-Черкесская Республика;45_75_days;SputnikLite;7030;2291;9321;266261;94005;360266
2022.01_13-10-2022;Карачаево-Черкесская Республика;45_75_days;SputnikV;4857;1809;6666;266261;94005;360266
2022.01_13-10-2022;Карачаево-Черкесская Республика;75_90_days;AllVaccines;7603;2757;10360;266261;94005;360266
2022.01_13-10-2022;Карачаево-Черкесская Республика;75_90_days;CoviVac;34;9;43;266261;94005;360266
2022.01_13-10-2022;Карачаево-Черкесская Республика;75_90_days;EpiVacCorona;50;15;65;266261;94005;360266
2022.01_13-10-2022;Карачаево-Черкесская Республика;75_90_days;SputnikLite;4917;1659;6576;266261;94005;360266
2022.01_13-10-2022;Карачаево-Черкесская Республика;75_90_days;SputnikV;2602;1074;3676;266261;94005;360266
2022.01_13-10-2022;Карачаево-Черкесская Республика;90_105_days;AllVaccines;7666;2973;10639;266261;94005;360266
2022.01_13-10-2022;Карачаево-Черкесская Республика;90_105_days;CoviVac;5;6;11;266261;94005;360266
2022.01_13-10-2022;Карачаево-Черкесская Республика;90_105_days;EpiVacCorona;45;18;63;266261;94005;360266
2022.01_13-10-2022;Карачаево-Черкесская Республика;90_105_days;SputnikLite;5684;1763;7447;266261;94005;360266
2022.01_13-10-2022;Карачаево-Черкесская Республика;90_105_days;SputnikV;1932;1186;3118;266261;94005;360266
2022.01_13-10-2022;Кемеровская область;105_165_days;AllVaccines;104403;46193;150596;1453976;610256;2064232
2022.01_13-10-2022;Кемеровская область;105_165_days;CoviVac;1842;386;2228;1453976;610256;2064232
2022.01_13-10-2022;Кемеровская область;105_165_days;EpiVacCorona;1137;419;1556;1453976;610256;2064232
2022.01_13-10-2022;Кемеровская область;105_165_days;SputnikLite;23317;25509;48826;1453976;610256;2064232
2022.01_13-10-2022;Кемеровская область;105_165_days;SputnikV;78107;19879;97986;1453976;610256;2064232
2022.01_13-10-2022;Кемеровская область;165_195_days;AllVaccines;147970;27320;175290;1453976;610256;2064232
2022.01_13-10-2022;Кемеровская область;165_195_days;CoviVac;666;115;781;1453976;610256;2064232
2022.01_13-10-2022;Кемеровская область;165_195_days;EpiVacCorona;1463;449;1912;1453976;610256;2064232
2022.01_13-10-2022;Кемеровская область;165_195_days;SputnikLite;4722;2031;6753;1453976;610256;2064232
2022.01_13-10-2022;Кемеровская область;165_195_days;SputnikV;141119;24725;165844;1453976;610256;2064232
2022.01_13-10-2022;Кемеровская область;21_45_days;AllVaccines;60815;27602;88417;1453976;610256;2064232
2022.01_13-10-2022;Кемеровская область;21_45_days;CoviVac;308;85;393;1453976;610256;2064232
2022.01_13-10-2022;Кемеровская область;21_45_days;EpiVacCorona;4510;2647;7157;1453976;610256;2064232
2022.01_13-10-2022;Кемеровская область;21_45_days;SputnikLite;35135;17556;52691;1453976;610256;2064232
2022.01_13-10-2022;Кемеровская область;21_45_days;SputnikV;20862;7314;28176;1453976;610256;2064232
2022.01_13-10-2022;Кемеровская область;45_75_days;AllVaccines;140511;58495;199006;1453976;610256;2064232
2022.01_13-10-2022;Кемеровская область;45_75_days;CoviVac;1462;304;1766;1453976;610256;2064232
2022.01_13-10-2022;Кемеровская область;45_75_days;EpiVacCorona;5241;2103;7344;1453976;610256;2064232
2022.01_13-10-2022;Кемеровская область;45_75_days;SputnikLite;25038;19770;44808;1453976;610256;2064232
2022.01_13-10-2022;Кемеровская область;45_75_days;SputnikV;108770;36318;145088;1453976;610256;2064232
2022.01_13-10-2022;Кемеровская область;75_90_days;AllVaccines;45194;25785;70979;1453976;610256;2064232
2022.01_13-10-2022;Кемеровская область;75_90_days;CoviVac;981;152;1133;1453976;610256;2064232
2022.01_13-10-2022;Кемеровская область;75_90_days;EpiVacCorona;2434;1255;3689;1453976;610256;2064232
2022.01_13-10-2022;Кемеровская область;75_90_days;SputnikLite;12045;11217;23262;1453976;610256;2064232
2022.01_13-10-2022;Кемеровская область;75_90_days;SputnikV;29734;13161;42895;1453976;610256;2064232
2022.01_13-10-2022;Кемеровская область;90_105_days;AllVaccines;32187;20669;52856;1453976;610256;2064232
2022.01_13-10-2022;Кемеровская область;90_105_days;CoviVac;471;104;575;1453976;610256;2064232
2022.01_13-10-2022;Кемеровская область;90_105_days;EpiVacCorona;1027;650;1677;1453976;610256;2064232
2022.01_13-10-2022;Кемеровская область;90_105_days;SputnikLite;11357;9795;21152;1453976;610256;2064232
2022.01_13-10-2022;Кемеровская область;90_105_days;SputnikV;19332;10120;29452;1453976;610256;2064232
2022.01_13-10-2022;Кировская область;105_165_days;AllVaccines;68318;39111;107429;663621;334585;998206
2022.01_13-10-2022;Кировская область;105_165_days;CoviVac;798;92;890;663621;334585;998206
2022.01_13-10-2022;Кировская область;105_165_days;EpiVacCorona;428;187;615;663621;334585;998206
2022.01_13-10-2022;Кировская область;105_165_days;SputnikLite;54760;28840;83600;663621;334585;998206
2022.01_13-10-2022;Кировская область;105_165_days;SputnikV;12332;9992;22324;663621;334585;998206
2022.01_13-10-2022;Кировская область;165_195_days;AllVaccines;48558;15818;64376;663621;334585;998206
2022.01_13-10-2022;Кировская область;165_195_days;CoviVac;236;19;255;663621;334585;998206
2022.01_13-10-2022;Кировская область;165_195_days;EpiVacCorona;841;306;1147;663621;334585;998206
2022.01_13-10-2022;Кировская область;165_195_days;SputnikLite;15917;3330;19247;663621;334585;998206
2022.01_13-10-2022;Кировская область;165_195_days;SputnikV;31564;12163;43727;663621;334585;998206
2022.01_13-10-2022;Кировская область;21_45_days;AllVaccines;26783;17534;44317;663621;334585;998206
2022.01_13-10-2022;Кировская область;21_45_days;CoviVac;398;83;481;663621;334585;998206
2022.01_13-10-2022;Кировская область;21_45_days;EpiVacCorona;1102;567;1669;663621;334585;998206
2022.01_13-10-2022;Кировская область;21_45_days;SputnikLite;19134;12616;31750;663621;334585;998206
2022.01_13-10-2022;Кировская область;21_45_days;SputnikV;6149;4268;10417;663621;334585;998206
2022.01_13-10-2022;Кировская область;45_75_days;AllVaccines;66180;40446;106626;663621;334585;998206
2022.01_13-10-2022;Кировская область;45_75_days;CoviVac;1186;167;1353;663621;334585;998206
2022.01_13-10-2022;Кировская область;45_75_days;EpiVacCorona;3452;1432;4884;663621;334585;998206
2022.01_13-10-2022;Кировская область;45_75_days;SputnikLite;20345;14331;34676;663621;334585;998206
2022.01_13-10-2022;Кировская область;45_75_days;SputnikV;41197;24516;65713;663621;334585;998206
2022.01_13-10-2022;Кировская область;75_90_days;AllVaccines;59579;30482;90061;663621;334585;998206
2022.01_13-10-2022;Кировская область;75_90_days;CoviVac;1797;190;1987;663621;334585;998206
2022.01_13-10-2022;Кировская область;75_90_days;EpiVacCorona;2567;936;3503;663621;334585;998206
2022.01_13-10-2022;Кировская область;75_90_days;SputnikLite;21259;13534;34793;663621;334585;998206
2022.01_13-10-2022;Кировская область;75_90_days;SputnikV;33956;15822;49778;663621;334585;998206
2022.01_13-10-2022;Кировская область;90_105_days;AllVaccines;31908;18049;49957;663621;334585;998206
2022.01_13-10-2022;Кировская область;90_105_days;CoviVac;1144;119;1263;663621;334585;998206
2022.01_13-10-2022;Кировская область;90_105_days;EpiVacCorona;1481;549;2030;663621;334585;998206
2022.01_13-10-2022;Кировская область;90_105_days;SputnikLite;14523;8976;23499;663621;334585;998206
2022.01_13-10-2022;Кировская область;90_105_days;SputnikV;14760;8405;23165;663621;334585;998206
2022.01_13-10-2022;Костромская область;105_165_days;AllVaccines;36289;17725;54014;339046;160543;499589
2022.01_13-10-2022;Костромская область;105_165_days;CoviVac;51;16;67;339046;160543;499589
2022.01_13-10-2022;Костромская область;105_165_days;EpiVacCorona;27;17;44;339046;160543;499589
2022.01_13-10-2022;Костромская область;105_165_days;SputnikLite;24458;12212;36670;339046;160543;499589
2022.01_13-10-2022;Костромская область;105_165_days;SputnikV;11753;5480;17233;339046;160543;499589
2022.01_13-10-2022;Костромская область;165_195_days;AllVaccines;39511;8577;48088;339046;160543;499589
2022.01_13-10-2022;Костромская область;165_195_days;CoviVac;427;47;474;339046;160543;499589
2022.01_13-10-2022;Костромская область;165_195_days;EpiVacCorona;2;0;2;339046;160543;499589
2022.01_13-10-2022;Костромская область;165_195_days;SputnikLite;9061;1696;10757;339046;160543;499589
2022.01_13-10-2022;Костромская область;165_195_days;SputnikV;30021;6834;36855;339046;160543;499589
2022.01_13-10-2022;Костромская область;21_45_days;AllVaccines;7564;4463;12027;339046;160543;499589
2022.01_13-10-2022;Костромская область;21_45_days;CoviVac;128;29;157;339046;160543;499589
2022.01_13-10-2022;Костромская область;21_45_days;EpiVacCorona;645;293;938;339046;160543;499589
2022.01_13-10-2022;Костромская область;21_45_days;SputnikLite;4488;3110;7598;339046;160543;499589
2022.01_13-10-2022;Костромская область;21_45_days;SputnikV;2303;1031;3334;339046;160543;499589
2022.01_13-10-2022;Костромская область;45_75_days;AllVaccines;29190;15091;44281;339046;160543;499589
2022.01_13-10-2022;Костромская область;45_75_days;CoviVac;288;81;369;339046;160543;499589
2022.01_13-10-2022;Костромская область;45_75_days;EpiVacCorona;3770;1420;5190;339046;160543;499589
2022.01_13-10-2022;Костромская область;45_75_days;SputnikLite;11821;6499;18320;339046;160543;499589
2022.01_13-10-2022;Костромская область;45_75_days;SputnikV;13311;7091;20402;339046;160543;499589
2022.01_13-10-2022;Костромская область;75_90_days;AllVaccines;17284;10133;27417;339046;160543;499589
2022.01_13-10-2022;Костромская область;75_90_days;CoviVac;358;91;449;339046;160543;499589
2022.01_13-10-2022;Костромская область;75_90_days;EpiVacCorona;1034;466;1500;339046;160543;499589
2022.01_13-10-2022;Костромская область;75_90_days;SputnikLite;8411;5170;13581;339046;160543;499589
2022.01_13-10-2022;Костромская область;75_90_days;SputnikV;7481;4406;11887;339046;160543;499589
2022.01_13-10-2022;Костромская область;90_105_days;AllVaccines;18971;8666;27637;339046;160543;499589
2022.01_13-10-2022;Костромская область;90_105_days;CoviVac;477;145;622;339046;160543;499589
2022.01_13-10-2022;Костромская область;90_105_days;EpiVacCorona;185;125;310;339046;160543;499589
2022.01_13-10-2022;Костромская область;90_105_days;SputnikLite;13156;5094;18250;339046;160543;499589
2022.01_13-10-2022;Костромская область;90_105_days;SputnikV;5153;3302;8455;339046;160543;499589
2022.01_13-10-2022;Краснодарский край;105_165_days;AllVaccines;269516;144511;414027;3157155;1334085;4491240
2022.01_13-10-2022;Краснодарский край;105_165_days;CoviVac;5015;1497;6512;3157155;1334085;4491240
2022.01_13-10-2022;Краснодарский край;105_165_days;EpiVacCorona;5354;2628;7982;3157155;1334085;4491240
2022.01_13-10-2022;Краснодарский край;105_165_days;SputnikLite;42060;56319;98379;3157155;1334085;4491240
2022.01_13-10-2022;Краснодарский край;105_165_days;SputnikV;217087;84067;301154;3157155;1334085;4491240
2022.01_13-10-2022;Краснодарский край;165_195_days;AllVaccines;432753;80254;513007;3157155;1334085;4491240
2022.01_13-10-2022;Краснодарский край;165_195_days;CoviVac;3330;715;4045;3157155;1334085;4491240
2022.01_13-10-2022;Краснодарский край;165_195_days;EpiVacCorona;2022;654;2676;3157155;1334085;4491240
2022.01_13-10-2022;Краснодарский край;165_195_days;SputnikLite;10007;7606;17613;3157155;1334085;4491240
2022.01_13-10-2022;Краснодарский край;165_195_days;SputnikV;417394;71279;488673;3157155;1334085;4491240
2022.01_13-10-2022;Краснодарский край;21_45_days;AllVaccines;115417;62264;177681;3157155;1334085;4491240
2022.01_13-10-2022;Краснодарский край;21_45_days;CoviVac;621;196;817;3157155;1334085;4491240
2022.01_13-10-2022;Краснодарский край;21_45_days;EpiVacCorona;2077;1132;3209;3157155;1334085;4491240
2022.01_13-10-2022;Краснодарский край;21_45_days;SputnikLite;51334;30581;81915;3157155;1334085;4491240
2022.01_13-10-2022;Краснодарский край;21_45_days;SputnikV;61385;30355;91740;3157155;1334085;4491240
2022.01_13-10-2022;Краснодарский край;45_75_days;AllVaccines;325713;152055;477768;3157155;1334085;4491240
2022.01_13-10-2022;Краснодарский край;45_75_days;CoviVac;2012;674;2686;3157155;1334085;4491240
2022.01_13-10-2022;Краснодарский край;45_75_days;EpiVacCorona;5643;2824;8467;3157155;1334085;4491240
2022.01_13-10-2022;Краснодарский край;45_75_days;SputnikLite;50270;45678;95948;3157155;1334085;4491240
2022.01_13-10-2022;Краснодарский край;45_75_days;SputnikV;267788;102879;370667;3157155;1334085;4491240
2022.01_13-10-2022;Краснодарский край;75_90_days;AllVaccines;157372;73169;230541;3157155;1334085;4491240
2022.01_13-10-2022;Краснодарский край;75_90_days;CoviVac;1680;476;2156;3157155;1334085;4491240
2022.01_13-10-2022;Краснодарский край;75_90_days;EpiVacCorona;2787;1555;4342;3157155;1334085;4491240
2022.01_13-10-2022;Краснодарский край;75_90_days;SputnikLite;28176;27232;55408;3157155;1334085;4491240
2022.01_13-10-2022;Краснодарский край;75_90_days;SputnikV;124729;43906;168635;3157155;1334085;4491240
2022.01_13-10-2022;Краснодарский край;90_105_days;AllVaccines;100503;51654;152157;3157155;1334085;4491240
2022.01_13-10-2022;Краснодарский край;90_105_days;CoviVac;2025;656;2681;3157155;1334085;4491240
2022.01_13-10-2022;Краснодарский край;90_105_days;EpiVacCorona;2370;1262;3632;3157155;1334085;4491240
2022.01_13-10-2022;Краснодарский край;90_105_days;SputnikLite;12783;15906;28689;3157155;1334085;4491240
2022.01_13-10-2022;Краснодарский край;90_105_days;SputnikV;83325;33830;117155;3157155;1334085;4491240
2022.01_13-10-2022;Красноярский край;105_165_days;AllVaccines;180087;57306;237393;1637377;585822;2223199
2022.01_13-10-2022;Красноярский край;105_165_days;CoviVac;2403;398;2801;1637377;585822;2223199
2022.01_13-10-2022;Красноярский край;105_165_days;EpiVacCorona;2133;906;3039;1637377;585822;2223199
2022.01_13-10-2022;Красноярский край;105_165_days;SputnikLite;96378;32522;128900;1637377;585822;2223199
2022.01_13-10-2022;Красноярский край;105_165_days;SputnikV;79173;23480;102653;1637377;585822;2223199
2022.01_13-10-2022;Красноярский край;165_195_days;AllVaccines;205506;35658;241164;1637377;585822;2223199
2022.01_13-10-2022;Красноярский край;165_195_days;CoviVac;2176;226;2402;1637377;585822;2223199
2022.01_13-10-2022;Красноярский край;165_195_days;EpiVacCorona;5627;1764;7391;1637377;585822;2223199
2022.01_13-10-2022;Красноярский край;165_195_days;SputnikLite;67396;5921;73317;1637377;585822;2223199
2022.01_13-10-2022;Красноярский край;165_195_days;SputnikV;130307;27747;158054;1637377;585822;2223199
2022.01_13-10-2022;Красноярский край;21_45_days;AllVaccines;71941;30279;102220;1637377;585822;2223199
2022.01_13-10-2022;Красноярский край;21_45_days;CoviVac;593;137;730;1637377;585822;2223199
2022.01_13-10-2022;Красноярский край;21_45_days;EpiVacCorona;2213;1242;3455;1637377;585822;2223199
2022.01_13-10-2022;Красноярский край;21_45_days;SputnikLite;39353;19971;59324;1637377;585822;2223199
2022.01_13-10-2022;Красноярский край;21_45_days;SputnikV;29782;8929;38711;1637377;585822;2223199
2022.01_13-10-2022;Красноярский край;45_75_days;AllVaccines;169820;64778;234598;1637377;585822;2223199
2022.01_13-10-2022;Красноярский край;45_75_days;CoviVac;1814;423;2237;1637377;585822;2223199
2022.01_13-10-2022;Красноярский край;45_75_days;EpiVacCorona;7462;3849;11311;1637377;585822;2223199
2022.01_13-10-2022;Красноярский край;45_75_days;SputnikLite;41835;23368;65203;1637377;585822;2223199
2022.01_13-10-2022;Красноярский край;45_75_days;SputnikV;118709;37138;155847;1637377;585822;2223199
2022.01_13-10-2022;Красноярский край;75_90_days;AllVaccines;82609;35414;118023;1637377;585822;2223199
2022.01_13-10-2022;Красноярский край;75_90_days;CoviVac;1370;349;1719;1637377;585822;2223199
2022.01_13-10-2022;Красноярский край;75_90_days;EpiVacCorona;3728;1895;5623;1637377;585822;2223199
2022.01_13-10-2022;Красноярский край;75_90_days;SputnikLite;26424;15360;41784;1637377;585822;2223199
2022.01_13-10-2022;Красноярский край;75_90_days;SputnikV;51087;17810;68897;1637377;585822;2223199
2022.01_13-10-2022;Красноярский край;90_105_days;AllVaccines;39734;17260;56994;1637377;585822;2223199
2022.01_13-10-2022;Красноярский край;90_105_days;CoviVac;875;171;1046;1637377;585822;2223199
2022.01_13-10-2022;Красноярский край;90_105_days;EpiVacCorona;1433;850;2283;1637377;585822;2223199
2022.01_13-10-2022;Красноярский край;90_105_days;SputnikLite;16110;4762;20872;1637377;585822;2223199
2022.01_13-10-2022;Красноярский край;90_105_days;SputnikV;21316;11477;32793;1637377;585822;2223199
2022.01_13-10-2022;Курганская область;105_165_days;AllVaccines;51213;24792;76005;425081;217502;642583
2022.01_13-10-2022;Курганская область;105_165_days;CoviVac;351;97;448;425081;217502;642583
2022.01_13-10-2022;Курганская область;105_165_days;EpiVacCorona;95;74;169;425081;217502;642583
2022.01_13-10-2022;Курганская область;105_165_days;SputnikLite;30758;17636;48394;425081;217502;642583
2022.01_13-10-2022;Курганская область;105_165_days;SputnikV;20009;6985;26994;425081;217502;642583
2022.01_13-10-2022;Курганская область;165_195_days;AllVaccines;35590;13182;48772;425081;217502;642583
2022.01_13-10-2022;Курганская область;165_195_days;CoviVac;351;81;432;425081;217502;642583
2022.01_13-10-2022;Курганская область;165_195_days;EpiVacCorona;103;47;150;425081;217502;642583
2022.01_13-10-2022;Курганская область;165_195_days;SputnikLite;5482;3517;8999;425081;217502;642583
2022.01_13-10-2022;Курганская область;165_195_days;SputnikV;29654;9537;39191;425081;217502;642583
2022.01_13-10-2022;Курганская область;21_45_days;AllVaccines;20490;12888;33378;425081;217502;642583
2022.01_13-10-2022;Курганская область;21_45_days;CoviVac;129;43;172;425081;217502;642583
2022.01_13-10-2022;Курганская область;21_45_days;EpiVacCorona;1017;755;1772;425081;217502;642583
2022.01_13-10-2022;Курганская область;21_45_days;SputnikLite;13904;9387;23291;425081;217502;642583
2022.01_13-10-2022;Курганская область;21_45_days;SputnikV;5440;2703;8143;425081;217502;642583
2022.01_13-10-2022;Курганская область;45_75_days;AllVaccines;35282;21985;57267;425081;217502;642583
2022.01_13-10-2022;Курганская область;45_75_days;CoviVac;632;229;861;425081;217502;642583
2022.01_13-10-2022;Курганская область;45_75_days;EpiVacCorona;731;473;1204;425081;217502;642583
2022.01_13-10-2022;Курганская область;45_75_days;SputnikLite;10166;10551;20717;425081;217502;642583
2022.01_13-10-2022;Курганская область;45_75_days;SputnikV;23753;10732;34485;425081;217502;642583
2022.01_13-10-2022;Курганская область;75_90_days;AllVaccines;33244;15351;48595;425081;217502;642583
2022.01_13-10-2022;Курганская область;75_90_days;CoviVac;478;134;612;425081;217502;642583
2022.01_13-10-2022;Курганская область;75_90_days;EpiVacCorona;313;148;461;425081;217502;642583
2022.01_13-10-2022;Курганская область;75_90_days;SputnikLite;6108;6823;12931;425081;217502;642583
2022.01_13-10-2022;Курганская область;75_90_days;SputnikV;26345;8246;34591;425081;217502;642583
2022.01_13-10-2022;Курганская область;90_105_days;AllVaccines;38931;15641;54572;425081;217502;642583
2022.01_13-10-2022;Курганская область;90_105_days;CoviVac;680;218;898;425081;217502;642583
2022.01_13-10-2022;Курганская область;90_105_days;EpiVacCorona;455;147;602;425081;217502;642583
2022.01_13-10-2022;Курганская область;90_105_days;SputnikLite;6434;7517;13951;425081;217502;642583
2022.01_13-10-2022;Курганская область;90_105_days;SputnikV;31362;7759;39121;425081;217502;642583
2022.01_13-10-2022;Курская область;105_165_days;AllVaccines;71368;38123;109491;604409;285634;890043
2022.01_13-10-2022;Курская область;105_165_days;CoviVac;798;124;922;604409;285634;890043
2022.01_13-10-2022;Курская область;105_165_days;EpiVacCorona;586;304;890;604409;285634;890043
2022.01_13-10-2022;Курская область;105_165_days;SputnikLite;39089;26441;65530;604409;285634;890043
2022.01_13-10-2022;Курская область;105_165_days;SputnikV;30895;11254;42149;604409;285634;890043
2022.01_13-10-2022;Курская область;165_195_days;AllVaccines;82827;16901;99728;604409;285634;890043
2022.01_13-10-2022;Курская область;165_195_days;CoviVac;566;62;628;604409;285634;890043
2022.01_13-10-2022;Курская область;165_195_days;EpiVacCorona;1040;373;1413;604409;285634;890043
2022.01_13-10-2022;Курская область;165_195_days;SputnikLite;11538;3614;15152;604409;285634;890043
2022.01_13-10-2022;Курская область;165_195_days;SputnikV;69683;12852;82535;604409;285634;890043
2022.01_13-10-2022;Курская область;21_45_days;AllVaccines;22801;10995;33796;604409;285634;890043
2022.01_13-10-2022;Курская область;21_45_days;CoviVac;291;64;355;604409;285634;890043
2022.01_13-10-2022;Курская область;21_45_days;EpiVacCorona;1166;597;1763;604409;285634;890043
2022.01_13-10-2022;Курская область;21_45_days;SputnikLite;16669;8116;24785;604409;285634;890043
2022.01_13-10-2022;Курская область;21_45_days;SputnikV;4675;2218;6893;604409;285634;890043
2022.01_13-10-2022;Курская область;45_75_days;AllVaccines;47446;24451;71897;604409;285634;890043
2022.01_13-10-2022;Курская область;45_75_days;CoviVac;1667;389;2056;604409;285634;890043
2022.01_13-10-2022;Курская область;45_75_days;EpiVacCorona;3313;1605;4918;604409;285634;890043
2022.01_13-10-2022;Курская область;45_75_days;SputnikLite;15272;9198;24470;604409;285634;890043
2022.01_13-10-2022;Курская область;45_75_days;SputnikV;27194;13259;40453;604409;285634;890043
2022.01_13-10-2022;Курская область;75_90_days;AllVaccines;28962;16184;45146;604409;285634;890043
2022.01_13-10-2022;Курская область;75_90_days;CoviVac;217;41;258;604409;285634;890043
2022.01_13-10-2022;Курская область;75_90_days;EpiVacCorona;1004;525;1529;604409;285634;890043
2022.01_13-10-2022;Курская область;75_90_days;SputnikLite;10633;7487;18120;604409;285634;890043
2022.01_13-10-2022;Курская область;75_90_days;SputnikV;17108;8131;25239;604409;285634;890043
2022.01_13-10-2022;Курская область;90_105_days;AllVaccines;34099;19368;53467;604409;285634;890043
2022.01_13-10-2022;Курская область;90_105_days;CoviVac;594;133;727;604409;285634;890043
2022.01_13-10-2022;Курская область;90_105_days;EpiVacCorona;1461;613;2074;604409;285634;890043
2022.01_13-10-2022;Курская область;90_105_days;SputnikLite;12884;11201;24085;604409;285634;890043
2022.01_13-10-2022;Курская область;90_105_days;SputnikV;19160;7421;26581;604409;285634;890043
2022.01_13-10-2022;Ленинградская область;105_165_days;AllVaccines;107535;45553;153088;1100343;462742;1563085
2022.01_13-10-2022;Ленинградская область;105_165_days;CoviVac;2361;328;2689;1100343;462742;1563085
2022.01_13-10-2022;Ленинградская область;105_165_days;EpiVacCorona;208;105;313;1100343;462742;1563085
2022.01_13-10-2022;Ленинградская область;105_165_days;SputnikLite;55362;25647;81009;1100343;462742;1563085
2022.01_13-10-2022;Ленинградская область;105_165_days;SputnikV;49604;19473;69077;1100343;462742;1563085
2022.01_13-10-2022;Ленинградская область;165_195_days;AllVaccines;114195;26722;140917;1100343;462742;1563085
2022.01_13-10-2022;Ленинградская область;165_195_days;CoviVac;2599;236;2835;1100343;462742;1563085
2022.01_13-10-2022;Ленинградская область;165_195_days;EpiVacCorona;942;292;1234;1100343;462742;1563085
2022.01_13-10-2022;Ленинградская область;165_195_days;SputnikLite;20033;3098;23131;1100343;462742;1563085
2022.01_13-10-2022;Ленинградская область;165_195_days;SputnikV;90621;23096;113717;1100343;462742;1563085
2022.01_13-10-2022;Ленинградская область;21_45_days;AllVaccines;32165;18036;50201;1100343;462742;1563085
2022.01_13-10-2022;Ленинградская область;21_45_days;CoviVac;339;72;411;1100343;462742;1563085
2022.01_13-10-2022;Ленинградская область;21_45_days;EpiVacCorona;785;484;1269;1100343;462742;1563085
2022.01_13-10-2022;Ленинградская область;21_45_days;SputnikLite;14958;11461;26419;1100343;462742;1563085
2022.01_13-10-2022;Ленинградская область;21_45_days;SputnikV;16083;6019;22102;1100343;462742;1563085
2022.01_13-10-2022;Ленинградская область;45_75_days;AllVaccines;93108;47516;140624;1100343;462742;1563085
2022.01_13-10-2022;Ленинградская область;45_75_days;CoviVac;1057;140;1197;1100343;462742;1563085
2022.01_13-10-2022;Ленинградская область;45_75_days;EpiVacCorona;2256;1364;3620;1100343;462742;1563085
2022.01_13-10-2022;Ленинградская область;45_75_days;SputnikLite;19883;16886;36769;1100343;462742;1563085
2022.01_13-10-2022;Ленинградская область;45_75_days;SputnikV;69912;29126;99038;1100343;462742;1563085
2022.01_13-10-2022;Ленинградская область;75_90_days;AllVaccines;57826;28115;85941;1100343;462742;1563085
2022.01_13-10-2022;Ленинградская область;75_90_days;CoviVac;647;112;759;1100343;462742;1563085
2022.01_13-10-2022;Ленинградская область;75_90_days;EpiVacCorona;1437;612;2049;1100343;462742;1563085
2022.01_13-10-2022;Ленинградская область;75_90_days;SputnikLite;16597;12535;29132;1100343;462742;1563085
2022.01_13-10-2022;Ленинградская область;75_90_days;SputnikV;39145;14856;54001;1100343;462742;1563085
2022.01_13-10-2022;Ленинградская область;90_105_days;AllVaccines;31615;14899;46514;1100343;462742;1563085
2022.01_13-10-2022;Ленинградская область;90_105_days;CoviVac;686;97;783;1100343;462742;1563085
2022.01_13-10-2022;Ленинградская область;90_105_days;EpiVacCorona;660;343;1003;1100343;462742;1563085
2022.01_13-10-2022;Ленинградская область;90_105_days;SputnikLite;9481;4769;14250;1100343;462742;1563085
2022.01_13-10-2022;Ленинградская область;90_105_days;SputnikV;20788;9690;30478;1100343;462742;1563085
2022.01_13-10-2022;Липецкая область;105_165_days;AllVaccines;67047;32030;99077;621641;290878;912519
2022.01_13-10-2022;Липецкая область;105_165_days;CoviVac;1310;107;1417;621641;290878;912519
2022.01_13-10-2022;Липецкая область;105_165_days;EpiVacCorona;720;249;969;621641;290878;912519
2022.01_13-10-2022;Липецкая область;105_165_days;SputnikLite;28095;21413;49508;621641;290878;912519
2022.01_13-10-2022;Липецкая область;105_165_days;SputnikV;36922;10261;47183;621641;290878;912519
2022.01_13-10-2022;Липецкая область;165_195_days;AllVaccines;73426;12416;85842;621641;290878;912519
2022.01_13-10-2022;Липецкая область;165_195_days;CoviVac;1069;42;1111;621641;290878;912519
2022.01_13-10-2022;Липецкая область;165_195_days;EpiVacCorona;656;280;936;621641;290878;912519
2022.01_13-10-2022;Липецкая область;165_195_days;SputnikLite;5300;2154;7454;621641;290878;912519
2022.01_13-10-2022;Липецкая область;165_195_days;SputnikV;66401;9940;76341;621641;290878;912519
2022.01_13-10-2022;Липецкая область;21_45_days;AllVaccines;19002;9595;28597;621641;290878;912519
2022.01_13-10-2022;Липецкая область;21_45_days;CoviVac;105;16;121;621641;290878;912519
2022.01_13-10-2022;Липецкая область;21_45_days;EpiVacCorona;2058;712;2770;621641;290878;912519
2022.01_13-10-2022;Липецкая область;21_45_days;SputnikLite;10592;6926;17518;621641;290878;912519
2022.01_13-10-2022;Липецкая область;21_45_days;SputnikV;6247;1941;8188;621641;290878;912519
2022.01_13-10-2022;Липецкая область;45_75_days;AllVaccines;54167;23302;77469;621641;290878;912519
2022.01_13-10-2022;Липецкая область;45_75_days;CoviVac;393;46;439;621641;290878;912519
2022.01_13-10-2022;Липецкая область;45_75_days;EpiVacCorona;3500;1218;4718;621641;290878;912519
2022.01_13-10-2022;Липецкая область;45_75_days;SputnikLite;10621;9678;20299;621641;290878;912519
2022.01_13-10-2022;Липецкая область;45_75_days;SputnikV;39653;12360;52013;621641;290878;912519
2022.01_13-10-2022;Липецкая область;75_90_days;AllVaccines;55899;19120;75019;621641;290878;912519
2022.01_13-10-2022;Липецкая область;75_90_days;CoviVac;77;17;94;621641;290878;912519
2022.01_13-10-2022;Липецкая область;75_90_days;EpiVacCorona;2346;456;2802;621641;290878;912519
2022.01_13-10-2022;Липецкая область;75_90_days;SputnikLite;10418;9063;19481;621641;290878;912519
2022.01_13-10-2022;Липецкая область;75_90_days;SputnikV;43058;9584;52642;621641;290878;912519
2022.01_13-10-2022;Липецкая область;90_105_days;AllVaccines;49058;17585;66643;621641;290878;912519
2022.01_13-10-2022;Липецкая область;90_105_days;CoviVac;179;23;202;621641;290878;912519
2022.01_13-10-2022;Липецкая область;90_105_days;EpiVacCorona;2164;342;2506;621641;290878;912519
2022.01_13-10-2022;Липецкая область;90_105_days;SputnikLite;12445;10325;22770;621641;290878;912519
2022.01_13-10-2022;Липецкая область;90_105_days;SputnikV;34270;6895;41165;621641;290878;912519
2022.01_13-10-2022;Магаданская область;105_165_days;AllVaccines;9800;2720;12520;83196;26810;110006
2022.01_13-10-2022;Магаданская область;105_165_days;CoviVac;98;23;121;83196;26810;110006
2022.01_13-10-2022;Магаданская область;105_165_days;EpiVacCorona;1;1;2;83196;26810;110006
2022.01_13-10-2022;Магаданская область;105_165_days;SputnikLite;6483;1909;8392;83196;26810;110006
2022.01_13-10-2022;Магаданская область;105_165_days;SputnikV;3218;787;4005;83196;26810;110006
2022.01_13-10-2022;Магаданская область;165_195_days;AllVaccines;8615;1285;9900;83196;26810;110006
2022.01_13-10-2022;Магаданская область;165_195_days;CoviVac;128;28;156;83196;26810;110006
2022.01_13-10-2022;Магаданская область;165_195_days;EpiVacCorona;1;0;1;83196;26810;110006
2022.01_13-10-2022;Магаданская область;165_195_days;SputnikLite;3054;303;3357;83196;26810;110006
2022.01_13-10-2022;Магаданская область;165_195_days;SputnikV;5432;954;6386;83196;26810;110006
2022.01_13-10-2022;Магаданская область;21_45_days;AllVaccines;4099;1226;5325;83196;26810;110006
2022.01_13-10-2022;Магаданская область;21_45_days;CoviVac;94;16;110;83196;26810;110006
2022.01_13-10-2022;Магаданская область;21_45_days;EpiVacCorona;202;43;245;83196;26810;110006
2022.01_13-10-2022;Магаданская область;21_45_days;SputnikLite;2771;948;3719;83196;26810;110006
2022.01_13-10-2022;Магаданская область;21_45_days;SputnikV;1032;219;1251;83196;26810;110006
2022.01_13-10-2022;Магаданская область;45_75_days;AllVaccines;8213;2070;10283;83196;26810;110006
2022.01_13-10-2022;Магаданская область;45_75_days;CoviVac;79;9;88;83196;26810;110006
2022.01_13-10-2022;Магаданская область;45_75_days;EpiVacCorona;948;113;1061;83196;26810;110006
2022.01_13-10-2022;Магаданская область;45_75_days;SputnikLite;3498;1202;4700;83196;26810;110006
2022.01_13-10-2022;Магаданская область;45_75_days;SputnikV;3688;746;4434;83196;26810;110006
2022.01_13-10-2022;Магаданская область;75_90_days;AllVaccines;3950;1327;5277;83196;26810;110006
2022.01_13-10-2022;Магаданская область;75_90_days;CoviVac;18;7;25;83196;26810;110006
2022.01_13-10-2022;Магаданская область;75_90_days;EpiVacCorona;480;68;548;83196;26810;110006
2022.01_13-10-2022;Магаданская область;75_90_days;SputnikLite;2024;926;2950;83196;26810;110006
2022.01_13-10-2022;Магаданская область;75_90_days;SputnikV;1428;326;1754;83196;26810;110006
2022.01_13-10-2022;Магаданская область;90_105_days;AllVaccines;2863;1093;3956;83196;26810;110006
2022.01_13-10-2022;Магаданская область;90_105_days;CoviVac;143;38;181;83196;26810;110006
2022.01_13-10-2022;Магаданская область;90_105_days;EpiVacCorona;9;2;11;83196;26810;110006
2022.01_13-10-2022;Магаданская область;90_105_days;SputnikLite;2056;852;2908;83196;26810;110006
2022.01_13-10-2022;Магаданская область;90_105_days;SputnikV;655;201;856;83196;26810;110006
2022.01_13-10-2022;Московская область;105_165_days;AllVaccines;373684;168558;542242;4485323;1674471;6159794
2022.01_13-10-2022;Московская область;105_165_days;CoviVac;6000;2009;8009;4485323;1674471;6159794
2022.01_13-10-2022;Московская область;105_165_days;EpiVacCorona;3781;2417;6198;4485323;1674471;6159794
2022.01_13-10-2022;Московская область;105_165_days;SputnikLite;97312;93682;190994;4485323;1674471;6159794
2022.01_13-10-2022;Московская область;105_165_days;SputnikV;266591;70450;337041;4485323;1674471;6159794
2022.01_13-10-2022;Московская область;165_195_days;AllVaccines;622635;115290;737925;4485323;1674471;6159794
2022.01_13-10-2022;Московская область;165_195_days;CoviVac;7207;1677;8884;4485323;1674471;6159794
2022.01_13-10-2022;Московская область;165_195_days;EpiVacCorona;3825;1788;5613;4485323;1674471;6159794
2022.01_13-10-2022;Московская область;165_195_days;SputnikLite;20080;10215;30295;4485323;1674471;6159794
2022.01_13-10-2022;Московская область;165_195_days;SputnikV;591523;101610;693133;4485323;1674471;6159794
2022.01_13-10-2022;Московская область;21_45_days;AllVaccines;139479;65423;204902;4485323;1674471;6159794
2022.01_13-10-2022;Московская область;21_45_days;CoviVac;558;223;781;4485323;1674471;6159794
2022.01_13-10-2022;Московская область;21_45_days;EpiVacCorona;1358;1183;2541;4485323;1674471;6159794
2022.01_13-10-2022;Московская область;21_45_days;SputnikLite;79412;44906;124318;4485323;1674471;6159794
2022.01_13-10-2022;Московская область;21_45_days;SputnikV;58151;19111;77262;4485323;1674471;6159794
2022.01_13-10-2022;Московская область;45_75_days;AllVaccines;276413;133243;409656;4485323;1674471;6159794
2022.01_13-10-2022;Московская область;45_75_days;CoviVac;3763;1443;5206;4485323;1674471;6159794
2022.01_13-10-2022;Московская область;45_75_days;EpiVacCorona;4709;3770;8479;4485323;1674471;6159794
2022.01_13-10-2022;Московская область;45_75_days;SputnikLite;54735;46483;101218;4485323;1674471;6159794
2022.01_13-10-2022;Московская область;45_75_days;SputnikV;213206;81547;294753;4485323;1674471;6159794
2022.01_13-10-2022;Московская область;75_90_days;AllVaccines;174919;86815;261734;4485323;1674471;6159794
2022.01_13-10-2022;Московская область;75_90_days;CoviVac;1738;693;2431;4485323;1674471;6159794
2022.01_13-10-2022;Московская область;75_90_days;EpiVacCorona;3354;2609;5963;4485323;1674471;6159794
2022.01_13-10-2022;Московская область;75_90_days;SputnikLite;35135;31040;66175;4485323;1674471;6159794
2022.01_13-10-2022;Московская область;75_90_days;SputnikV;134692;52473;187165;4485323;1674471;6159794
2022.01_13-10-2022;Московская область;90_105_days;AllVaccines;148260;81342;229602;4485323;1674471;6159794
2022.01_13-10-2022;Московская область;90_105_days;CoviVac;2034;962;2996;4485323;1674471;6159794
2022.01_13-10-2022;Московская область;90_105_days;EpiVacCorona;2001;1846;3847;4485323;1674471;6159794
2022.01_13-10-2022;Московская область;90_105_days;SputnikLite;36610;33833;70443;4485323;1674471;6159794
2022.01_13-10-2022;Московская область;90_105_days;SputnikV;107615;44701;152316;4485323;1674471;6159794
2022.01_13-10-2022;Мурманская область;105_165_days;AllVaccines;53270;14474;67744;436555;144366;580921
2022.01_13-10-2022;Мурманская область;105_165_days;CoviVac;150;18;168;436555;144366;580921
2022.01_13-10-2022;Мурманская область;105_165_days;EpiVacCorona;450;128;578;436555;144366;580921
2022.01_13-10-2022;Мурманская область;105_165_days;SputnikLite;27894;9192;37086;436555;144366;580921
2022.01_13-10-2022;Мурманская область;105_165_days;SputnikV;24776;5136;29912;436555;144366;580921
2022.01_13-10-2022;Мурманская область;165_195_days;AllVaccines;57827;7918;65745;436555;144366;580921
2022.01_13-10-2022;Мурманская область;165_195_days;CoviVac;638;64;702;436555;144366;580921
2022.01_13-10-2022;Мурманская область;165_195_days;EpiVacCorona;347;76;423;436555;144366;580921
2022.01_13-10-2022;Мурманская область;165_195_days;SputnikLite;19962;1512;21474;436555;144366;580921
2022.01_13-10-2022;Мурманская область;165_195_days;SputnikV;36880;6266;43146;436555;144366;580921
2022.01_13-10-2022;Мурманская область;21_45_days;AllVaccines;15601;5943;21544;436555;144366;580921
2022.01_13-10-2022;Мурманская область;21_45_days;CoviVac;185;27;212;436555;144366;580921
2022.01_13-10-2022;Мурманская область;21_45_days;EpiVacCorona;411;166;577;436555;144366;580921
2022.01_13-10-2022;Мурманская область;21_45_days;SputnikLite;8514;4009;12523;436555;144366;580921
2022.01_13-10-2022;Мурманская область;21_45_days;SputnikV;6491;1741;8232;436555;144366;580921
2022.01_13-10-2022;Мурманская область;45_75_days;AllVaccines;44279;14219;58498;436555;144366;580921
2022.01_13-10-2022;Мурманская область;45_75_days;CoviVac;813;83;896;436555;144366;580921
2022.01_13-10-2022;Мурманская область;45_75_days;EpiVacCorona;2077;619;2696;436555;144366;580921
2022.01_13-10-2022;Мурманская область;45_75_days;SputnikLite;16594;6669;23263;436555;144366;580921
2022.01_13-10-2022;Мурманская область;45_75_days;SputnikV;24795;6848;31643;436555;144366;580921
2022.01_13-10-2022;Мурманская область;75_90_days;AllVaccines;19542;7320;26862;436555;144366;580921
2022.01_13-10-2022;Мурманская область;75_90_days;CoviVac;309;47;356;436555;144366;580921
2022.01_13-10-2022;Мурманская область;75_90_days;EpiVacCorona;617;283;900;436555;144366;580921
2022.01_13-10-2022;Мурманская область;75_90_days;SputnikLite;11321;4289;15610;436555;144366;580921
2022.01_13-10-2022;Мурманская область;75_90_days;SputnikV;7295;2701;9996;436555;144366;580921
2022.01_13-10-2022;Мурманская область;90_105_days;AllVaccines;19314;6866;26180;436555;144366;580921
2022.01_13-10-2022;Мурманская область;90_105_days;CoviVac;300;44;344;436555;144366;580921
2022.01_13-10-2022;Мурманская область;90_105_days;EpiVacCorona;314;211;525;436555;144366;580921
2022.01_13-10-2022;Мурманская область;90_105_days;SputnikLite;13193;4561;17754;436555;144366;580921
2022.01_13-10-2022;Мурманская область;90_105_days;SputnikV;5507;2050;7557;436555;144366;580921
2022.01_13-10-2022;Ненецкий автономный округ;105_165_days;AllVaccines;2053;878;2931;24931;7449;32380
2022.01_13-10-2022;Ненецкий автономный округ;105_165_days;CoviVac;94;5;99;24931;7449;32380
2022.01_13-10-2022;Ненецкий автономный округ;105_165_days;EpiVacCorona;19;10;29;24931;7449;32380
2022.01_13-10-2022;Ненецкий автономный округ;105_165_days;SputnikLite;1721;813;2534;24931;7449;32380
2022.01_13-10-2022;Ненецкий автономный округ;105_165_days;SputnikV;219;50;269;24931;7449;32380
2022.01_13-10-2022;Ненецкий автономный округ;165_195_days;AllVaccines;1527;304;1831;24931;7449;32380
2022.01_13-10-2022;Ненецкий автономный округ;165_195_days;CoviVac;89;17;106;24931;7449;32380
2022.01_13-10-2022;Ненецкий автономный округ;165_195_days;EpiVacCorona;610;86;696;24931;7449;32380
2022.01_13-10-2022;Ненецкий автономный округ;165_195_days;SputnikLite;474;135;609;24931;7449;32380
2022.01_13-10-2022;Ненецкий автономный округ;165_195_days;SputnikV;354;66;420;24931;7449;32380
2022.01_13-10-2022;Ненецкий автономный округ;21_45_days;AllVaccines;782;244;1026;24931;7449;32380
2022.01_13-10-2022;Ненецкий автономный округ;21_45_days;EpiVacCorona;13;2;15;24931;7449;32380
2022.01_13-10-2022;Ненецкий автономный округ;21_45_days;SputnikLite;659;232;891;24931;7449;32380
2022.01_13-10-2022;Ненецкий автономный округ;21_45_days;SputnikV;110;10;120;24931;7449;32380
2022.01_13-10-2022;Ненецкий автономный округ;45_75_days;AllVaccines;1662;569;2231;24931;7449;32380
2022.01_13-10-2022;Ненецкий автономный округ;45_75_days;EpiVacCorona;81;12;93;24931;7449;32380
2022.01_13-10-2022;Ненецкий автономный округ;45_75_days;SputnikLite;1149;484;1633;24931;7449;32380
2022.01_13-10-2022;Ненецкий автономный округ;45_75_days;SputnikV;432;73;505;24931;7449;32380
2022.01_13-10-2022;Ненецкий автономный округ;75_90_days;AllVaccines;1488;431;1919;24931;7449;32380
2022.01_13-10-2022;Ненецкий автономный округ;75_90_days;EpiVacCorona;31;2;33;24931;7449;32380
2022.01_13-10-2022;Ненецкий автономный округ;75_90_days;SputnikLite;1205;381;1586;24931;7449;32380
2022.01_13-10-2022;Ненецкий автономный округ;75_90_days;SputnikV;252;48;300;24931;7449;32380
2022.01_13-10-2022;Ненецкий автономный округ;90_105_days;AllVaccines;1114;413;1527;24931;7449;32380
2022.01_13-10-2022;Ненецкий автономный округ;90_105_days;CoviVac;3;0;3;24931;7449;32380
2022.01_13-10-2022;Ненецкий автономный округ;90_105_days;EpiVacCorona;18;3;21;24931;7449;32380
2022.01_13-10-2022;Ненецкий автономный округ;90_105_days;SputnikLite;966;377;1343;24931;7449;32380
2022.01_13-10-2022;Ненецкий автономный округ;90_105_days;SputnikV;127;33;160;24931;7449;32380
2022.01_13-10-2022;Нижегородская область;105_165_days;AllVaccines;190750;85675;276425;1769909;800663;2570572
2022.01_13-10-2022;Нижегородская область;105_165_days;CoviVac;3919;713;4632;1769909;800663;2570572
2022.01_13-10-2022;Нижегородская область;105_165_days;EpiVacCorona;1658;1145;2803;1769909;800663;2570572
2022.01_13-10-2022;Нижегородская область;105_165_days;SputnikLite;118606;54214;172820;1769909;800663;2570572
2022.01_13-10-2022;Нижегородская область;105_165_days;SputnikV;66567;29603;96170;1769909;800663;2570572
2022.01_13-10-2022;Нижегородская область;165_195_days;AllVaccines;196597;34853;231450;1769909;800663;2570572
2022.01_13-10-2022;Нижегородская область;165_195_days;CoviVac;2725;308;3033;1769909;800663;2570572
2022.01_13-10-2022;Нижегородская область;165_195_days;EpiVacCorona;6686;2198;8884;1769909;800663;2570572
2022.01_13-10-2022;Нижегородская область;165_195_days;SputnikLite;60975;8606;69581;1769909;800663;2570572
2022.01_13-10-2022;Нижегородская область;165_195_days;SputnikV;126211;23741;149952;1769909;800663;2570572
2022.01_13-10-2022;Нижегородская область;21_45_days;AllVaccines;50514;31803;82317;1769909;800663;2570572
2022.01_13-10-2022;Нижегородская область;21_45_days;CoviVac;393;123;516;1769909;800663;2570572
2022.01_13-10-2022;Нижегородская область;21_45_days;EpiVacCorona;1805;1552;3357;1769909;800663;2570572
2022.01_13-10-2022;Нижегородская область;21_45_days;SputnikLite;32262;21439;53701;1769909;800663;2570572
2022.01_13-10-2022;Нижегородская область;21_45_days;SputnikV;16054;8689;24743;1769909;800663;2570572
2022.01_13-10-2022;Нижегородская область;45_75_days;AllVaccines;136369;84864;221233;1769909;800663;2570572
2022.01_13-10-2022;Нижегородская область;45_75_days;CoviVac;376;86;462;1769909;800663;2570572
2022.01_13-10-2022;Нижегородская область;45_75_days;EpiVacCorona;3418;2674;6092;1769909;800663;2570572
2022.01_13-10-2022;Нижегородская область;45_75_days;SputnikLite;39692;33912;73604;1769909;800663;2570572
2022.01_13-10-2022;Нижегородская область;45_75_days;SputnikV;92883;48192;141075;1769909;800663;2570572
2022.01_13-10-2022;Нижегородская область;75_90_days;AllVaccines;109242;61824;171066;1769909;800663;2570572
2022.01_13-10-2022;Нижегородская область;75_90_days;CoviVac;490;98;588;1769909;800663;2570572
2022.01_13-10-2022;Нижегородская область;75_90_days;EpiVacCorona;2147;1189;3336;1769909;800663;2570572
2022.01_13-10-2022;Нижегородская область;75_90_days;SputnikLite;31714;29858;61572;1769909;800663;2570572
2022.01_13-10-2022;Нижегородская область;75_90_days;SputnikV;74891;30679;105570;1769909;800663;2570572
2022.01_13-10-2022;Нижегородская область;90_105_days;AllVaccines;62073;30495;92568;1769909;800663;2570572
2022.01_13-10-2022;Нижегородская область;90_105_days;CoviVac;518;94;612;1769909;800663;2570572
2022.01_13-10-2022;Нижегородская область;90_105_days;EpiVacCorona;1365;714;2079;1769909;800663;2570572
2022.01_13-10-2022;Нижегородская область;90_105_days;SputnikLite;14731;10912;25643;1769909;800663;2570572
2022.01_13-10-2022;Нижегородская область;90_105_days;SputnikV;45459;18775;64234;1769909;800663;2570572
2022.01_13-10-2022;Новгородская область;105_165_days;AllVaccines;36419;17049;53468;317276;158308;475584
2022.01_13-10-2022;Новгородская область;105_165_days;CoviVac;71;22;93;317276;158308;475584
2022.01_13-10-2022;Новгородская область;105_165_days;EpiVacCorona;154;89;243;317276;158308;475584
2022.01_13-10-2022;Новгородская область;105_165_days;SputnikLite;29790;13376;43166;317276;158308;475584
2022.01_13-10-2022;Новгородская область;105_165_days;SputnikV;6404;3562;9966;317276;158308;475584
2022.01_13-10-2022;Новгородская область;165_195_days;AllVaccines;34728;7935;42663;317276;158308;475584
2022.01_13-10-2022;Новгородская область;165_195_days;CoviVac;195;33;228;317276;158308;475584
2022.01_13-10-2022;Новгородская область;165_195_days;EpiVacCorona;325;95;420;317276;158308;475584
2022.01_13-10-2022;Новгородская область;165_195_days;SputnikLite;14099;1714;15813;317276;158308;475584
2022.01_13-10-2022;Новгородская область;165_195_days;SputnikV;20109;6093;26202;317276;158308;475584
2022.01_13-10-2022;Новгородская область;21_45_days;AllVaccines;8129;6178;14307;317276;158308;475584
2022.01_13-10-2022;Новгородская область;21_45_days;CoviVac;230;96;326;317276;158308;475584
2022.01_13-10-2022;Новгородская область;21_45_days;EpiVacCorona;624;353;977;317276;158308;475584
2022.01_13-10-2022;Новгородская область;21_45_days;SputnikLite;4104;3471;7575;317276;158308;475584
2022.01_13-10-2022;Новгородская область;21_45_days;SputnikV;3171;2258;5429;317276;158308;475584
2022.01_13-10-2022;Новгородская область;45_75_days;AllVaccines;21592;13881;35473;317276;158308;475584
2022.01_13-10-2022;Новгородская область;45_75_days;CoviVac;893;310;1203;317276;158308;475584
2022.01_13-10-2022;Новгородская область;45_75_days;EpiVacCorona;1943;1104;3047;317276;158308;475584
2022.01_13-10-2022;Новгородская область;45_75_days;SputnikLite;4831;4680;9511;317276;158308;475584
2022.01_13-10-2022;Новгородская область;45_75_days;SputnikV;13925;7787;21712;317276;158308;475584
2022.01_13-10-2022;Новгородская область;75_90_days;AllVaccines;14886;9581;24467;317276;158308;475584
2022.01_13-10-2022;Новгородская область;75_90_days;CoviVac;104;40;144;317276;158308;475584
2022.01_13-10-2022;Новгородская область;75_90_days;EpiVacCorona;663;263;926;317276;158308;475584
2022.01_13-10-2022;Новгородская область;75_90_days;SputnikLite;5252;5039;10291;317276;158308;475584
2022.01_13-10-2022;Новгородская область;75_90_days;SputnikV;8867;4239;13106;317276;158308;475584
2022.01_13-10-2022;Новгородская область;90_105_days;AllVaccines;10516;6450;16966;317276;158308;475584
2022.01_13-10-2022;Новгородская область;90_105_days;CoviVac;251;65;316;317276;158308;475584
2022.01_13-10-2022;Новгородская область;90_105_days;EpiVacCorona;280;116;396;317276;158308;475584
2022.01_13-10-2022;Новгородская область;90_105_days;SputnikLite;5807;3770;9577;317276;158308;475584
2022.01_13-10-2022;Новгородская область;90_105_days;SputnikV;4178;2499;6677;317276;158308;475584
2022.01_13-10-2022;Новосибирская область;105_165_days;AllVaccines;131847;58144;189991;1571829;624100;2195929
2022.01_13-10-2022;Новосибирская область;105_165_days;CoviVac;2997;608;3605;1571829;624100;2195929
2022.01_13-10-2022;Новосибирская область;105_165_days;EpiVacCorona;1951;1219;3170;1571829;624100;2195929
2022.01_13-10-2022;Новосибирская область;105_165_days;SputnikLite;77231;35815;113046;1571829;624100;2195929
2022.01_13-10-2022;Новосибирская область;105_165_days;SputnikV;49668;20502;70170;1571829;624100;2195929
2022.01_13-10-2022;Новосибирская область;165_195_days;AllVaccines;100202;25976;126178;1571829;624100;2195929
2022.01_13-10-2022;Новосибирская область;165_195_days;CoviVac;1353;186;1539;1571829;624100;2195929
2022.01_13-10-2022;Новосибирская область;165_195_days;EpiVacCorona;4269;2253;6522;1571829;624100;2195929
2022.01_13-10-2022;Новосибирская область;165_195_days;SputnikLite;28120;3973;32093;1571829;624100;2195929
2022.01_13-10-2022;Новосибирская область;165_195_days;SputnikV;66460;19564;86024;1571829;624100;2195929
2022.01_13-10-2022;Новосибирская область;21_45_days;AllVaccines;65250;37427;102677;1571829;624100;2195929
2022.01_13-10-2022;Новосибирская область;21_45_days;CoviVac;596;179;775;1571829;624100;2195929
2022.01_13-10-2022;Новосибирская область;21_45_days;EpiVacCorona;1360;876;2236;1571829;624100;2195929
2022.01_13-10-2022;Новосибирская область;21_45_days;SputnikLite;37023;27385;64408;1571829;624100;2195929
2022.01_13-10-2022;Новосибирская область;21_45_days;SputnikV;26271;8987;35258;1571829;624100;2195929
2022.01_13-10-2022;Новосибирская область;45_75_days;AllVaccines;202716;81674;284390;1571829;624100;2195929
2022.01_13-10-2022;Новосибирская область;45_75_days;CoviVac;475;110;585;1571829;624100;2195929
2022.01_13-10-2022;Новосибирская область;45_75_days;EpiVacCorona;4812;1857;6669;1571829;624100;2195929
2022.01_13-10-2022;Новосибирская область;45_75_days;SputnikLite;43068;35189;78257;1571829;624100;2195929
2022.01_13-10-2022;Новосибирская область;45_75_days;SputnikV;154361;44518;198879;1571829;624100;2195929
2022.01_13-10-2022;Новосибирская область;75_90_days;AllVaccines;92891;38391;131282;1571829;624100;2195929
2022.01_13-10-2022;Новосибирская область;75_90_days;CoviVac;269;36;305;1571829;624100;2195929
2022.01_13-10-2022;Новосибирская область;75_90_days;EpiVacCorona;3127;1013;4140;1571829;624100;2195929
2022.01_13-10-2022;Новосибирская область;75_90_days;SputnikLite;20352;15937;36289;1571829;624100;2195929
2022.01_13-10-2022;Новосибирская область;75_90_days;SputnikV;69143;21405;90548;1571829;624100;2195929
2022.01_13-10-2022;Новосибирская область;90_105_days;AllVaccines;55007;17915;72922;1571829;624100;2195929
2022.01_13-10-2022;Новосибирская область;90_105_days;CoviVac;817;96;913;1571829;624100;2195929
2022.01_13-10-2022;Новосибирская область;90_105_days;EpiVacCorona;1721;520;2241;1571829;624100;2195929
2022.01_13-10-2022;Новосибирская область;90_105_days;SputnikLite;8296;4272;12568;1571829;624100;2195929
2022.01_13-10-2022;Новосибирская область;90_105_days;SputnikV;44173;13027;57200;1571829;624100;2195929
2022.01_13-10-2022;Омская область;105_165_days;AllVaccines;91651;35173;126824;1058291;431046;1489337
2022.01_13-10-2022;Омская область;105_165_days;CoviVac;1136;316;1452;1058291;431046;1489337
2022.01_13-10-2022;Омская область;105_165_days;EpiVacCorona;1096;594;1690;1058291;431046;1489337
2022.01_13-10-2022;Омская область;105_165_days;SputnikLite;40869;20449;61318;1058291;431046;1489337
2022.01_13-10-2022;Омская область;105_165_days;SputnikV;48550;13814;62364;1058291;431046;1489337
2022.01_13-10-2022;Омская область;165_195_days;AllVaccines;143693;21968;165661;1058291;431046;1489337
2022.01_13-10-2022;Омская область;165_195_days;CoviVac;1825;257;2082;1058291;431046;1489337
2022.01_13-10-2022;Омская область;165_195_days;EpiVacCorona;2715;671;3386;1058291;431046;1489337
2022.01_13-10-2022;Омская область;165_195_days;SputnikLite;24124;2857;26981;1058291;431046;1489337
2022.01_13-10-2022;Омская область;165_195_days;SputnikV;115029;18183;133212;1058291;431046;1489337
2022.01_13-10-2022;Омская область;21_45_days;AllVaccines;40467;19392;59859;1058291;431046;1489337
2022.01_13-10-2022;Омская область;21_45_days;CoviVac;409;100;509;1058291;431046;1489337
2022.01_13-10-2022;Омская область;21_45_days;EpiVacCorona;1430;565;1995;1058291;431046;1489337
2022.01_13-10-2022;Омская область;21_45_days;SputnikLite;20038;11343;31381;1058291;431046;1489337
2022.01_13-10-2022;Омская область;21_45_days;SputnikV;18590;7384;25974;1058291;431046;1489337
2022.01_13-10-2022;Омская область;45_75_days;AllVaccines;117382;49101;166483;1058291;431046;1489337
2022.01_13-10-2022;Омская область;45_75_days;CoviVac;689;158;847;1058291;431046;1489337
2022.01_13-10-2022;Омская область;45_75_days;EpiVacCorona;3163;1162;4325;1058291;431046;1489337
2022.01_13-10-2022;Омская область;45_75_days;SputnikLite;24109;15424;39533;1058291;431046;1489337
2022.01_13-10-2022;Омская область;45_75_days;SputnikV;89421;32357;121778;1058291;431046;1489337
2022.01_13-10-2022;Омская область;75_90_days;AllVaccines;68172;25703;93875;1058291;431046;1489337
2022.01_13-10-2022;Омская область;75_90_days;CoviVac;378;74;452;1058291;431046;1489337
2022.01_13-10-2022;Омская область;75_90_days;EpiVacCorona;2214;629;2843;1058291;431046;1489337
2022.01_13-10-2022;Омская область;75_90_days;SputnikLite;8907;6839;15746;1058291;431046;1489337
2022.01_13-10-2022;Омская область;75_90_days;SputnikV;56673;18161;74834;1058291;431046;1489337
2022.01_13-10-2022;Омская область;90_105_days;AllVaccines;32892;16741;49633;1058291;431046;1489337
2022.01_13-10-2022;Омская область;90_105_days;CoviVac;599;153;752;1058291;431046;1489337
2022.01_13-10-2022;Омская область;90_105_days;EpiVacCorona;1016;394;1410;1058291;431046;1489337
2022.01_13-10-2022;Омская область;90_105_days;SputnikLite;11996;6651;18647;1058291;431046;1489337
2022.01_13-10-2022;Омская область;90_105_days;SputnikV;19281;9543;28824;1058291;431046;1489337
2022.01_13-10-2022;Оренбургская область;105_165_days;AllVaccines;92363;46379;138742;1068899;440686;1509585
2022.01_13-10-2022;Оренбургская область;105_165_days;CoviVac;1308;213;1521;1068899;440686;1509585
2022.01_13-10-2022;Оренбургская область;105_165_days;EpiVacCorona;936;322;1258;1068899;440686;1509585
2022.01_13-10-2022;Оренбургская область;105_165_days;SputnikLite;27196;27821;55017;1068899;440686;1509585
2022.01_13-10-2022;Оренбургская область;105_165_days;SputnikV;62923;18023;80946;1068899;440686;1509585
2022.01_13-10-2022;Оренбургская область;165_195_days;AllVaccines;105599;22138;127737;1068899;440686;1509585
2022.01_13-10-2022;Оренбургская область;165_195_days;CoviVac;560;67;627;1068899;440686;1509585
2022.01_13-10-2022;Оренбургская область;165_195_days;EpiVacCorona;1502;430;1932;1068899;440686;1509585
2022.01_13-10-2022;Оренбургская область;165_195_days;SputnikLite;5303;2763;8066;1068899;440686;1509585
2022.01_13-10-2022;Оренбургская область;165_195_days;SputnikV;98234;18878;117112;1068899;440686;1509585
2022.01_13-10-2022;Оренбургская область;21_45_days;AllVaccines;48513;19682;68195;1068899;440686;1509585
2022.01_13-10-2022;Оренбургская область;21_45_days;CoviVac;447;57;504;1068899;440686;1509585
2022.01_13-10-2022;Оренбургская область;21_45_days;EpiVacCorona;2226;849;3075;1068899;440686;1509585
2022.01_13-10-2022;Оренбургская область;21_45_days;SputnikLite;33968;14650;48618;1068899;440686;1509585
2022.01_13-10-2022;Оренбургская область;21_45_days;SputnikV;11872;4126;15998;1068899;440686;1509585
2022.01_13-10-2022;Оренбургская область;45_75_days;AllVaccines;78273;42463;120736;1068899;440686;1509585
2022.01_13-10-2022;Оренбургская область;45_75_days;CoviVac;950;144;1094;1068899;440686;1509585
2022.01_13-10-2022;Оренбургская область;45_75_days;EpiVacCorona;5172;2458;7630;1068899;440686;1509585
2022.01_13-10-2022;Оренбургская область;45_75_days;SputnikLite;25920;19290;45210;1068899;440686;1509585
2022.01_13-10-2022;Оренбургская область;45_75_days;SputnikV;46231;20571;66802;1068899;440686;1509585
2022.01_13-10-2022;Оренбургская область;75_90_days;AllVaccines;69725;31128;100853;1068899;440686;1509585
2022.01_13-10-2022;Оренбургская область;75_90_days;CoviVac;291;50;341;1068899;440686;1509585
2022.01_13-10-2022;Оренбургская область;75_90_days;EpiVacCorona;2692;961;3653;1068899;440686;1509585
2022.01_13-10-2022;Оренбургская область;75_90_days;SputnikLite;15943;15123;31066;1068899;440686;1509585
2022.01_13-10-2022;Оренбургская область;75_90_days;SputnikV;50799;14994;65793;1068899;440686;1509585
2022.01_13-10-2022;Оренбургская область;90_105_days;AllVaccines;57147;27224;84371;1068899;440686;1509585
2022.01_13-10-2022;Оренбургская область;90_105_days;CoviVac;1009;167;1176;1068899;440686;1509585
2022.01_13-10-2022;Оренбургская область;90_105_days;EpiVacCorona;1996;670;2666;1068899;440686;1509585
2022.01_13-10-2022;Оренбургская область;90_105_days;SputnikLite;11489;12944;24433;1068899;440686;1509585
2022.01_13-10-2022;Оренбургская область;90_105_days;SputnikV;42653;13443;56096;1068899;440686;1509585
2022.01_13-10-2022;Орловская область;105_165_days;AllVaccines;47499;23752;71251;398663;193123;591786
2022.01_13-10-2022;Орловская область;105_165_days;CoviVac;9;4;13;398663;193123;591786
2022.01_13-10-2022;Орловская область;105_165_days;EpiVacCorona;694;254;948;398663;193123;591786
2022.01_13-10-2022;Орловская область;105_165_days;SputnikLite;31988;16650;48638;398663;193123;591786
2022.01_13-10-2022;Орловская область;105_165_days;SputnikV;14808;6844;21652;398663;193123;591786
2022.01_13-10-2022;Орловская область;165_195_days;AllVaccines;50441;10897;61338;398663;193123;591786
2022.01_13-10-2022;Орловская область;165_195_days;CoviVac;15;7;22;398663;193123;591786
2022.01_13-10-2022;Орловская область;165_195_days;EpiVacCorona;6783;1464;8247;398663;193123;591786
2022.01_13-10-2022;Орловская область;165_195_days;SputnikLite;11223;2100;13323;398663;193123;591786
2022.01_13-10-2022;Орловская область;165_195_days;SputnikV;32420;7326;39746;398663;193123;591786
2022.01_13-10-2022;Орловская область;21_45_days;AllVaccines;13343;8095;21438;398663;193123;591786
2022.01_13-10-2022;Орловская область;21_45_days;CoviVac;287;76;363;398663;193123;591786
2022.01_13-10-2022;Орловская область;21_45_days;EpiVacCorona;460;223;683;398663;193123;591786
2022.01_13-10-2022;Орловская область;21_45_days;SputnikLite;8125;5683;13808;398663;193123;591786
2022.01_13-10-2022;Орловская область;21_45_days;SputnikV;4471;2113;6584;398663;193123;591786
2022.01_13-10-2022;Орловская область;45_75_days;AllVaccines;46614;21001;67615;398663;193123;591786
2022.01_13-10-2022;Орловская область;45_75_days;CoviVac;1745;486;2231;398663;193123;591786
2022.01_13-10-2022;Орловская область;45_75_days;EpiVacCorona;734;328;1062;398663;193123;591786
2022.01_13-10-2022;Орловская область;45_75_days;SputnikLite;8055;7267;15322;398663;193123;591786
2022.01_13-10-2022;Орловская область;45_75_days;SputnikV;36080;12920;49000;398663;193123;591786
2022.01_13-10-2022;Орловская область;75_90_days;AllVaccines;31599;13941;45540;398663;193123;591786
2022.01_13-10-2022;Орловская область;75_90_days;CoviVac;262;52;314;398663;193123;591786
2022.01_13-10-2022;Орловская область;75_90_days;EpiVacCorona;183;96;279;398663;193123;591786
2022.01_13-10-2022;Орловская область;75_90_days;SputnikLite;7127;7061;14188;398663;193123;591786
2022.01_13-10-2022;Орловская область;75_90_days;SputnikV;24027;6732;30759;398663;193123;591786
2022.01_13-10-2022;Орловская область;90_105_days;AllVaccines;12925;6798;19723;398663;193123;591786
2022.01_13-10-2022;Орловская область;90_105_days;CoviVac;641;139;780;398663;193123;591786
2022.01_13-10-2022;Орловская область;90_105_days;EpiVacCorona;237;137;374;398663;193123;591786
2022.01_13-10-2022;Орловская область;90_105_days;SputnikLite;5217;3306;8523;398663;193123;591786
2022.01_13-10-2022;Орловская область;90_105_days;SputnikV;6830;3216;10046;398663;193123;591786
2022.01_13-10-2022;Пензенская область;105_165_days;AllVaccines;90866;55429;146295;710438;350687;1061125
2022.01_13-10-2022;Пензенская область;105_165_days;CoviVac;434;53;487;710438;350687;1061125
2022.01_13-10-2022;Пензенская область;105_165_days;EpiVacCorona;1085;732;1817;710438;350687;1061125
2022.01_13-10-2022;Пензенская область;105_165_days;SputnikLite;52873;17567;70440;710438;350687;1061125
2022.01_13-10-2022;Пензенская область;105_165_days;SputnikV;36474;37077;73551;710438;350687;1061125
2022.01_13-10-2022;Пензенская область;165_195_days;AllVaccines;85843;21094;106937;710438;350687;1061125
2022.01_13-10-2022;Пензенская область;165_195_days;CoviVac;721;79;800;710438;350687;1061125
2022.01_13-10-2022;Пензенская область;165_195_days;EpiVacCorona;2263;802;3065;710438;350687;1061125
2022.01_13-10-2022;Пензенская область;165_195_days;SputnikLite;35153;6572;41725;710438;350687;1061125
2022.01_13-10-2022;Пензенская область;165_195_days;SputnikV;47706;13641;61347;710438;350687;1061125
2022.01_13-10-2022;Пензенская область;21_45_days;AllVaccines;27176;26078;53254;710438;350687;1061125
2022.01_13-10-2022;Пензенская область;21_45_days;CoviVac;194;112;306;710438;350687;1061125
2022.01_13-10-2022;Пензенская область;21_45_days;EpiVacCorona;914;3062;3976;710438;350687;1061125
2022.01_13-10-2022;Пензенская область;21_45_days;SputnikLite;17905;10151;28056;710438;350687;1061125
2022.01_13-10-2022;Пензенская область;21_45_days;SputnikV;8163;12753;20916;710438;350687;1061125
2022.01_13-10-2022;Пензенская область;45_75_days;AllVaccines;59227;42196;101423;710438;350687;1061125
2022.01_13-10-2022;Пензенская область;45_75_days;CoviVac;827;262;1089;710438;350687;1061125
2022.01_13-10-2022;Пензенская область;45_75_days;EpiVacCorona;1082;1227;2309;710438;350687;1061125
2022.01_13-10-2022;Пензенская область;45_75_days;SputnikLite;15758;10466;26224;710438;350687;1061125
2022.01_13-10-2022;Пензенская область;45_75_days;SputnikV;41560;30241;71801;710438;350687;1061125
2022.01_13-10-2022;Пензенская область;75_90_days;AllVaccines;73807;29708;103515;710438;350687;1061125
2022.01_13-10-2022;Пензенская область;75_90_days;CoviVac;714;105;819;710438;350687;1061125
2022.01_13-10-2022;Пензенская область;75_90_days;EpiVacCorona;387;83;470;710438;350687;1061125
2022.01_13-10-2022;Пензенская область;75_90_days;SputnikLite;8529;5143;13672;710438;350687;1061125
2022.01_13-10-2022;Пензенская область;75_90_days;SputnikV;64177;24377;88554;710438;350687;1061125
2022.01_13-10-2022;Пензенская область;90_105_days;AllVaccines;53278;17564;70842;710438;350687;1061125
2022.01_13-10-2022;Пензенская область;90_105_days;CoviVac;792;106;898;710438;350687;1061125
2022.01_13-10-2022;Пензенская область;90_105_days;EpiVacCorona;1961;469;2430;710438;350687;1061125
2022.01_13-10-2022;Пензенская область;90_105_days;SputnikLite;794;477;1271;710438;350687;1061125
2022.01_13-10-2022;Пензенская область;90_105_days;SputnikV;49731;16512;66243;710438;350687;1061125
2022.01_13-10-2022;Пермский край;105_165_days;AllVaccines;163558;59467;223025;1423011;574038;1997049
2022.01_13-10-2022;Пермский край;105_165_days;CoviVac;2666;529;3195;1423011;574038;1997049
2022.01_13-10-2022;Пермский край;105_165_days;EpiVacCorona;2493;896;3389;1423011;574038;1997049
2022.01_13-10-2022;Пермский край;105_165_days;SputnikLite;69708;33721;103429;1423011;574038;1997049
2022.01_13-10-2022;Пермский край;105_165_days;SputnikV;88691;24321;113012;1423011;574038;1997049
2022.01_13-10-2022;Пермский край;165_195_days;AllVaccines;163438;30697;194135;1423011;574038;1997049
2022.01_13-10-2022;Пермский край;165_195_days;CoviVac;2429;290;2719;1423011;574038;1997049
2022.01_13-10-2022;Пермский край;165_195_days;EpiVacCorona;3588;881;4469;1423011;574038;1997049
2022.01_13-10-2022;Пермский край;165_195_days;SputnikLite;34599;5179;39778;1423011;574038;1997049
2022.01_13-10-2022;Пермский край;165_195_days;SputnikV;122822;24347;147169;1423011;574038;1997049
2022.01_13-10-2022;Пермский край;21_45_days;AllVaccines;45128;25470;70598;1423011;574038;1997049
2022.01_13-10-2022;Пермский край;21_45_days;CoviVac;668;129;797;1423011;574038;1997049
2022.01_13-10-2022;Пермский край;21_45_days;EpiVacCorona;799;309;1108;1423011;574038;1997049
2022.01_13-10-2022;Пермский край;21_45_days;SputnikLite;25934;18824;44758;1423011;574038;1997049
2022.01_13-10-2022;Пермский край;21_45_days;SputnikV;17727;6208;23935;1423011;574038;1997049
2022.01_13-10-2022;Пермский край;45_75_days;AllVaccines;132367;63469;195836;1423011;574038;1997049
2022.01_13-10-2022;Пермский край;45_75_days;CoviVac;1246;273;1519;1423011;574038;1997049
2022.01_13-10-2022;Пермский край;45_75_days;EpiVacCorona;1678;614;2292;1423011;574038;1997049
2022.01_13-10-2022;Пермский край;45_75_days;SputnikLite;29226;27190;56416;1423011;574038;1997049
2022.01_13-10-2022;Пермский край;45_75_days;SputnikV;100217;35392;135609;1423011;574038;1997049
2022.01_13-10-2022;Пермский край;75_90_days;AllVaccines;97231;42122;139353;1423011;574038;1997049
2022.01_13-10-2022;Пермский край;75_90_days;CoviVac;377;73;450;1423011;574038;1997049
2022.01_13-10-2022;Пермский край;75_90_days;EpiVacCorona;1050;304;1354;1423011;574038;1997049
2022.01_13-10-2022;Пермский край;75_90_days;SputnikLite;16718;17198;33916;1423011;574038;1997049
2022.01_13-10-2022;Пермский край;75_90_days;SputnikV;79086;24547;103633;1423011;574038;1997049
2022.01_13-10-2022;Пермский край;90_105_days;AllVaccines;37333;16647;53980;1423011;574038;1997049
2022.01_13-10-2022;Пермский край;90_105_days;CoviVac;924;189;1113;1423011;574038;1997049
2022.01_13-10-2022;Пермский край;90_105_days;EpiVacCorona;1130;451;1581;1423011;574038;1997049
2022.01_13-10-2022;Пермский край;90_105_days;SputnikLite;5062;3244;8306;1423011;574038;1997049
2022.01_13-10-2022;Пермский край;90_105_days;SputnikV;30217;12763;42980;1423011;574038;1997049
2022.01_13-10-2022;Приморский край;105_165_days;AllVaccines;73624;30021;103645;1086430;416518;1502948
2022.01_13-10-2022;Приморский край;105_165_days;CoviVac;1453;173;1626;1086430;416518;1502948
2022.01_13-10-2022;Приморский край;105_165_days;EpiVacCorona;1729;790;2519;1086430;416518;1502948
2022.01_13-10-2022;Приморский край;105_165_days;SputnikLite;33461;18251;51712;1086430;416518;1502948
2022.01_13-10-2022;Приморский край;105_165_days;SputnikV;36981;10807;47788;1086430;416518;1502948
2022.01_13-10-2022;Приморский край;165_195_days;AllVaccines;64570;14176;78746;1086430;416518;1502948
2022.01_13-10-2022;Приморский край;165_195_days;CoviVac;848;67;915;1086430;416518;1502948
2022.01_13-10-2022;Приморский край;165_195_days;EpiVacCorona;1283;470;1753;1086430;416518;1502948
2022.01_13-10-2022;Приморский край;165_195_days;SputnikLite;8178;1209;9387;1086430;416518;1502948
2022.01_13-10-2022;Приморский край;165_195_days;SputnikV;54261;12430;66691;1086430;416518;1502948
2022.01_13-10-2022;Приморский край;21_45_days;AllVaccines;36578;19976;56554;1086430;416518;1502948
2022.01_13-10-2022;Приморский край;21_45_days;CoviVac;248;29;277;1086430;416518;1502948
2022.01_13-10-2022;Приморский край;21_45_days;EpiVacCorona;926;517;1443;1086430;416518;1502948
2022.01_13-10-2022;Приморский край;21_45_days;SputnikLite;17779;13938;31717;1086430;416518;1502948
2022.01_13-10-2022;Приморский край;21_45_days;SputnikV;17625;5492;23117;1086430;416518;1502948
2022.01_13-10-2022;Приморский край;45_75_days;AllVaccines;159010;48231;207241;1086430;416518;1502948
2022.01_13-10-2022;Приморский край;45_75_days;CoviVac;1069;87;1156;1086430;416518;1502948
2022.01_13-10-2022;Приморский край;45_75_days;EpiVacCorona;1827;963;2790;1086430;416518;1502948
2022.01_13-10-2022;Приморский край;45_75_days;SputnikLite;23791;18494;42285;1086430;416518;1502948
2022.01_13-10-2022;Приморский край;45_75_days;SputnikV;132323;28687;161010;1086430;416518;1502948
2022.01_13-10-2022;Приморский край;75_90_days;AllVaccines;95612;22288;117900;1086430;416518;1502948
2022.01_13-10-2022;Приморский край;75_90_days;CoviVac;1857;178;2035;1086430;416518;1502948
2022.01_13-10-2022;Приморский край;75_90_days;EpiVacCorona;1028;298;1326;1086430;416518;1502948
2022.01_13-10-2022;Приморский край;75_90_days;SputnikLite;9840;7635;17475;1086430;416518;1502948
2022.01_13-10-2022;Приморский край;75_90_days;SputnikV;82887;14177;97064;1086430;416518;1502948
2022.01_13-10-2022;Приморский край;90_105_days;AllVaccines;60051;15147;75198;1086430;416518;1502948
2022.01_13-10-2022;Приморский край;90_105_days;CoviVac;1281;111;1392;1086430;416518;1502948
2022.01_13-10-2022;Приморский край;90_105_days;EpiVacCorona;1156;341;1497;1086430;416518;1502948
2022.01_13-10-2022;Приморский край;90_105_days;SputnikLite;15772;5940;21712;1086430;416518;1502948
2022.01_13-10-2022;Приморский край;90_105_days;SputnikV;41842;8755;50597;1086430;416518;1502948
2022.01_13-10-2022;Псковская область;105_165_days;AllVaccines;29687;16534;46221;337881;166663;504544
2022.01_13-10-2022;Псковская область;105_165_days;CoviVac;31;7;38;337881;166663;504544
2022.01_13-10-2022;Псковская область;105_165_days;EpiVacCorona;1020;389;1409;337881;166663;504544
2022.01_13-10-2022;Псковская область;105_165_days;SputnikLite;11353;10409;21762;337881;166663;504544
2022.01_13-10-2022;Псковская область;105_165_days;SputnikV;17283;5729;23012;337881;166663;504544
2022.01_13-10-2022;Псковская область;165_195_days;AllVaccines;41017;9299;50316;337881;166663;504544
2022.01_13-10-2022;Псковская область;165_195_days;CoviVac;223;17;240;337881;166663;504544
2022.01_13-10-2022;Псковская область;165_195_days;EpiVacCorona;6399;1532;7931;337881;166663;504544
2022.01_13-10-2022;Псковская область;165_195_days;SputnikLite;2888;908;3796;337881;166663;504544
2022.01_13-10-2022;Псковская область;165_195_days;SputnikV;31507;6842;38349;337881;166663;504544
2022.01_13-10-2022;Псковская область;21_45_days;AllVaccines;9535;5476;15011;337881;166663;504544
2022.01_13-10-2022;Псковская область;21_45_days;CoviVac;265;24;289;337881;166663;504544
2022.01_13-10-2022;Псковская область;21_45_days;EpiVacCorona;376;257;633;337881;166663;504544
2022.01_13-10-2022;Псковская область;21_45_days;SputnikLite;4182;3517;7699;337881;166663;504544
2022.01_13-10-2022;Псковская область;21_45_days;SputnikV;4712;1678;6390;337881;166663;504544
2022.01_13-10-2022;Псковская область;45_75_days;AllVaccines;24466;14158;38624;337881;166663;504544
2022.01_13-10-2022;Псковская область;45_75_days;CoviVac;452;67;519;337881;166663;504544
2022.01_13-10-2022;Псковская область;45_75_days;EpiVacCorona;884;427;1311;337881;166663;504544
2022.01_13-10-2022;Псковская область;45_75_days;SputnikLite;6796;6515;13311;337881;166663;504544
2022.01_13-10-2022;Псковская область;45_75_days;SputnikV;16334;7149;23483;337881;166663;504544
2022.01_13-10-2022;Псковская область;75_90_days;AllVaccines;13378;8368;21746;337881;166663;504544
2022.01_13-10-2022;Псковская область;75_90_days;CoviVac;313;63;376;337881;166663;504544
2022.01_13-10-2022;Псковская область;75_90_days;EpiVacCorona;549;232;781;337881;166663;504544
2022.01_13-10-2022;Псковская область;75_90_days;SputnikLite;4004;4454;8458;337881;166663;504544
2022.01_13-10-2022;Псковская область;75_90_days;SputnikV;8512;3619;12131;337881;166663;504544
2022.01_13-10-2022;Псковская область;90_105_days;AllVaccines;11005;7747;18752;337881;166663;504544
2022.01_13-10-2022;Псковская область;90_105_days;CoviVac;371;72;443;337881;166663;504544
2022.01_13-10-2022;Псковская область;90_105_days;EpiVacCorona;435;201;636;337881;166663;504544
2022.01_13-10-2022;Псковская область;90_105_days;SputnikLite;3862;4498;8360;337881;166663;504544
2022.01_13-10-2022;Псковская область;90_105_days;SputnikV;6337;2976;9313;337881;166663;504544
2022.01_13-10-2022;РФ;105_165_days;AllVaccines;7684016;3357815;11041831;82332898;33454776;115787674
2022.01_13-10-2022;РФ;105_165_days;CoviVac;105090;21731;126821;82332898;33454776;115787674
2022.01_13-10-2022;РФ;105_165_days;EpiVacCorona;88305;42629;130934;82332898;33454776;115787674
2022.01_13-10-2022;РФ;105_165_days;SputnikLite;3757393;1932970;5690363;82332898;33454776;115787674
2022.01_13-10-2022;РФ;105_165_days;SputnikV;3733228;1360485;5093713;82332898;33454776;115787674
2022.01_13-10-2022;РФ;165_195_days;AllVaccines;8783592;1732915;10516507;82332898;33454776;115787674
2022.01_13-10-2022;РФ;165_195_days;CoviVac;99198;13675;112873;82332898;33454776;115787674
2022.01_13-10-2022;РФ;165_195_days;EpiVacCorona;175137;52634;227771;82332898;33454776;115787674
2022.01_13-10-2022;РФ;165_195_days;SputnikLite;1686621;286794;1973415;82332898;33454776;115787674
2022.01_13-10-2022;РФ;165_195_days;SputnikV;6822636;1379812;8202448;82332898;33454776;115787674
2022.01_13-10-2022;РФ;21_45_days;AllVaccines;2858177;1381215;4239392;82332898;33454776;115787674
2022.01_13-10-2022;РФ;21_45_days;CoviVac;24853;6054;30907;82332898;33454776;115787674
2022.01_13-10-2022;РФ;21_45_days;EpiVacCorona;88662;48679;137341;82332898;33454776;115787674
2022.01_13-10-2022;РФ;21_45_days;SputnikLite;1694220;904759;2598979;82332898;33454776;115787674
2022.01_13-10-2022;РФ;21_45_days;SputnikV;1050442;421723;1472165;82332898;33454776;115787674
2022.01_13-10-2022;РФ;45_75_days;AllVaccines;7058299;3215817;10274116;82332898;33454776;115787674
2022.01_13-10-2022;РФ;45_75_days;CoviVac;91455;19849;111304;82332898;33454776;115787674
2022.01_13-10-2022;РФ;45_75_days;EpiVacCorona;201520;94989;296509;82332898;33454776;115787674
2022.01_13-10-2022;РФ;45_75_days;SputnikLite;1820940;1226347;3047287;82332898;33454776;115787674
2022.01_13-10-2022;РФ;45_75_days;SputnikV;4944384;1874632;6819016;82332898;33454776;115787674
2022.01_13-10-2022;РФ;75_90_days;AllVaccines;4822794;2065064;6887858;82332898;33454776;115787674
2022.01_13-10-2022;РФ;75_90_days;CoviVac;55387;11339;66726;82332898;33454776;115787674
2022.01_13-10-2022;РФ;75_90_days;EpiVacCorona;127829;50483;178312;82332898;33454776;115787674
2022.01_13-10-2022;РФ;75_90_days;SputnikLite;1164458;826457;1990915;82332898;33454776;115787674
2022.01_13-10-2022;РФ;75_90_days;SputnikV;3475120;1176785;4651905;82332898;33454776;115787674
2022.01_13-10-2022;РФ;90_105_days;AllVaccines;3345025;1421285;4766310;82332898;33454776;115787674
2022.01_13-10-2022;РФ;90_105_days;CoviVac;54910;12349;67259;82332898;33454776;115787674
2022.01_13-10-2022;РФ;90_105_days;EpiVacCorona;91336;38599;129935;82332898;33454776;115787674
2022.01_13-10-2022;РФ;90_105_days;SputnikLite;923058;538324;1461382;82332898;33454776;115787674
2022.01_13-10-2022;РФ;90_105_days;SputnikV;2275721;832013;3107734;82332898;33454776;115787674
2022.01_13-10-2022;Республика Адыгея;105_165_days;AllVaccines;25572;9827;35399;256368;104563;360931
2022.01_13-10-2022;Республика Адыгея;105_165_days;CoviVac;42;9;51;256368;104563;360931
2022.01_13-10-2022;Республика Адыгея;105_165_days;EpiVacCorona;138;85;223;256368;104563;360931
2022.01_13-10-2022;Республика Адыгея;105_165_days;SputnikLite;16685;6433;23118;256368;104563;360931
2022.01_13-10-2022;Республика Адыгея;105_165_days;SputnikV;8707;3300;12007;256368;104563;360931
2022.01_13-10-2022;Республика Адыгея;165_195_days;AllVaccines;27073;5713;32786;256368;104563;360931
2022.01_13-10-2022;Республика Адыгея;165_195_days;CoviVac;15;3;18;256368;104563;360931
2022.01_13-10-2022;Республика Адыгея;165_195_days;EpiVacCorona;362;146;508;256368;104563;360931
2022.01_13-10-2022;Республика Адыгея;165_195_days;SputnikLite;3254;941;4195;256368;104563;360931
2022.01_13-10-2022;Республика Адыгея;165_195_days;SputnikV;23442;4623;28065;256368;104563;360931
2022.01_13-10-2022;Республика Адыгея;21_45_days;AllVaccines;7686;3793;11479;256368;104563;360931
2022.01_13-10-2022;Республика Адыгея;21_45_days;CoviVac;46;9;55;256368;104563;360931
2022.01_13-10-2022;Республика Адыгея;21_45_days;EpiVacCorona;311;105;416;256368;104563;360931
2022.01_13-10-2022;Республика Адыгея;21_45_days;SputnikLite;5503;2959;8462;256368;104563;360931
2022.01_13-10-2022;Республика Адыгея;21_45_days;SputnikV;1826;720;2546;256368;104563;360931
2022.01_13-10-2022;Республика Адыгея;45_75_days;AllVaccines;13734;7232;20966;256368;104563;360931
2022.01_13-10-2022;Республика Адыгея;45_75_days;CoviVac;143;42;185;256368;104563;360931
2022.01_13-10-2022;Республика Адыгея;45_75_days;EpiVacCorona;418;277;695;256368;104563;360931
2022.01_13-10-2022;Республика Адыгея;45_75_days;SputnikLite;5427;3456;8883;256368;104563;360931
2022.01_13-10-2022;Республика Адыгея;45_75_days;SputnikV;7746;3457;11203;256368;104563;360931
2022.01_13-10-2022;Республика Адыгея;75_90_days;AllVaccines;10450;4456;14906;256368;104563;360931
2022.01_13-10-2022;Республика Адыгея;75_90_days;CoviVac;131;47;178;256368;104563;360931
2022.01_13-10-2022;Республика Адыгея;75_90_days;EpiVacCorona;298;122;420;256368;104563;360931
2022.01_13-10-2022;Республика Адыгея;75_90_days;SputnikLite;3763;2202;5965;256368;104563;360931
2022.01_13-10-2022;Республика Адыгея;75_90_days;SputnikV;6258;2085;8343;256368;104563;360931
2022.01_13-10-2022;Республика Адыгея;90_105_days;AllVaccines;9290;4254;13544;256368;104563;360931
2022.01_13-10-2022;Республика Адыгея;90_105_days;CoviVac;234;48;282;256368;104563;360931
2022.01_13-10-2022;Республика Адыгея;90_105_days;EpiVacCorona;210;105;315;256368;104563;360931
2022.01_13-10-2022;Республика Адыгея;90_105_days;SputnikLite;4066;2228;6294;256368;104563;360931
2022.01_13-10-2022;Республика Адыгея;90_105_days;SputnikV;4780;1873;6653;256368;104563;360931
2022.01_13-10-2022;Республика Алтай;105_165_days;AllVaccines;9840;4533;14373;117210;36468;153678
2022.01_13-10-2022;Республика Алтай;105_165_days;CoviVac;32;16;48;117210;36468;153678
2022.01_13-10-2022;Республика Алтай;105_165_days;EpiVacCorona;40;31;71;117210;36468;153678
2022.01_13-10-2022;Республика Алтай;105_165_days;SputnikLite;5353;3489;8842;117210;36468;153678
2022.01_13-10-2022;Республика Алтай;105_165_days;SputnikV;4415;997;5412;117210;36468;153678
2022.01_13-10-2022;Республика Алтай;165_195_days;AllVaccines;11876;1977;13853;117210;36468;153678
2022.01_13-10-2022;Республика Алтай;165_195_days;CoviVac;457;70;527;117210;36468;153678
2022.01_13-10-2022;Республика Алтай;165_195_days;EpiVacCorona;60;24;84;117210;36468;153678
2022.01_13-10-2022;Республика Алтай;165_195_days;SputnikLite;2713;616;3329;117210;36468;153678
2022.01_13-10-2022;Республика Алтай;165_195_days;SputnikV;8646;1267;9913;117210;36468;153678
2022.01_13-10-2022;Республика Алтай;21_45_days;AllVaccines;6852;2224;9076;117210;36468;153678
2022.01_13-10-2022;Республика Алтай;21_45_days;CoviVac;70;19;89;117210;36468;153678
2022.01_13-10-2022;Республика Алтай;21_45_days;EpiVacCorona;193;65;258;117210;36468;153678
2022.01_13-10-2022;Республика Алтай;21_45_days;SputnikLite;5123;1686;6809;117210;36468;153678
2022.01_13-10-2022;Республика Алтай;21_45_days;SputnikV;1466;454;1920;117210;36468;153678
2022.01_13-10-2022;Республика Алтай;45_75_days;AllVaccines;10756;3894;14650;117210;36468;153678
2022.01_13-10-2022;Республика Алтай;45_75_days;CoviVac;185;33;218;117210;36468;153678
2022.01_13-10-2022;Республика Алтай;45_75_days;EpiVacCorona;264;89;353;117210;36468;153678
2022.01_13-10-2022;Республика Алтай;45_75_days;SputnikLite;6227;2417;8644;117210;36468;153678
2022.01_13-10-2022;Республика Алтай;45_75_days;SputnikV;4080;1355;5435;117210;36468;153678
2022.01_13-10-2022;Республика Алтай;75_90_days;AllVaccines;4961;2129;7090;117210;36468;153678
2022.01_13-10-2022;Республика Алтай;75_90_days;CoviVac;3;2;5;117210;36468;153678
2022.01_13-10-2022;Республика Алтай;75_90_days;EpiVacCorona;83;28;111;117210;36468;153678
2022.01_13-10-2022;Республика Алтай;75_90_days;SputnikLite;3294;1433;4727;117210;36468;153678
2022.01_13-10-2022;Республика Алтай;75_90_days;SputnikV;1581;666;2247;117210;36468;153678
2022.01_13-10-2022;Республика Алтай;90_105_days;AllVaccines;5119;2623;7742;117210;36468;153678
2022.01_13-10-2022;Республика Алтай;90_105_days;CoviVac;1;4;5;117210;36468;153678
2022.01_13-10-2022;Республика Алтай;90_105_days;EpiVacCorona;70;22;92;117210;36468;153678
2022.01_13-10-2022;Республика Алтай;90_105_days;SputnikLite;4080;2034;6114;117210;36468;153678
2022.01_13-10-2022;Республика Алтай;90_105_days;SputnikV;968;563;1531;117210;36468;153678
2022.01_13-10-2022;Республика Башкортостан;105_165_days;AllVaccines;228834;84314;313148;2235962;869874;3105836
2022.01_13-10-2022;Республика Башкортостан;105_165_days;CoviVac;3209;851;4060;2235962;869874;3105836
2022.01_13-10-2022;Республика Башкортостан;105_165_days;EpiVacCorona;3123;1547;4670;2235962;869874;3105836
2022.01_13-10-2022;Республика Башкортостан;105_165_days;SputnikLite;77923;31943;109866;2235962;869874;3105836
2022.01_13-10-2022;Республика Башкортостан;105_165_days;SputnikV;144579;49973;194552;2235962;869874;3105836
2022.01_13-10-2022;Республика Башкортостан;165_195_days;AllVaccines;246031;48298;294329;2235962;869874;3105836
2022.01_13-10-2022;Республика Башкортостан;165_195_days;CoviVac;3429;501;3930;2235962;869874;3105836
2022.01_13-10-2022;Республика Башкортостан;165_195_days;EpiVacCorona;3381;1140;4521;2235962;869874;3105836
2022.01_13-10-2022;Республика Башкортостан;165_195_days;SputnikLite;40283;8027;48310;2235962;869874;3105836
2022.01_13-10-2022;Республика Башкортостан;165_195_days;SputnikV;198938;38630;237568;2235962;869874;3105836
2022.01_13-10-2022;Республика Башкортостан;21_45_days;AllVaccines;89822;34127;123949;2235962;869874;3105836
2022.01_13-10-2022;Республика Башкортостан;21_45_days;CoviVac;1632;288;1920;2235962;869874;3105836
2022.01_13-10-2022;Республика Башкортостан;21_45_days;EpiVacCorona;4957;2708;7665;2235962;869874;3105836
2022.01_13-10-2022;Республика Башкортостан;21_45_days;SputnikLite;46809;19088;65897;2235962;869874;3105836
2022.01_13-10-2022;Республика Башкортостан;21_45_days;SputnikV;36424;12043;48467;2235962;869874;3105836
2022.01_13-10-2022;Республика Башкортостан;45_75_days;AllVaccines;208723;80835;289558;2235962;869874;3105836
2022.01_13-10-2022;Республика Башкортостан;45_75_days;CoviVac;7016;1839;8855;2235962;869874;3105836
2022.01_13-10-2022;Республика Башкортостан;45_75_days;EpiVacCorona;5077;2568;7645;2235962;869874;3105836
2022.01_13-10-2022;Республика Башкортостан;45_75_days;SputnikLite;50281;24836;75117;2235962;869874;3105836
2022.01_13-10-2022;Республика Башкортостан;45_75_days;SputnikV;146349;51592;197941;2235962;869874;3105836
2022.01_13-10-2022;Республика Башкортостан;75_90_days;AllVaccines;139422;58919;198341;2235962;869874;3105836
2022.01_13-10-2022;Республика Башкортостан;75_90_days;CoviVac;243;69;312;2235962;869874;3105836
2022.01_13-10-2022;Республика Башкортостан;75_90_days;EpiVacCorona;3443;1647;5090;2235962;869874;3105836
2022.01_13-10-2022;Республика Башкортостан;75_90_days;SputnikLite;28462;19070;47532;2235962;869874;3105836
2022.01_13-10-2022;Республика Башкортостан;75_90_days;SputnikV;107274;38133;145407;2235962;869874;3105836
2022.01_13-10-2022;Республика Башкортостан;90_105_days;AllVaccines;163918;48804;212722;2235962;869874;3105836
2022.01_13-10-2022;Республика Башкортостан;90_105_days;CoviVac;544;123;667;2235962;869874;3105836
2022.01_13-10-2022;Республика Башкортостан;90_105_days;EpiVacCorona;4480;2140;6620;2235962;869874;3105836
2022.01_13-10-2022;Республика Башкортостан;90_105_days;SputnikLite;4677;2102;6779;2235962;869874;3105836
2022.01_13-10-2022;Республика Башкортостан;90_105_days;SputnikV;154217;44439;198656;2235962;869874;3105836
2022.01_13-10-2022;Республика Бурятия;105_165_days;AllVaccines;57446;18672;76118;542372;176777;719149
2022.01_13-10-2022;Республика Бурятия;105_165_days;CoviVac;113;35;148;542372;176777;719149
2022.01_13-10-2022;Республика Бурятия;105_165_days;EpiVacCorona;405;132;537;542372;176777;719149
2022.01_13-10-2022;Республика Бурятия;105_165_days;SputnikLite;31225;12075;43300;542372;176777;719149
2022.01_13-10-2022;Республика Бурятия;105_165_days;SputnikV;25703;6430;32133;542372;176777;719149
2022.01_13-10-2022;Республика Бурятия;165_195_days;AllVaccines;59287;12847;72134;542372;176777;719149
2022.01_13-10-2022;Республика Бурятия;165_195_days;CoviVac;321;89;410;542372;176777;719149
2022.01_13-10-2022;Республика Бурятия;165_195_days;EpiVacCorona;832;256;1088;542372;176777;719149
2022.01_13-10-2022;Республика Бурятия;165_195_days;SputnikLite;16406;3183;19589;542372;176777;719149
2022.01_13-10-2022;Республика Бурятия;165_195_days;SputnikV;41728;9319;51047;542372;176777;719149
2022.01_13-10-2022;Республика Бурятия;21_45_days;AllVaccines;24776;9769;34545;542372;176777;719149
2022.01_13-10-2022;Республика Бурятия;21_45_days;CoviVac;171;47;218;542372;176777;719149
2022.01_13-10-2022;Республика Бурятия;21_45_days;EpiVacCorona;615;389;1004;542372;176777;719149
2022.01_13-10-2022;Республика Бурятия;21_45_days;SputnikLite;14763;6287;21050;542372;176777;719149
2022.01_13-10-2022;Республика Бурятия;21_45_days;SputnikV;9227;3046;12273;542372;176777;719149
2022.01_13-10-2022;Республика Бурятия;45_75_days;AllVaccines;51122;21456;72578;542372;176777;719149
2022.01_13-10-2022;Республика Бурятия;45_75_days;CoviVac;753;230;983;542372;176777;719149
2022.01_13-10-2022;Республика Бурятия;45_75_days;EpiVacCorona;494;325;819;542372;176777;719149
2022.01_13-10-2022;Республика Бурятия;45_75_days;SputnikLite;16531;9362;25893;542372;176777;719149
2022.01_13-10-2022;Республика Бурятия;45_75_days;SputnikV;33344;11539;44883;542372;176777;719149
2022.01_13-10-2022;Республика Бурятия;75_90_days;AllVaccines;32922;12359;45281;542372;176777;719149
2022.01_13-10-2022;Республика Бурятия;75_90_days;CoviVac;503;118;621;542372;176777;719149
2022.01_13-10-2022;Республика Бурятия;75_90_days;EpiVacCorona;468;275;743;542372;176777;719149
2022.01_13-10-2022;Республика Бурятия;75_90_days;SputnikLite;8653;5386;14039;542372;176777;719149
2022.01_13-10-2022;Республика Бурятия;75_90_days;SputnikV;23298;6580;29878;542372;176777;719149
2022.01_13-10-2022;Республика Бурятия;90_105_days;AllVaccines;15010;6535;21545;542372;176777;719149
2022.01_13-10-2022;Республика Бурятия;90_105_days;CoviVac;195;35;230;542372;176777;719149
2022.01_13-10-2022;Республика Бурятия;90_105_days;EpiVacCorona;458;213;671;542372;176777;719149
2022.01_13-10-2022;Республика Бурятия;90_105_days;SputnikLite;5724;2595;8319;542372;176777;719149
2022.01_13-10-2022;Республика Бурятия;90_105_days;SputnikV;8633;3692;12325;542372;176777;719149
2022.01_13-10-2022;Республика Дагестан;105_165_days;AllVaccines;114426;29664;144090;1856109;394621;2250730
2022.01_13-10-2022;Республика Дагестан;105_165_days;CoviVac;831;231;1062;1856109;394621;2250730
2022.01_13-10-2022;Республика Дагестан;105_165_days;EpiVacCorona;824;270;1094;1856109;394621;2250730
2022.01_13-10-2022;Республика Дагестан;105_165_days;SputnikLite;43759;9285;53044;1856109;394621;2250730
2022.01_13-10-2022;Республика Дагестан;105_165_days;SputnikV;69012;19878;88890;1856109;394621;2250730
2022.01_13-10-2022;Республика Дагестан;165_195_days;AllVaccines;126715;18207;144922;1856109;394621;2250730
2022.01_13-10-2022;Республика Дагестан;165_195_days;CoviVac;724;174;898;1856109;394621;2250730
2022.01_13-10-2022;Республика Дагестан;165_195_days;EpiVacCorona;5570;905;6475;1856109;394621;2250730
2022.01_13-10-2022;Республика Дагестан;165_195_days;SputnikLite;34533;4601;39134;1856109;394621;2250730
2022.01_13-10-2022;Республика Дагестан;165_195_days;SputnikV;85888;12527;98415;1856109;394621;2250730
2022.01_13-10-2022;Республика Дагестан;21_45_days;AllVaccines;62223;14683;76906;1856109;394621;2250730
2022.01_13-10-2022;Республика Дагестан;21_45_days;CoviVac;577;117;694;1856109;394621;2250730
2022.01_13-10-2022;Республика Дагестан;21_45_days;EpiVacCorona;9068;1772;10840;1856109;394621;2250730
2022.01_13-10-2022;Республика Дагестан;21_45_days;SputnikLite;15897;4332;20229;1856109;394621;2250730
2022.01_13-10-2022;Республика Дагестан;21_45_days;SputnikV;36681;8462;45143;1856109;394621;2250730
2022.01_13-10-2022;Республика Дагестан;45_75_days;AllVaccines;91504;15870;107374;1856109;394621;2250730
2022.01_13-10-2022;Республика Дагестан;45_75_days;CoviVac;1175;204;1379;1856109;394621;2250730
2022.01_13-10-2022;Республика Дагестан;45_75_days;EpiVacCorona;7136;1147;8283;1856109;394621;2250730
2022.01_13-10-2022;Республика Дагестан;45_75_days;SputnikLite;25102;4730;29832;1856109;394621;2250730
2022.01_13-10-2022;Республика Дагестан;45_75_days;SputnikV;58091;9789;67880;1856109;394621;2250730
2022.01_13-10-2022;Республика Дагестан;75_90_days;AllVaccines;71770;9598;81368;1856109;394621;2250730
2022.01_13-10-2022;Республика Дагестан;75_90_days;CoviVac;475;64;539;1856109;394621;2250730
2022.01_13-10-2022;Республика Дагестан;75_90_days;EpiVacCorona;4755;562;5317;1856109;394621;2250730
2022.01_13-10-2022;Республика Дагестан;75_90_days;SputnikLite;7343;1526;8869;1856109;394621;2250730
2022.01_13-10-2022;Республика Дагестан;75_90_days;SputnikV;59197;7446;66643;1856109;394621;2250730
2022.01_13-10-2022;Республика Дагестан;90_105_days;AllVaccines;32942;7018;39960;1856109;394621;2250730
2022.01_13-10-2022;Республика Дагестан;90_105_days;CoviVac;335;87;422;1856109;394621;2250730
2022.01_13-10-2022;Республика Дагестан;90_105_days;EpiVacCorona;1492;227;1719;1856109;394621;2250730
2022.01_13-10-2022;Республика Дагестан;90_105_days;SputnikLite;11912;1788;13700;1856109;394621;2250730
2022.01_13-10-2022;Республика Дагестан;90_105_days;SputnikV;19203;4916;24119;1856109;394621;2250730
2022.01_13-10-2022;Республика Ингушетия;105_165_days;AllVaccines;24019;3903;27922;295583;61477;357060
2022.01_13-10-2022;Республика Ингушетия;105_165_days;CoviVac;28;5;33;295583;61477;357060
2022.01_13-10-2022;Республика Ингушетия;105_165_days;EpiVacCorona;135;7;142;295583;61477;357060
2022.01_13-10-2022;Республика Ингушетия;105_165_days;SputnikLite;7864;1360;9224;295583;61477;357060
2022.01_13-10-2022;Республика Ингушетия;105_165_days;SputnikV;15992;2531;18523;295583;61477;357060
2022.01_13-10-2022;Республика Ингушетия;165_195_days;AllVaccines;34715;4924;39639;295583;61477;357060
2022.01_13-10-2022;Республика Ингушетия;165_195_days;CoviVac;569;79;648;295583;61477;357060
2022.01_13-10-2022;Республика Ингушетия;165_195_days;EpiVacCorona;543;74;617;295583;61477;357060
2022.01_13-10-2022;Республика Ингушетия;165_195_days;SputnikLite;6037;833;6870;295583;61477;357060
2022.01_13-10-2022;Республика Ингушетия;165_195_days;SputnikV;27566;3938;31504;295583;61477;357060
2022.01_13-10-2022;Республика Ингушетия;21_45_days;AllVaccines;18797;3317;22114;295583;61477;357060
2022.01_13-10-2022;Республика Ингушетия;21_45_days;CoviVac;42;29;71;295583;61477;357060
2022.01_13-10-2022;Республика Ингушетия;21_45_days;EpiVacCorona;87;34;121;295583;61477;357060
2022.01_13-10-2022;Республика Ингушетия;21_45_days;SputnikLite;11578;1761;13339;295583;61477;357060
2022.01_13-10-2022;Республика Ингушетия;21_45_days;SputnikV;7090;1493;8583;295583;61477;357060
2022.01_13-10-2022;Республика Ингушетия;45_75_days;AllVaccines;44149;9845;53994;295583;61477;357060
2022.01_13-10-2022;Республика Ингушетия;45_75_days;CoviVac;340;159;499;295583;61477;357060
2022.01_13-10-2022;Республика Ингушетия;45_75_days;EpiVacCorona;588;148;736;295583;61477;357060
2022.01_13-10-2022;Республика Ингушетия;45_75_days;SputnikLite;22812;4786;27598;295583;61477;357060
2022.01_13-10-2022;Республика Ингушетия;45_75_days;SputnikV;20409;4752;25161;295583;61477;357060
2022.01_13-10-2022;Республика Ингушетия;75_90_days;AllVaccines;9374;2033;11407;295583;61477;357060
2022.01_13-10-2022;Республика Ингушетия;75_90_days;CoviVac;8;7;15;295583;61477;357060
2022.01_13-10-2022;Республика Ингушетия;75_90_days;SputnikLite;5048;1340;6388;295583;61477;357060
2022.01_13-10-2022;Республика Ингушетия;75_90_days;SputnikV;4318;686;5004;295583;61477;357060
2022.01_13-10-2022;Республика Ингушетия;90_105_days;AllVaccines;6874;1608;8482;295583;61477;357060
2022.01_13-10-2022;Республика Ингушетия;90_105_days;CoviVac;1;0;1;295583;61477;357060
2022.01_13-10-2022;Республика Ингушетия;90_105_days;SputnikLite;3383;925;4308;295583;61477;357060
2022.01_13-10-2022;Республика Ингушетия;90_105_days;SputnikV;3490;683;4173;295583;61477;357060
2022.01_13-10-2022;Республика Калмыкия;105_165_days;AllVaccines;13664;8618;22282;150440;54890;205330
2022.01_13-10-2022;Республика Калмыкия;105_165_days;CoviVac;167;42;209;150440;54890;205330
2022.01_13-10-2022;Республика Калмыкия;105_165_days;EpiVacCorona;16;11;27;150440;54890;205330
2022.01_13-10-2022;Республика Калмыкия;105_165_days;SputnikLite;11500;7501;19001;150440;54890;205330
2022.01_13-10-2022;Республика Калмыкия;105_165_days;SputnikV;1981;1064;3045;150440;54890;205330
2022.01_13-10-2022;Республика Калмыкия;165_195_days;AllVaccines;10777;2722;13499;150440;54890;205330
2022.01_13-10-2022;Республика Калмыкия;165_195_days;CoviVac;263;38;301;150440;54890;205330
2022.01_13-10-2022;Республика Калмыкия;165_195_days;EpiVacCorona;27;6;33;150440;54890;205330
2022.01_13-10-2022;Республика Калмыкия;165_195_days;SputnikLite;3611;861;4472;150440;54890;205330
2022.01_13-10-2022;Республика Калмыкия;165_195_days;SputnikV;6876;1817;8693;150440;54890;205330
2022.01_13-10-2022;Республика Калмыкия;21_45_days;AllVaccines;5250;2252;7502;150440;54890;205330
2022.01_13-10-2022;Республика Калмыкия;21_45_days;CoviVac;49;12;61;150440;54890;205330
2022.01_13-10-2022;Республика Калмыкия;21_45_days;EpiVacCorona;268;143;411;150440;54890;205330
2022.01_13-10-2022;Республика Калмыкия;21_45_days;SputnikLite;4423;1918;6341;150440;54890;205330
2022.01_13-10-2022;Республика Калмыкия;21_45_days;SputnikV;510;179;689;150440;54890;205330
2022.01_13-10-2022;Республика Калмыкия;45_75_days;AllVaccines;10241;4249;14490;150440;54890;205330
2022.01_13-10-2022;Республика Калмыкия;45_75_days;CoviVac;294;67;361;150440;54890;205330
2022.01_13-10-2022;Республика Калмыкия;45_75_days;EpiVacCorona;129;87;216;150440;54890;205330
2022.01_13-10-2022;Республика Калмыкия;45_75_days;SputnikLite;7325;3185;10510;150440;54890;205330
2022.01_13-10-2022;Республика Калмыкия;45_75_days;SputnikV;2493;910;3403;150440;54890;205330
2022.01_13-10-2022;Республика Калмыкия;75_90_days;AllVaccines;8503;3468;11971;150440;54890;205330
2022.01_13-10-2022;Республика Калмыкия;75_90_days;CoviVac;293;58;351;150440;54890;205330
2022.01_13-10-2022;Республика Калмыкия;75_90_days;EpiVacCorona;55;20;75;150440;54890;205330
2022.01_13-10-2022;Республика Калмыкия;75_90_days;SputnikLite;6240;2627;8867;150440;54890;205330
2022.01_13-10-2022;Республика Калмыкия;75_90_days;SputnikV;1915;763;2678;150440;54890;205330
2022.01_13-10-2022;Республика Калмыкия;90_105_days;AllVaccines;11064;4835;15899;150440;54890;205330
2022.01_13-10-2022;Республика Калмыкия;90_105_days;CoviVac;170;37;207;150440;54890;205330
2022.01_13-10-2022;Республика Калмыкия;90_105_days;EpiVacCorona;11;8;19;150440;54890;205330
2022.01_13-10-2022;Республика Калмыкия;90_105_days;SputnikLite;10035;4228;14263;150440;54890;205330
2022.01_13-10-2022;Республика Калмыкия;90_105_days;SputnikV;848;562;1410;150440;54890;205330
2022.01_13-10-2022;Республика Карелия;105_165_days;AllVaccines;39321;23589;62910;334874;149526;484400
2022.01_13-10-2022;Республика Карелия;105_165_days;CoviVac;44;11;55;334874;149526;484400
2022.01_13-10-2022;Республика Карелия;105_165_days;EpiVacCorona;112;113;225;334874;149526;484400
2022.01_13-10-2022;Республика Карелия;105_165_days;SputnikLite;28559;16539;45098;334874;149526;484400
2022.01_13-10-2022;Республика Карелия;105_165_days;SputnikV;10606;6926;17532;334874;149526;484400
2022.01_13-10-2022;Республика Карелия;165_195_days;AllVaccines;42988;8754;51742;334874;149526;484400
2022.01_13-10-2022;Республика Карелия;165_195_days;CoviVac;206;23;229;334874;149526;484400
2022.01_13-10-2022;Республика Карелия;165_195_days;EpiVacCorona;398;112;510;334874;149526;484400
2022.01_13-10-2022;Республика Карелия;165_195_days;SputnikLite;15114;2758;17872;334874;149526;484400
2022.01_13-10-2022;Республика Карелия;165_195_days;SputnikV;27270;5861;33131;334874;149526;484400
2022.01_13-10-2022;Республика Карелия;21_45_days;AllVaccines;10774;6140;16914;334874;149526;484400
2022.01_13-10-2022;Республика Карелия;21_45_days;CoviVac;240;67;307;334874;149526;484400
2022.01_13-10-2022;Республика Карелия;21_45_days;EpiVacCorona;339;220;559;334874;149526;484400
2022.01_13-10-2022;Республика Карелия;21_45_days;SputnikLite;6846;4181;11027;334874;149526;484400
2022.01_13-10-2022;Республика Карелия;21_45_days;SputnikV;3349;1672;5021;334874;149526;484400
2022.01_13-10-2022;Республика Карелия;45_75_days;AllVaccines;24224;14818;39042;334874;149526;484400
2022.01_13-10-2022;Республика Карелия;45_75_days;CoviVac;572;122;694;334874;149526;484400
2022.01_13-10-2022;Республика Карелия;45_75_days;EpiVacCorona;1005;539;1544;334874;149526;484400
2022.01_13-10-2022;Республика Карелия;45_75_days;SputnikLite;8332;6619;14951;334874;149526;484400
2022.01_13-10-2022;Республика Карелия;45_75_days;SputnikV;14315;7538;21853;334874;149526;484400
2022.01_13-10-2022;Республика Карелия;75_90_days;AllVaccines;13278;10194;23472;334874;149526;484400
2022.01_13-10-2022;Республика Карелия;75_90_days;CoviVac;295;79;374;334874;149526;484400
2022.01_13-10-2022;Республика Карелия;75_90_days;EpiVacCorona;330;206;536;334874;149526;484400
2022.01_13-10-2022;Республика Карелия;75_90_days;SputnikLite;6514;5748;12262;334874;149526;484400
2022.01_13-10-2022;Республика Карелия;75_90_days;SputnikV;6139;4161;10300;334874;149526;484400
2022.01_13-10-2022;Республика Карелия;90_105_days;AllVaccines;11493;10727;22220;334874;149526;484400
2022.01_13-10-2022;Республика Карелия;90_105_days;CoviVac;433;103;536;334874;149526;484400
2022.01_13-10-2022;Республика Карелия;90_105_days;EpiVacCorona;152;140;292;334874;149526;484400
2022.01_13-10-2022;Республика Карелия;90_105_days;SputnikLite;6574;7169;13743;334874;149526;484400
2022.01_13-10-2022;Республика Карелия;90_105_days;SputnikV;4334;3315;7649;334874;149526;484400
2022.01_13-10-2022;Республика Коми;105_165_days;AllVaccines;40567;14506;55073;465210;166370;631580
2022.01_13-10-2022;Республика Коми;105_165_days;CoviVac;83;11;94;465210;166370;631580
2022.01_13-10-2022;Республика Коми;105_165_days;EpiVacCorona;3;4;7;465210;166370;631580
2022.01_13-10-2022;Республика Коми;105_165_days;SputnikLite;23578;9005;32583;465210;166370;631580
2022.01_13-10-2022;Республика Коми;105_165_days;SputnikV;16903;5486;22389;465210;166370;631580
2022.01_13-10-2022;Республика Коми;165_195_days;AllVaccines;60082;9255;69337;465210;166370;631580
2022.01_13-10-2022;Республика Коми;165_195_days;CoviVac;463;46;509;465210;166370;631580
2022.01_13-10-2022;Республика Коми;165_195_days;EpiVacCorona;47;14;61;465210;166370;631580
2022.01_13-10-2022;Республика Коми;165_195_days;SputnikLite;17526;1650;19176;465210;166370;631580
2022.01_13-10-2022;Республика Коми;165_195_days;SputnikV;42046;7545;49591;465210;166370;631580
2022.01_13-10-2022;Республика Коми;21_45_days;AllVaccines;15097;7182;22279;465210;166370;631580
2022.01_13-10-2022;Республика Коми;21_45_days;CoviVac;198;53;251;465210;166370;631580
2022.01_13-10-2022;Республика Коми;21_45_days;EpiVacCorona;453;191;644;465210;166370;631580
2022.01_13-10-2022;Республика Коми;21_45_days;SputnikLite;10139;4755;14894;465210;166370;631580
2022.01_13-10-2022;Республика Коми;21_45_days;SputnikV;4307;2183;6490;465210;166370;631580
2022.01_13-10-2022;Республика Коми;45_75_days;AllVaccines;29366;14552;43918;465210;166370;631580
2022.01_13-10-2022;Республика Коми;45_75_days;CoviVac;399;99;498;465210;166370;631580
2022.01_13-10-2022;Республика Коми;45_75_days;EpiVacCorona;948;415;1363;465210;166370;631580
2022.01_13-10-2022;Республика Коми;45_75_days;SputnikLite;11301;6589;17890;465210;166370;631580
2022.01_13-10-2022;Республика Коми;45_75_days;SputnikV;16718;7449;24167;465210;166370;631580
2022.01_13-10-2022;Республика Коми;75_90_days;AllVaccines;18561;9934;28495;465210;166370;631580
2022.01_13-10-2022;Республика Коми;75_90_days;CoviVac;212;46;258;465210;166370;631580
2022.01_13-10-2022;Республика Коми;75_90_days;EpiVacCorona;326;127;453;465210;166370;631580
2022.01_13-10-2022;Республика Коми;75_90_days;SputnikLite;10614;6142;16756;465210;166370;631580
2022.01_13-10-2022;Республика Коми;75_90_days;SputnikV;7409;3619;11028;465210;166370;631580
2022.01_13-10-2022;Республика Коми;90_105_days;AllVaccines;14742;7838;22580;465210;166370;631580
2022.01_13-10-2022;Республика Коми;90_105_days;CoviVac;245;52;297;465210;166370;631580
2022.01_13-10-2022;Республика Коми;90_105_days;EpiVacCorona;107;35;142;465210;166370;631580
2022.01_13-10-2022;Республика Коми;90_105_days;SputnikLite;10510;5226;15736;465210;166370;631580
2022.01_13-10-2022;Республика Коми;90_105_days;SputnikV;3880;2525;6405;465210;166370;631580
2022.01_13-10-2022;Республика Крым;105_165_days;AllVaccines;83743;36197;119940;1036087;480146;1516233
2022.01_13-10-2022;Республика Крым;105_165_days;CoviVac;1286;357;1643;1036087;480146;1516233
2022.01_13-10-2022;Республика Крым;105_165_days;EpiVacCorona;1024;519;1543;1036087;480146;1516233
2022.01_13-10-2022;Республика Крым;105_165_days;SputnikLite;24399;22266;46665;1036087;480146;1516233
2022.01_13-10-2022;Республика Крым;105_165_days;SputnikV;57034;13055;70089;1036087;480146;1516233
2022.01_13-10-2022;Республика Крым;165_195_days;AllVaccines;61140;15749;76889;1036087;480146;1516233
2022.01_13-10-2022;Республика Крым;165_195_days;CoviVac;605;130;735;1036087;480146;1516233
2022.01_13-10-2022;Республика Крым;165_195_days;EpiVacCorona;1279;621;1900;1036087;480146;1516233
2022.01_13-10-2022;Республика Крым;165_195_days;SputnikLite;2159;1591;3750;1036087;480146;1516233
2022.01_13-10-2022;Республика Крым;165_195_days;SputnikV;57097;13407;70504;1036087;480146;1516233
2022.01_13-10-2022;Республика Крым;21_45_days;AllVaccines;44566;25663;70229;1036087;480146;1516233
2022.01_13-10-2022;Республика Крым;21_45_days;CoviVac;204;61;265;1036087;480146;1516233
2022.01_13-10-2022;Республика Крым;21_45_days;EpiVacCorona;1421;836;2257;1036087;480146;1516233
2022.01_13-10-2022;Республика Крым;21_45_days;SputnikLite;27157;19914;47071;1036087;480146;1516233
2022.01_13-10-2022;Республика Крым;21_45_days;SputnikV;15784;4852;20636;1036087;480146;1516233
2022.01_13-10-2022;Республика Крым;45_75_days;AllVaccines;126447;62235;188682;1036087;480146;1516233
2022.01_13-10-2022;Республика Крым;45_75_days;CoviVac;1010;346;1356;1036087;480146;1516233
2022.01_13-10-2022;Республика Крым;45_75_days;EpiVacCorona;2667;1326;3993;1036087;480146;1516233
2022.01_13-10-2022;Республика Крым;45_75_days;SputnikLite;32315;32698;65013;1036087;480146;1516233
2022.01_13-10-2022;Республика Крым;45_75_days;SputnikV;90455;27865;118320;1036087;480146;1516233
2022.01_13-10-2022;Республика Крым;75_90_days;AllVaccines;140789;42771;183560;1036087;480146;1516233
2022.01_13-10-2022;Республика Крым;75_90_days;CoviVac;841;206;1047;1036087;480146;1516233
2022.01_13-10-2022;Республика Крым;75_90_days;EpiVacCorona;2674;926;3600;1036087;480146;1516233
2022.01_13-10-2022;Республика Крым;75_90_days;SputnikLite;16162;18870;35032;1036087;480146;1516233
2022.01_13-10-2022;Республика Крым;75_90_days;SputnikV;121112;22769;143881;1036087;480146;1516233
2022.01_13-10-2022;Республика Крым;90_105_days;AllVaccines;73491;13326;86817;1036087;480146;1516233
2022.01_13-10-2022;Республика Крым;90_105_days;CoviVac;1206;245;1451;1036087;480146;1516233
2022.01_13-10-2022;Республика Крым;90_105_days;EpiVacCorona;2927;820;3747;1036087;480146;1516233
2022.01_13-10-2022;Республика Крым;90_105_days;SputnikLite;2733;2135;4868;1036087;480146;1516233
2022.01_13-10-2022;Республика Крым;90_105_days;SputnikV;66625;10126;76751;1036087;480146;1516233
2022.01_13-10-2022;Республика Марий Эл;105_165_days;AllVaccines;52284;15932;68216;370626;156749;527375
2022.01_13-10-2022;Республика Марий Эл;105_165_days;CoviVac;40;10;50;370626;156749;527375
2022.01_13-10-2022;Республика Марий Эл;105_165_days;EpiVacCorona;174;77;251;370626;156749;527375
2022.01_13-10-2022;Республика Марий Эл;105_165_days;SputnikLite;41611;10853;52464;370626;156749;527375
2022.01_13-10-2022;Республика Марий Эл;105_165_days;SputnikV;10459;4992;15451;370626;156749;527375
2022.01_13-10-2022;Республика Марий Эл;165_195_days;AllVaccines;50533;7727;58260;370626;156749;527375
2022.01_13-10-2022;Республика Марий Эл;165_195_days;CoviVac;261;43;304;370626;156749;527375
2022.01_13-10-2022;Республика Марий Эл;165_195_days;EpiVacCorona;421;221;642;370626;156749;527375
2022.01_13-10-2022;Республика Марий Эл;165_195_days;SputnikLite;23300;1753;25053;370626;156749;527375
2022.01_13-10-2022;Республика Марий Эл;165_195_days;SputnikV;26551;5710;32261;370626;156749;527375
2022.01_13-10-2022;Республика Марий Эл;21_45_days;AllVaccines;11938;6584;18522;370626;156749;527375
2022.01_13-10-2022;Республика Марий Эл;21_45_days;CoviVac;81;45;126;370626;156749;527375
2022.01_13-10-2022;Республика Марий Эл;21_45_days;EpiVacCorona;350;210;560;370626;156749;527375
2022.01_13-10-2022;Республика Марий Эл;21_45_days;SputnikLite;8078;4806;12884;370626;156749;527375
2022.01_13-10-2022;Республика Марий Эл;21_45_days;SputnikV;3429;1523;4952;370626;156749;527375
2022.01_13-10-2022;Республика Марий Эл;45_75_days;AllVaccines;41131;15683;56814;370626;156749;527375
2022.01_13-10-2022;Республика Марий Эл;45_75_days;CoviVac;471;139;610;370626;156749;527375
2022.01_13-10-2022;Республика Марий Эл;45_75_days;EpiVacCorona;1652;681;2333;370626;156749;527375
2022.01_13-10-2022;Республика Марий Эл;45_75_days;SputnikLite;14596;6047;20643;370626;156749;527375
2022.01_13-10-2022;Республика Марий Эл;45_75_days;SputnikV;24412;8816;33228;370626;156749;527375
2022.01_13-10-2022;Республика Марий Эл;75_90_days;AllVaccines;27685;10186;37871;370626;156749;527375
2022.01_13-10-2022;Республика Марий Эл;75_90_days;CoviVac;186;50;236;370626;156749;527375
2022.01_13-10-2022;Республика Марий Эл;75_90_days;EpiVacCorona;2250;540;2790;370626;156749;527375
2022.01_13-10-2022;Республика Марий Эл;75_90_days;SputnikLite;10017;4435;14452;370626;156749;527375
2022.01_13-10-2022;Республика Марий Эл;75_90_days;SputnikV;15232;5161;20393;370626;156749;527375
2022.01_13-10-2022;Республика Марий Эл;90_105_days;AllVaccines;15549;7784;23333;370626;156749;527375
2022.01_13-10-2022;Республика Марий Эл;90_105_days;CoviVac;239;72;311;370626;156749;527375
2022.01_13-10-2022;Республика Марий Эл;90_105_days;EpiVacCorona;1129;371;1500;370626;156749;527375
2022.01_13-10-2022;Республика Марий Эл;90_105_days;SputnikLite;4809;3550;8359;370626;156749;527375
2022.01_13-10-2022;Республика Марий Эл;90_105_days;SputnikV;9372;3791;13163;370626;156749;527375
2022.01_13-10-2022;Республика Мордовия;105_165_days;AllVaccines;52060;35981;88041;448319;198808;647127
2022.01_13-10-2022;Республика Мордовия;105_165_days;CoviVac;42;3;45;448319;198808;647127
2022.01_13-10-2022;Республика Мордовия;105_165_days;EpiVacCorona;232;121;353;448319;198808;647127
2022.01_13-10-2022;Республика Мордовия;105_165_days;SputnikLite;32589;20190;52779;448319;198808;647127
2022.01_13-10-2022;Республика Мордовия;105_165_days;SputnikV;19197;15667;34864;448319;198808;647127
2022.01_13-10-2022;Республика Мордовия;165_195_days;AllVaccines;57304;12521;69825;448319;198808;647127
2022.01_13-10-2022;Республика Мордовия;165_195_days;CoviVac;154;23;177;448319;198808;647127
2022.01_13-10-2022;Республика Мордовия;165_195_days;EpiVacCorona;478;122;600;448319;198808;647127
2022.01_13-10-2022;Республика Мордовия;165_195_days;SputnikLite;12594;3647;16241;448319;198808;647127
2022.01_13-10-2022;Республика Мордовия;165_195_days;SputnikV;44078;8729;52807;448319;198808;647127
2022.01_13-10-2022;Республика Мордовия;21_45_days;AllVaccines;23374;10738;34112;448319;198808;647127
2022.01_13-10-2022;Республика Мордовия;21_45_days;CoviVac;176;48;224;448319;198808;647127
2022.01_13-10-2022;Республика Мордовия;21_45_days;EpiVacCorona;978;575;1553;448319;198808;647127
2022.01_13-10-2022;Республика Мордовия;21_45_days;SputnikLite;17724;7345;25069;448319;198808;647127
2022.01_13-10-2022;Республика Мордовия;21_45_days;SputnikV;4496;2770;7266;448319;198808;647127
2022.01_13-10-2022;Республика Мордовия;45_75_days;AllVaccines;39653;20852;60505;448319;198808;647127
2022.01_13-10-2022;Республика Мордовия;45_75_days;CoviVac;738;219;957;448319;198808;647127
2022.01_13-10-2022;Республика Мордовия;45_75_days;EpiVacCorona;1380;598;1978;448319;198808;647127
2022.01_13-10-2022;Республика Мордовия;45_75_days;SputnikLite;14571;9061;23632;448319;198808;647127
2022.01_13-10-2022;Республика Мордовия;45_75_days;SputnikV;22964;10974;33938;448319;198808;647127
2022.01_13-10-2022;Республика Мордовия;75_90_days;AllVaccines;31679;18527;50206;448319;198808;647127
2022.01_13-10-2022;Республика Мордовия;75_90_days;CoviVac;583;142;725;448319;198808;647127
2022.01_13-10-2022;Республика Мордовия;75_90_days;EpiVacCorona;795;279;1074;448319;198808;647127
2022.01_13-10-2022;Республика Мордовия;75_90_days;SputnikLite;12004;8908;20912;448319;198808;647127
2022.01_13-10-2022;Республика Мордовия;75_90_days;SputnikV;18297;9198;27495;448319;198808;647127
2022.01_13-10-2022;Республика Мордовия;90_105_days;AllVaccines;20673;10003;30676;448319;198808;647127
2022.01_13-10-2022;Республика Мордовия;90_105_days;CoviVac;355;108;463;448319;198808;647127
2022.01_13-10-2022;Республика Мордовия;90_105_days;EpiVacCorona;712;217;929;448319;198808;647127
2022.01_13-10-2022;Республика Мордовия;90_105_days;SputnikLite;4811;3800;8611;448319;198808;647127
2022.01_13-10-2022;Республика Мордовия;90_105_days;SputnikV;14795;5878;20673;448319;198808;647127
2022.01_13-10-2022;Республика Саха (Якутия);105_165_days;AllVaccines;58132;13885;72017;568643;148395;717038
2022.01_13-10-2022;Республика Саха (Якутия);105_165_days;CoviVac;28;8;36;568643;148395;717038
2022.01_13-10-2022;Республика Саха (Якутия);105_165_days;EpiVacCorona;1912;405;2317;568643;148395;717038
2022.01_13-10-2022;Республика Саха (Якутия);105_165_days;SputnikLite;43082;10185;53267;568643;148395;717038
2022.01_13-10-2022;Республика Саха (Якутия);105_165_days;SputnikV;13110;3287;16397;568643;148395;717038
2022.01_13-10-2022;Республика Саха (Якутия);165_195_days;AllVaccines;61742;6193;67935;568643;148395;717038
2022.01_13-10-2022;Республика Саха (Якутия);165_195_days;CoviVac;15;1;16;568643;148395;717038
2022.01_13-10-2022;Республика Саха (Якутия);165_195_days;EpiVacCorona;13289;2118;15407;568643;148395;717038
2022.01_13-10-2022;Республика Саха (Якутия);165_195_days;SputnikLite;32955;2173;35128;568643;148395;717038
2022.01_13-10-2022;Республика Саха (Якутия);165_195_days;SputnikV;15483;1901;17384;568643;148395;717038
2022.01_13-10-2022;Республика Саха (Якутия);21_45_days;AllVaccines;24290;6287;30577;568643;148395;717038
2022.01_13-10-2022;Республика Саха (Якутия);21_45_days;CoviVac;205;22;227;568643;148395;717038
2022.01_13-10-2022;Республика Саха (Якутия);21_45_days;EpiVacCorona;266;90;356;568643;148395;717038
2022.01_13-10-2022;Республика Саха (Якутия);21_45_days;SputnikLite;16541;4097;20638;568643;148395;717038
2022.01_13-10-2022;Республика Саха (Якутия);21_45_days;SputnikV;7278;2078;9356;568643;148395;717038
2022.01_13-10-2022;Республика Саха (Якутия);45_75_days;AllVaccines;42280;12389;54669;568643;148395;717038
2022.01_13-10-2022;Республика Саха (Якутия);45_75_days;CoviVac;888;117;1005;568643;148395;717038
2022.01_13-10-2022;Республика Саха (Якутия);45_75_days;EpiVacCorona;389;172;561;568643;148395;717038
2022.01_13-10-2022;Республика Саха (Якутия);45_75_days;SputnikLite;18107;5815;23922;568643;148395;717038
2022.01_13-10-2022;Республика Саха (Якутия);45_75_days;SputnikV;22896;6285;29181;568643;148395;717038
2022.01_13-10-2022;Республика Саха (Якутия);75_90_days;AllVaccines;24945;7431;32376;568643;148395;717038
2022.01_13-10-2022;Республика Саха (Якутия);75_90_days;CoviVac;742;118;860;568643;148395;717038
2022.01_13-10-2022;Республика Саха (Якутия);75_90_days;EpiVacCorona;179;87;266;568643;148395;717038
2022.01_13-10-2022;Республика Саха (Якутия);75_90_days;SputnikLite;11633;3909;15542;568643;148395;717038
2022.01_13-10-2022;Республика Саха (Якутия);75_90_days;SputnikV;12391;3317;15708;568643;148395;717038
2022.01_13-10-2022;Республика Саха (Якутия);90_105_days;AllVaccines;23485;6901;30386;568643;148395;717038
2022.01_13-10-2022;Республика Саха (Якутия);90_105_days;CoviVac;196;61;257;568643;148395;717038
2022.01_13-10-2022;Республика Саха (Якутия);90_105_days;EpiVacCorona;219;100;319;568643;148395;717038
2022.01_13-10-2022;Республика Саха (Якутия);90_105_days;SputnikLite;18267;5362;23629;568643;148395;717038
2022.01_13-10-2022;Республика Саха (Якутия);90_105_days;SputnikV;4803;1378;6181;568643;148395;717038
2022.01_13-10-2022;Республика Северная Осетия - Алания;105_165_days;AllVaccines;24170;6024;30194;385443;144230;529673
2022.01_13-10-2022;Республика Северная Осетия - Алания;105_165_days;CoviVac;20;2;22;385443;144230;529673
2022.01_13-10-2022;Республика Северная Осетия - Алания;105_165_days;EpiVacCorona;287;61;348;385443;144230;529673
2022.01_13-10-2022;Республика Северная Осетия - Алания;105_165_days;SputnikLite;11796;3048;14844;385443;144230;529673
2022.01_13-10-2022;Республика Северная Осетия - Алания;105_165_days;SputnikV;12067;2913;14980;385443;144230;529673
2022.01_13-10-2022;Республика Северная Осетия - Алания;165_195_days;AllVaccines;27268;4667;31935;385443;144230;529673
2022.01_13-10-2022;Республика Северная Осетия - Алания;165_195_days;CoviVac;5;6;11;385443;144230;529673
2022.01_13-10-2022;Республика Северная Осетия - Алания;165_195_days;EpiVacCorona;313;38;351;385443;144230;529673
2022.01_13-10-2022;Республика Северная Осетия - Алания;165_195_days;SputnikLite;3940;648;4588;385443;144230;529673
2022.01_13-10-2022;Республика Северная Осетия - Алания;165_195_days;SputnikV;23010;3975;26985;385443;144230;529673
2022.01_13-10-2022;Республика Северная Осетия - Алания;21_45_days;AllVaccines;8769;2778;11547;385443;144230;529673
2022.01_13-10-2022;Республика Северная Осетия - Алания;21_45_days;CoviVac;47;19;66;385443;144230;529673
2022.01_13-10-2022;Республика Северная Осетия - Алания;21_45_days;EpiVacCorona;1544;478;2022;385443;144230;529673
2022.01_13-10-2022;Республика Северная Осетия - Алания;21_45_days;SputnikLite;4253;1454;5707;385443;144230;529673
2022.01_13-10-2022;Республика Северная Осетия - Алания;21_45_days;SputnikV;2925;827;3752;385443;144230;529673
2022.01_13-10-2022;Республика Северная Осетия - Алания;45_75_days;AllVaccines;24161;4782;28943;385443;144230;529673
2022.01_13-10-2022;Республика Северная Осетия - Алания;45_75_days;CoviVac;223;79;302;385443;144230;529673
2022.01_13-10-2022;Республика Северная Осетия - Алания;45_75_days;EpiVacCorona;798;153;951;385443;144230;529673
2022.01_13-10-2022;Республика Северная Осетия - Алания;45_75_days;SputnikLite;9149;2045;11194;385443;144230;529673
2022.01_13-10-2022;Республика Северная Осетия - Алания;45_75_days;SputnikV;13991;2505;16496;385443;144230;529673
2022.01_13-10-2022;Республика Северная Осетия - Алания;75_90_days;AllVaccines;16578;3138;19716;385443;144230;529673
2022.01_13-10-2022;Республика Северная Осетия - Алания;75_90_days;CoviVac;337;65;402;385443;144230;529673
2022.01_13-10-2022;Республика Северная Осетия - Алания;75_90_days;EpiVacCorona;363;38;401;385443;144230;529673
2022.01_13-10-2022;Республика Северная Осетия - Алания;75_90_days;SputnikLite;6876;1612;8488;385443;144230;529673
2022.01_13-10-2022;Республика Северная Осетия - Алания;75_90_days;SputnikV;9002;1423;10425;385443;144230;529673
2022.01_13-10-2022;Республика Северная Осетия - Алания;90_105_days;AllVaccines;15936;3419;19355;385443;144230;529673
2022.01_13-10-2022;Республика Северная Осетия - Алания;90_105_days;CoviVac;168;67;235;385443;144230;529673
2022.01_13-10-2022;Республика Северная Осетия - Алания;90_105_days;EpiVacCorona;222;23;245;385443;144230;529673
2022.01_13-10-2022;Республика Северная Осетия - Алания;90_105_days;SputnikLite;9518;1941;11459;385443;144230;529673
2022.01_13-10-2022;Республика Северная Осетия - Алания;90_105_days;SputnikV;6028;1388;7416;385443;144230;529673
2022.01_13-10-2022;Республика Татарстан;105_165_days;AllVaccines;244287;73535;317822;2180132;866477;3046609
2022.01_13-10-2022;Республика Татарстан;105_165_days;CoviVac;5161;924;6085;2180132;866477;3046609
2022.01_13-10-2022;Республика Татарстан;105_165_days;EpiVacCorona;4632;2209;6841;2180132;866477;3046609
2022.01_13-10-2022;Республика Татарстан;105_165_days;SputnikLite;82772;27829;110601;2180132;866477;3046609
2022.01_13-10-2022;Республика Татарстан;105_165_days;SputnikV;151722;42573;194295;2180132;866477;3046609
2022.01_13-10-2022;Республика Татарстан;165_195_days;AllVaccines;193767;32209;225976;2180132;866477;3046609
2022.01_13-10-2022;Республика Татарстан;165_195_days;CoviVac;4788;637;5425;2180132;866477;3046609
2022.01_13-10-2022;Республика Татарстан;165_195_days;EpiVacCorona;4862;1538;6400;2180132;866477;3046609
2022.01_13-10-2022;Республика Татарстан;165_195_days;SputnikLite;23259;2948;26207;2180132;866477;3046609
2022.01_13-10-2022;Республика Татарстан;165_195_days;SputnikV;160858;27086;187944;2180132;866477;3046609
2022.01_13-10-2022;Республика Татарстан;21_45_days;AllVaccines;56702;33461;90163;2180132;866477;3046609
2022.01_13-10-2022;Республика Татарстан;21_45_days;CoviVac;233;76;309;2180132;866477;3046609
2022.01_13-10-2022;Республика Татарстан;21_45_days;EpiVacCorona;875;736;1611;2180132;866477;3046609
2022.01_13-10-2022;Республика Татарстан;21_45_days;SputnikLite;28149;19285;47434;2180132;866477;3046609
2022.01_13-10-2022;Республика Татарстан;21_45_days;SputnikV;27445;13364;40809;2180132;866477;3046609
2022.01_13-10-2022;Республика Татарстан;45_75_days;AllVaccines;214978;98203;313181;2180132;866477;3046609
2022.01_13-10-2022;Республика Татарстан;45_75_days;CoviVac;781;304;1085;2180132;866477;3046609
2022.01_13-10-2022;Республика Татарстан;45_75_days;EpiVacCorona;3893;2938;6831;2180132;866477;3046609
2022.01_13-10-2022;Республика Татарстан;45_75_days;SputnikLite;33506;26172;59678;2180132;866477;3046609
2022.01_13-10-2022;Республика Татарстан;45_75_days;SputnikV;176798;68789;245587;2180132;866477;3046609
2022.01_13-10-2022;Республика Татарстан;75_90_days;AllVaccines;224486;70768;295254;2180132;866477;3046609
2022.01_13-10-2022;Республика Татарстан;75_90_days;CoviVac;1102;278;1380;2180132;866477;3046609
2022.01_13-10-2022;Республика Татарстан;75_90_days;EpiVacCorona;3507;1874;5381;2180132;866477;3046609
2022.01_13-10-2022;Республика Татарстан;75_90_days;SputnikLite;25764;17528;43292;2180132;866477;3046609
2022.01_13-10-2022;Республика Татарстан;75_90_days;SputnikV;194113;51088;245201;2180132;866477;3046609
2022.01_13-10-2022;Республика Татарстан;90_105_days;AllVaccines;285236;71105;356341;2180132;866477;3046609
2022.01_13-10-2022;Республика Татарстан;90_105_days;CoviVac;838;136;974;2180132;866477;3046609
2022.01_13-10-2022;Республика Татарстан;90_105_days;EpiVacCorona;6037;2300;8337;2180132;866477;3046609
2022.01_13-10-2022;Республика Татарстан;90_105_days;SputnikLite;25714;10897;36611;2180132;866477;3046609
2022.01_13-10-2022;Республика Татарстан;90_105_days;SputnikV;252647;57772;310419;2180132;866477;3046609
2022.01_13-10-2022;Республика Тыва;105_165_days;AllVaccines;23307;5540;28847;176122;31028;207150
2022.01_13-10-2022;Республика Тыва;105_165_days;CoviVac;39;3;42;176122;31028;207150
2022.01_13-10-2022;Республика Тыва;105_165_days;EpiVacCorona;48;10;58;176122;31028;207150
2022.01_13-10-2022;Республика Тыва;105_165_days;SputnikLite;19773;4712;24485;176122;31028;207150
2022.01_13-10-2022;Республика Тыва;105_165_days;SputnikV;3447;815;4262;176122;31028;207150
2022.01_13-10-2022;Республика Тыва;165_195_days;AllVaccines;20881;1849;22730;176122;31028;207150
2022.01_13-10-2022;Республика Тыва;165_195_days;CoviVac;172;9;181;176122;31028;207150
2022.01_13-10-2022;Республика Тыва;165_195_days;EpiVacCorona;50;8;58;176122;31028;207150
2022.01_13-10-2022;Республика Тыва;165_195_days;SputnikLite;10394;582;10976;176122;31028;207150
2022.01_13-10-2022;Республика Тыва;165_195_days;SputnikV;10265;1250;11515;176122;31028;207150
2022.01_13-10-2022;Республика Тыва;21_45_days;AllVaccines;10256;2121;12377;176122;31028;207150
2022.01_13-10-2022;Республика Тыва;21_45_days;CoviVac;2;0;2;176122;31028;207150
2022.01_13-10-2022;Республика Тыва;21_45_days;EpiVacCorona;64;5;69;176122;31028;207150
2022.01_13-10-2022;Республика Тыва;21_45_days;SputnikLite;8224;1789;10013;176122;31028;207150
2022.01_13-10-2022;Республика Тыва;21_45_days;SputnikV;1966;327;2293;176122;31028;207150
2022.01_13-10-2022;Республика Тыва;45_75_days;AllVaccines;11280;2120;13400;176122;31028;207150
2022.01_13-10-2022;Республика Тыва;45_75_days;CoviVac;1;0;1;176122;31028;207150
2022.01_13-10-2022;Республика Тыва;45_75_days;EpiVacCorona;122;13;135;176122;31028;207150
2022.01_13-10-2022;Республика Тыва;45_75_days;SputnikLite;6020;1398;7418;176122;31028;207150
2022.01_13-10-2022;Республика Тыва;45_75_days;SputnikV;5137;709;5846;176122;31028;207150
2022.01_13-10-2022;Республика Тыва;75_90_days;AllVaccines;8193;1875;10068;176122;31028;207150
2022.01_13-10-2022;Республика Тыва;75_90_days;CoviVac;10;0;10;176122;31028;207150
2022.01_13-10-2022;Республика Тыва;75_90_days;EpiVacCorona;66;12;78;176122;31028;207150
2022.01_13-10-2022;Республика Тыва;75_90_days;SputnikLite;5198;1429;6627;176122;31028;207150
2022.01_13-10-2022;Республика Тыва;75_90_days;SputnikV;2919;434;3353;176122;31028;207150
2022.01_13-10-2022;Республика Тыва;90_105_days;AllVaccines;10619;2088;12707;176122;31028;207150
2022.01_13-10-2022;Республика Тыва;90_105_days;CoviVac;14;2;16;176122;31028;207150
2022.01_13-10-2022;Республика Тыва;90_105_days;EpiVacCorona;24;10;34;176122;31028;207150
2022.01_13-10-2022;Республика Тыва;90_105_days;SputnikLite;8847;1668;10515;176122;31028;207150
2022.01_13-10-2022;Республика Тыва;90_105_days;SputnikV;1734;408;2142;176122;31028;207150
2022.01_13-10-2022;Республика Хакасия;105_165_days;AllVaccines;24159;10531;34690;291439;112190;403629
2022.01_13-10-2022;Республика Хакасия;105_165_days;CoviVac;418;171;589;291439;112190;403629
2022.01_13-10-2022;Республика Хакасия;105_165_days;EpiVacCorona;171;69;240;291439;112190;403629
2022.01_13-10-2022;Республика Хакасия;105_165_days;SputnikLite;13379;6613;19992;291439;112190;403629
2022.01_13-10-2022;Республика Хакасия;105_165_days;SputnikV;10191;3678;13869;291439;112190;403629
2022.01_13-10-2022;Республика Хакасия;165_195_days;AllVaccines;38854;7077;45931;291439;112190;403629
2022.01_13-10-2022;Республика Хакасия;165_195_days;CoviVac;322;71;393;291439;112190;403629
2022.01_13-10-2022;Республика Хакасия;165_195_days;EpiVacCorona;407;96;503;291439;112190;403629
2022.01_13-10-2022;Республика Хакасия;165_195_days;SputnikLite;5024;785;5809;291439;112190;403629
2022.01_13-10-2022;Республика Хакасия;165_195_days;SputnikV;33101;6125;39226;291439;112190;403629
2022.01_13-10-2022;Республика Хакасия;21_45_days;AllVaccines;10837;4757;15594;291439;112190;403629
2022.01_13-10-2022;Республика Хакасия;21_45_days;CoviVac;170;46;216;291439;112190;403629
2022.01_13-10-2022;Республика Хакасия;21_45_days;EpiVacCorona;335;121;456;291439;112190;403629
2022.01_13-10-2022;Республика Хакасия;21_45_days;SputnikLite;7484;3490;10974;291439;112190;403629
2022.01_13-10-2022;Республика Хакасия;21_45_days;SputnikV;2848;1100;3948;291439;112190;403629
2022.01_13-10-2022;Республика Хакасия;45_75_days;AllVaccines;18378;8765;27143;291439;112190;403629
2022.01_13-10-2022;Республика Хакасия;45_75_days;CoviVac;285;74;359;291439;112190;403629
2022.01_13-10-2022;Республика Хакасия;45_75_days;EpiVacCorona;473;206;679;291439;112190;403629
2022.01_13-10-2022;Республика Хакасия;45_75_days;SputnikLite;6939;3888;10827;291439;112190;403629
2022.01_13-10-2022;Республика Хакасия;45_75_days;SputnikV;10681;4597;15278;291439;112190;403629
2022.01_13-10-2022;Республика Хакасия;75_90_days;AllVaccines;11699;6593;18292;291439;112190;403629
2022.01_13-10-2022;Республика Хакасия;75_90_days;CoviVac;244;59;303;291439;112190;403629
2022.01_13-10-2022;Республика Хакасия;75_90_days;EpiVacCorona;270;148;418;291439;112190;403629
2022.01_13-10-2022;Республика Хакасия;75_90_days;SputnikLite;5063;3537;8600;291439;112190;403629
2022.01_13-10-2022;Республика Хакасия;75_90_days;SputnikV;6122;2849;8971;291439;112190;403629
2022.01_13-10-2022;Республика Хакасия;90_105_days;AllVaccines;9034;5597;14631;291439;112190;403629
2022.01_13-10-2022;Республика Хакасия;90_105_days;CoviVac;238;100;338;291439;112190;403629
2022.01_13-10-2022;Республика Хакасия;90_105_days;EpiVacCorona;132;57;189;291439;112190;403629
2022.01_13-10-2022;Республика Хакасия;90_105_days;SputnikLite;5063;3614;8677;291439;112190;403629
2022.01_13-10-2022;Республика Хакасия;90_105_days;SputnikV;3601;1826;5427;291439;112190;403629
2022.01_13-10-2022;Ростовская область;105_165_days;AllVaccines;229860;91282;321142;2367942;1020468;3388410
2022.01_13-10-2022;Ростовская область;105_165_days;CoviVac;2118;728;2846;2367942;1020468;3388410
2022.01_13-10-2022;Ростовская область;105_165_days;EpiVacCorona;3243;1401;4644;2367942;1020468;3388410
2022.01_13-10-2022;Ростовская область;105_165_days;SputnikLite;65636;39428;105064;2367942;1020468;3388410
2022.01_13-10-2022;Ростовская область;105_165_days;SputnikV;158863;49725;208588;2367942;1020468;3388410
2022.01_13-10-2022;Ростовская область;165_195_days;AllVaccines;378225;67115;445340;2367942;1020468;3388410
2022.01_13-10-2022;Ростовская область;165_195_days;CoviVac;3454;645;4099;2367942;1020468;3388410
2022.01_13-10-2022;Ростовская область;165_195_days;EpiVacCorona;5095;1454;6549;2367942;1020468;3388410
2022.01_13-10-2022;Ростовская область;165_195_days;SputnikLite;43403;7913;51316;2367942;1020468;3388410
2022.01_13-10-2022;Ростовская область;165_195_days;SputnikV;326273;57103;383376;2367942;1020468;3388410
2022.01_13-10-2022;Ростовская область;21_45_days;AllVaccines;74127;36450;110577;2367942;1020468;3388410
2022.01_13-10-2022;Ростовская область;21_45_days;CoviVac;360;152;512;2367942;1020468;3388410
2022.01_13-10-2022;Ростовская область;21_45_days;EpiVacCorona;642;405;1047;2367942;1020468;3388410
2022.01_13-10-2022;Ростовская область;21_45_days;SputnikLite;37023;17102;54125;2367942;1020468;3388410
2022.01_13-10-2022;Ростовская область;21_45_days;SputnikV;36102;18791;54893;2367942;1020468;3388410
2022.01_13-10-2022;Ростовская область;45_75_days;AllVaccines;149791;88712;238503;2367942;1020468;3388410
2022.01_13-10-2022;Ростовская область;45_75_days;CoviVac;951;418;1369;2367942;1020468;3388410
2022.01_13-10-2022;Ростовская область;45_75_days;EpiVacCorona;1016;805;1821;2367942;1020468;3388410
2022.01_13-10-2022;Ростовская область;45_75_days;SputnikLite;35173;24540;59713;2367942;1020468;3388410
2022.01_13-10-2022;Ростовская область;45_75_days;SputnikV;112651;62949;175600;2367942;1020468;3388410
2022.01_13-10-2022;Ростовская область;75_90_days;AllVaccines;85203;46570;131773;2367942;1020468;3388410
2022.01_13-10-2022;Ростовская область;75_90_days;CoviVac;930;360;1290;2367942;1020468;3388410
2022.01_13-10-2022;Ростовская область;75_90_days;EpiVacCorona;947;425;1372;2367942;1020468;3388410
2022.01_13-10-2022;Ростовская область;75_90_days;SputnikLite;21641;16853;38494;2367942;1020468;3388410
2022.01_13-10-2022;Ростовская область;75_90_days;SputnikV;61685;28932;90617;2367942;1020468;3388410
2022.01_13-10-2022;Ростовская область;90_105_days;AllVaccines;51874;27277;79151;2367942;1020468;3388410
2022.01_13-10-2022;Ростовская область;90_105_days;CoviVac;962;420;1382;2367942;1020468;3388410
2022.01_13-10-2022;Ростовская область;90_105_days;EpiVacCorona;845;376;1221;2367942;1020468;3388410
2022.01_13-10-2022;Ростовская область;90_105_days;SputnikLite;10848;7638;18486;2367942;1020468;3388410
2022.01_13-10-2022;Ростовская область;90_105_days;SputnikV;39219;18843;58062;2367942;1020468;3388410
2022.01_13-10-2022;Рязанская область;105_165_days;AllVaccines;56738;26900;83638;600731;301318;902049
2022.01_13-10-2022;Рязанская область;105_165_days;CoviVac;615;124;739;600731;301318;902049
2022.01_13-10-2022;Рязанская область;105_165_days;EpiVacCorona;948;291;1239;600731;301318;902049
2022.01_13-10-2022;Рязанская область;105_165_days;SputnikLite;26111;17090;43201;600731;301318;902049
2022.01_13-10-2022;Рязанская область;105_165_days;SputnikV;29064;9395;38459;600731;301318;902049
2022.01_13-10-2022;Рязанская область;165_195_days;AllVaccines;46135;13016;59151;600731;301318;902049
2022.01_13-10-2022;Рязанская область;165_195_days;CoviVac;306;41;347;600731;301318;902049
2022.01_13-10-2022;Рязанская область;165_195_days;EpiVacCorona;1093;424;1517;600731;301318;902049
2022.01_13-10-2022;Рязанская область;165_195_days;SputnikLite;5906;3085;8991;600731;301318;902049
2022.01_13-10-2022;Рязанская область;165_195_days;SputnikV;38830;9466;48296;600731;301318;902049
2022.01_13-10-2022;Рязанская область;21_45_days;AllVaccines;24231;12428;36659;600731;301318;902049
2022.01_13-10-2022;Рязанская область;21_45_days;CoviVac;301;79;380;600731;301318;902049
2022.01_13-10-2022;Рязанская область;21_45_days;EpiVacCorona;718;288;1006;600731;301318;902049
2022.01_13-10-2022;Рязанская область;21_45_days;SputnikLite;13071;8658;21729;600731;301318;902049
2022.01_13-10-2022;Рязанская область;21_45_days;SputnikV;10141;3403;13544;600731;301318;902049
2022.01_13-10-2022;Рязанская область;45_75_days;AllVaccines;59959;33816;93775;600731;301318;902049
2022.01_13-10-2022;Рязанская область;45_75_days;CoviVac;992;320;1312;600731;301318;902049
2022.01_13-10-2022;Рязанская область;45_75_days;EpiVacCorona;1288;601;1889;600731;301318;902049
2022.01_13-10-2022;Рязанская область;45_75_days;SputnikLite;13000;13777;26777;600731;301318;902049
2022.01_13-10-2022;Рязанская область;45_75_days;SputnikV;44679;19118;63797;600731;301318;902049
2022.01_13-10-2022;Рязанская область;75_90_days;AllVaccines;47712;18229;65941;600731;301318;902049
2022.01_13-10-2022;Рязанская область;75_90_days;CoviVac;723;162;885;600731;301318;902049
2022.01_13-10-2022;Рязанская область;75_90_days;EpiVacCorona;1793;450;2243;600731;301318;902049
2022.01_13-10-2022;Рязанская область;75_90_days;SputnikLite;5183;5985;11168;600731;301318;902049
2022.01_13-10-2022;Рязанская область;75_90_days;SputnikV;40013;11632;51645;600731;301318;902049
2022.01_13-10-2022;Рязанская область;90_105_days;AllVaccines;41539;10283;51822;600731;301318;902049
2022.01_13-10-2022;Рязанская область;90_105_days;CoviVac;659;130;789;600731;301318;902049
2022.01_13-10-2022;Рязанская область;90_105_days;EpiVacCorona;2705;658;3363;600731;301318;902049
2022.01_13-10-2022;Рязанская область;90_105_days;SputnikLite;1847;1362;3209;600731;301318;902049
2022.01_13-10-2022;Рязанская область;90_105_days;SputnikV;36328;8133;44461;600731;301318;902049
2022.01_13-10-2022;Самарская область;105_165_days;AllVaccines;197858;79249;277107;1769846;769791;2539637
2022.01_13-10-2022;Самарская область;105_165_days;CoviVac;2662;712;3374;1769846;769791;2539637
2022.01_13-10-2022;Самарская область;105_165_days;EpiVacCorona;1356;1207;2563;1769846;769791;2539637
2022.01_13-10-2022;Самарская область;105_165_days;SputnikLite;102617;48583;151200;1769846;769791;2539637
2022.01_13-10-2022;Самарская область;105_165_days;SputnikV;91223;28747;119970;1769846;769791;2539637
2022.01_13-10-2022;Самарская область;165_195_days;AllVaccines;252948;40567;293515;1769846;769791;2539637
2022.01_13-10-2022;Самарская область;165_195_days;CoviVac;3010;483;3493;1769846;769791;2539637
2022.01_13-10-2022;Самарская область;165_195_days;EpiVacCorona;5978;1309;7287;1769846;769791;2539637
2022.01_13-10-2022;Самарская область;165_195_days;SputnikLite;60991;9911;70902;1769846;769791;2539637
2022.01_13-10-2022;Самарская область;165_195_days;SputnikV;182969;28864;211833;1769846;769791;2539637
2022.01_13-10-2022;Самарская область;21_45_days;AllVaccines;53399;31664;85063;1769846;769791;2539637
2022.01_13-10-2022;Самарская область;21_45_days;CoviVac;383;165;548;1769846;769791;2539637
2022.01_13-10-2022;Самарская область;21_45_days;EpiVacCorona;788;993;1781;1769846;769791;2539637
2022.01_13-10-2022;Самарская область;21_45_days;SputnikLite;31776;20409;52185;1769846;769791;2539637
2022.01_13-10-2022;Самарская область;21_45_days;SputnikV;20452;10097;30549;1769846;769791;2539637
2022.01_13-10-2022;Самарская область;45_75_days;AllVaccines;155297;86915;242212;1769846;769791;2539637
2022.01_13-10-2022;Самарская область;45_75_days;CoviVac;1223;431;1654;1769846;769791;2539637
2022.01_13-10-2022;Самарская область;45_75_days;EpiVacCorona;2695;2031;4726;1769846;769791;2539637
2022.01_13-10-2022;Самарская область;45_75_days;SputnikLite;36329;29828;66157;1769846;769791;2539637
2022.01_13-10-2022;Самарская область;45_75_days;SputnikV;115050;54625;169675;1769846;769791;2539637
2022.01_13-10-2022;Самарская область;75_90_days;AllVaccines;129761;65378;195139;1769846;769791;2539637
2022.01_13-10-2022;Самарская область;75_90_days;CoviVac;689;225;914;1769846;769791;2539637
2022.01_13-10-2022;Самарская область;75_90_days;EpiVacCorona;1266;727;1993;1769846;769791;2539637
2022.01_13-10-2022;Самарская область;75_90_days;SputnikLite;21850;19621;41471;1769846;769791;2539637
2022.01_13-10-2022;Самарская область;75_90_days;SputnikV;105956;44805;150761;1769846;769791;2539637
2022.01_13-10-2022;Самарская область;90_105_days;AllVaccines;69812;35338;105150;1769846;769791;2539637
2022.01_13-10-2022;Самарская область;90_105_days;CoviVac;317;121;438;1769846;769791;2539637
2022.01_13-10-2022;Самарская область;90_105_days;EpiVacCorona;1284;839;2123;1769846;769791;2539637
2022.01_13-10-2022;Самарская область;90_105_days;SputnikLite;8652;5873;14525;1769846;769791;2539637
2022.01_13-10-2022;Самарская область;90_105_days;SputnikV;59559;28505;88064;1769846;769791;2539637
2022.01_13-10-2022;Саратовская область;105_165_days;AllVaccines;115463;54205;169668;1348454;599954;1948408
2022.01_13-10-2022;Саратовская область;105_165_days;CoviVac;2247;487;2734;1348454;599954;1948408
2022.01_13-10-2022;Саратовская область;105_165_days;EpiVacCorona;1332;817;2149;1348454;599954;1948408
2022.01_13-10-2022;Саратовская область;105_165_days;SputnikLite;59859;28678;88537;1348454;599954;1948408
2022.01_13-10-2022;Саратовская область;105_165_days;SputnikV;52025;24223;76248;1348454;599954;1948408
2022.01_13-10-2022;Саратовская область;165_195_days;AllVaccines;109635;25623;135258;1348454;599954;1948408
2022.01_13-10-2022;Саратовская область;165_195_days;CoviVac;1015;128;1143;1348454;599954;1948408
2022.01_13-10-2022;Саратовская область;165_195_days;EpiVacCorona;1558;794;2352;1348454;599954;1948408
2022.01_13-10-2022;Саратовская область;165_195_days;SputnikLite;20662;5593;26255;1348454;599954;1948408
2022.01_13-10-2022;Саратовская область;165_195_days;SputnikV;86400;19108;105508;1348454;599954;1948408
2022.01_13-10-2022;Саратовская область;21_45_days;AllVaccines;41555;21973;63528;1348454;599954;1948408
2022.01_13-10-2022;Саратовская область;21_45_days;CoviVac;520;147;667;1348454;599954;1948408
2022.01_13-10-2022;Саратовская область;21_45_days;EpiVacCorona;1666;891;2557;1348454;599954;1948408
2022.01_13-10-2022;Саратовская область;21_45_days;SputnikLite;25763;14406;40169;1348454;599954;1948408
2022.01_13-10-2022;Саратовская область;21_45_days;SputnikV;13606;6529;20135;1348454;599954;1948408
2022.01_13-10-2022;Саратовская область;45_75_days;AllVaccines;128474;57343;185817;1348454;599954;1948408
2022.01_13-10-2022;Саратовская область;45_75_days;CoviVac;1090;265;1355;1348454;599954;1948408
2022.01_13-10-2022;Саратовская область;45_75_days;EpiVacCorona;6163;2666;8829;1348454;599954;1948408
2022.01_13-10-2022;Саратовская область;45_75_days;SputnikLite;27536;18909;46445;1348454;599954;1948408
2022.01_13-10-2022;Саратовская область;45_75_days;SputnikV;93685;35503;129188;1348454;599954;1948408
2022.01_13-10-2022;Саратовская область;75_90_days;AllVaccines;85593;38345;123938;1348454;599954;1948408
2022.01_13-10-2022;Саратовская область;75_90_days;CoviVac;262;40;302;1348454;599954;1948408
2022.01_13-10-2022;Саратовская область;75_90_days;EpiVacCorona;3575;1206;4781;1348454;599954;1948408
2022.01_13-10-2022;Саратовская область;75_90_days;SputnikLite;19340;13493;32833;1348454;599954;1948408
2022.01_13-10-2022;Саратовская область;75_90_days;SputnikV;62416;23606;86022;1348454;599954;1948408
2022.01_13-10-2022;Саратовская область;90_105_days;AllVaccines;56756;21523;78279;1348454;599954;1948408
2022.01_13-10-2022;Саратовская область;90_105_days;CoviVac;744;105;849;1348454;599954;1948408
2022.01_13-10-2022;Саратовская область;90_105_days;EpiVacCorona;2169;747;2916;1348454;599954;1948408
2022.01_13-10-2022;Саратовская область;90_105_days;SputnikLite;8533;3678;12211;1348454;599954;1948408
2022.01_13-10-2022;Саратовская область;90_105_days;SputnikV;45310;16993;62303;1348454;599954;1948408
2022.01_13-10-2022;Сахалинская область;105_165_days;AllVaccines;16402;8556;24958;276677;101794;378471
2022.01_13-10-2022;Сахалинская область;105_165_days;CoviVac;36;9;45;276677;101794;378471
2022.01_13-10-2022;Сахалинская область;105_165_days;EpiVacCorona;179;58;237;276677;101794;378471
2022.01_13-10-2022;Сахалинская область;105_165_days;SputnikLite;6423;6121;12544;276677;101794;378471
2022.01_13-10-2022;Сахалинская область;105_165_days;SputnikV;9764;2368;12132;276677;101794;378471
2022.01_13-10-2022;Сахалинская область;165_195_days;AllVaccines;26918;4409;31327;276677;101794;378471
2022.01_13-10-2022;Сахалинская область;165_195_days;CoviVac;137;26;163;276677;101794;378471
2022.01_13-10-2022;Сахалинская область;165_195_days;EpiVacCorona;37;7;44;276677;101794;378471
2022.01_13-10-2022;Сахалинская область;165_195_days;SputnikLite;5362;547;5909;276677;101794;378471
2022.01_13-10-2022;Сахалинская область;165_195_days;SputnikV;21382;3829;25211;276677;101794;378471
2022.01_13-10-2022;Сахалинская область;21_45_days;AllVaccines;13863;5234;19097;276677;101794;378471
2022.01_13-10-2022;Сахалинская область;21_45_days;CoviVac;198;50;248;276677;101794;378471
2022.01_13-10-2022;Сахалинская область;21_45_days;EpiVacCorona;316;90;406;276677;101794;378471
2022.01_13-10-2022;Сахалинская область;21_45_days;SputnikLite;10389;4341;14730;276677;101794;378471
2022.01_13-10-2022;Сахалинская область;21_45_days;SputnikV;2960;753;3713;276677;101794;378471
2022.01_13-10-2022;Сахалинская область;45_75_days;AllVaccines;20654;7568;28222;276677;101794;378471
2022.01_13-10-2022;Сахалинская область;45_75_days;CoviVac;450;75;525;276677;101794;378471
2022.01_13-10-2022;Сахалинская область;45_75_days;EpiVacCorona;1888;397;2285;276677;101794;378471
2022.01_13-10-2022;Сахалинская область;45_75_days;SputnikLite;7358;4482;11840;276677;101794;378471
2022.01_13-10-2022;Сахалинская область;45_75_days;SputnikV;10958;2614;13572;276677;101794;378471
2022.01_13-10-2022;Сахалинская область;75_90_days;AllVaccines;12063;5853;17916;276677;101794;378471
2022.01_13-10-2022;Сахалинская область;75_90_days;CoviVac;44;6;50;276677;101794;378471
2022.01_13-10-2022;Сахалинская область;75_90_days;EpiVacCorona;1686;498;2184;276677;101794;378471
2022.01_13-10-2022;Сахалинская область;75_90_days;SputnikLite;5170;3994;9164;276677;101794;378471
2022.01_13-10-2022;Сахалинская область;75_90_days;SputnikV;5163;1355;6518;276677;101794;378471
2022.01_13-10-2022;Сахалинская область;90_105_days;AllVaccines;8684;5819;14503;276677;101794;378471
2022.01_13-10-2022;Сахалинская область;90_105_days;CoviVac;14;2;16;276677;101794;378471
2022.01_13-10-2022;Сахалинская область;90_105_days;EpiVacCorona;398;218;616;276677;101794;378471
2022.01_13-10-2022;Сахалинская область;90_105_days;SputnikLite;5221;4581;9802;276677;101794;378471
2022.01_13-10-2022;Сахалинская область;90_105_days;SputnikV;3051;1018;4069;276677;101794;378471
2022.01_13-10-2022;Свердловская область;105_165_days;AllVaccines;270564;98971;369535;2364046;987486;3351532
2022.01_13-10-2022;Свердловская область;105_165_days;CoviVac;3856;850;4706;2364046;987486;3351532
2022.01_13-10-2022;Свердловская область;105_165_days;EpiVacCorona;2226;963;3189;2364046;987486;3351532
2022.01_13-10-2022;Свердловская область;105_165_days;SputnikLite;161610;54356;215966;2364046;987486;3351532
2022.01_13-10-2022;Свердловская область;105_165_days;SputnikV;102872;42802;145674;2364046;987486;3351532
2022.01_13-10-2022;Свердловская область;165_195_days;AllVaccines;234913;49284;284197;2364046;987486;3351532
2022.01_13-10-2022;Свердловская область;165_195_days;CoviVac;1615;288;1903;2364046;987486;3351532
2022.01_13-10-2022;Свердловская область;165_195_days;EpiVacCorona;7167;2825;9992;2364046;987486;3351532
2022.01_13-10-2022;Свердловская область;165_195_days;SputnikLite;92004;10824;102828;2364046;987486;3351532
2022.01_13-10-2022;Свердловская область;165_195_days;SputnikV;134127;35347;169474;2364046;987486;3351532
2022.01_13-10-2022;Свердловская область;21_45_days;AllVaccines;84781;47510;132291;2364046;987486;3351532
2022.01_13-10-2022;Свердловская область;21_45_days;CoviVac;239;70;309;2364046;987486;3351532
2022.01_13-10-2022;Свердловская область;21_45_days;EpiVacCorona;2750;1826;4576;2364046;987486;3351532
2022.01_13-10-2022;Свердловская область;21_45_days;SputnikLite;46658;28178;74836;2364046;987486;3351532
2022.01_13-10-2022;Свердловская область;21_45_days;SputnikV;35134;17436;52570;2364046;987486;3351532
2022.01_13-10-2022;Свердловская область;45_75_days;AllVaccines;264775;119584;384359;2364046;987486;3351532
2022.01_13-10-2022;Свердловская область;45_75_days;CoviVac;797;213;1010;2364046;987486;3351532
2022.01_13-10-2022;Свердловская область;45_75_days;EpiVacCorona;5210;2810;8020;2364046;987486;3351532
2022.01_13-10-2022;Свердловская область;45_75_days;SputnikLite;61487;40508;101995;2364046;987486;3351532
2022.01_13-10-2022;Свердловская область;45_75_days;SputnikV;197281;76053;273334;2364046;987486;3351532
2022.01_13-10-2022;Свердловская область;75_90_days;AllVaccines;235526;82402;317928;2364046;987486;3351532
2022.01_13-10-2022;Свердловская область;75_90_days;CoviVac;1063;190;1253;2364046;987486;3351532
2022.01_13-10-2022;Свердловская область;75_90_days;EpiVacCorona;4578;1700;6278;2364046;987486;3351532
2022.01_13-10-2022;Свердловская область;75_90_days;SputnikLite;46506;28459;74965;2364046;987486;3351532
2022.01_13-10-2022;Свердловская область;75_90_days;SputnikV;183379;52053;235432;2364046;987486;3351532
2022.01_13-10-2022;Свердловская область;90_105_days;AllVaccines;90855;30610;121465;2364046;987486;3351532
2022.01_13-10-2022;Свердловская область;90_105_days;CoviVac;2381;455;2836;2364046;987486;3351532
2022.01_13-10-2022;Свердловская область;90_105_days;EpiVacCorona;3521;1262;4783;2364046;987486;3351532
2022.01_13-10-2022;Свердловская область;90_105_days;SputnikLite;10660;4690;15350;2364046;987486;3351532
2022.01_13-10-2022;Свердловская область;90_105_days;SputnikV;74293;24203;98496;2364046;987486;3351532
2022.01_13-10-2022;Смоленская область;105_165_days;AllVaccines;45761;21332;67093;521379;238479;759858
2022.01_13-10-2022;Смоленская область;105_165_days;CoviVac;131;17;148;521379;238479;759858
2022.01_13-10-2022;Смоленская область;105_165_days;EpiVacCorona;484;194;678;521379;238479;759858
2022.01_13-10-2022;Смоленская область;105_165_days;SputnikLite;24135;14156;38291;521379;238479;759858
2022.01_13-10-2022;Смоленская область;105_165_days;SputnikV;21011;6965;27976;521379;238479;759858
2022.01_13-10-2022;Смоленская область;165_195_days;AllVaccines;63568;12873;76441;521379;238479;759858
2022.01_13-10-2022;Смоленская область;165_195_days;CoviVac;537;58;595;521379;238479;759858
2022.01_13-10-2022;Смоленская область;165_195_days;EpiVacCorona;861;237;1098;521379;238479;759858
2022.01_13-10-2022;Смоленская область;165_195_days;SputnikLite;7722;1602;9324;521379;238479;759858
2022.01_13-10-2022;Смоленская область;165_195_days;SputnikV;54448;10976;65424;521379;238479;759858
2022.01_13-10-2022;Смоленская область;21_45_days;AllVaccines;14567;9182;23749;521379;238479;759858
2022.01_13-10-2022;Смоленская область;21_45_days;CoviVac;149;33;182;521379;238479;759858
2022.01_13-10-2022;Смоленская область;21_45_days;EpiVacCorona;743;468;1211;521379;238479;759858
2022.01_13-10-2022;Смоленская область;21_45_days;SputnikLite;8400;6115;14515;521379;238479;759858
2022.01_13-10-2022;Смоленская область;21_45_days;SputnikV;5275;2566;7841;521379;238479;759858
2022.01_13-10-2022;Смоленская область;45_75_days;AllVaccines;31823;21039;52862;521379;238479;759858
2022.01_13-10-2022;Смоленская область;45_75_days;CoviVac;317;86;403;521379;238479;759858
2022.01_13-10-2022;Смоленская область;45_75_days;EpiVacCorona;1471;786;2257;521379;238479;759858
2022.01_13-10-2022;Смоленская область;45_75_days;SputnikLite;9938;9132;19070;521379;238479;759858
2022.01_13-10-2022;Смоленская область;45_75_days;SputnikV;20097;11035;31132;521379;238479;759858
2022.01_13-10-2022;Смоленская область;75_90_days;AllVaccines;17217;10391;27608;521379;238479;759858
2022.01_13-10-2022;Смоленская область;75_90_days;CoviVac;95;18;113;521379;238479;759858
2022.01_13-10-2022;Смоленская область;75_90_days;EpiVacCorona;213;123;336;521379;238479;759858
2022.01_13-10-2022;Смоленская область;75_90_days;SputnikLite;5543;5278;10821;521379;238479;759858
2022.01_13-10-2022;Смоленская область;75_90_days;SputnikV;11366;4972;16338;521379;238479;759858
2022.01_13-10-2022;Смоленская область;90_105_days;AllVaccines;18257;9676;27933;521379;238479;759858
2022.01_13-10-2022;Смоленская область;90_105_days;CoviVac;56;15;71;521379;238479;759858
2022.01_13-10-2022;Смоленская область;90_105_days;EpiVacCorona;144;56;200;521379;238479;759858
2022.01_13-10-2022;Смоленская область;90_105_days;SputnikLite;6596;5739;12335;521379;238479;759858
2022.01_13-10-2022;Смоленская область;90_105_days;SputnikV;11461;3866;15327;521379;238479;759858
2022.01_13-10-2022;Ставропольский край;105_165_days;AllVaccines;106124;55447;161571;1590669;616030;2206699
2022.01_13-10-2022;Ставропольский край;105_165_days;CoviVac;949;332;1281;1590669;616030;2206699
2022.01_13-10-2022;Ставропольский край;105_165_days;EpiVacCorona;805;496;1301;1590669;616030;2206699
2022.01_13-10-2022;Ставропольский край;105_165_days;SputnikLite;56527;34337;90864;1590669;616030;2206699
2022.01_13-10-2022;Ставропольский край;105_165_days;SputnikV;47843;20282;68125;1590669;616030;2206699
2022.01_13-10-2022;Ставропольский край;165_195_days;AllVaccines;135091;25678;160769;1590669;616030;2206699
2022.01_13-10-2022;Ставропольский край;165_195_days;CoviVac;1685;318;2003;1590669;616030;2206699
2022.01_13-10-2022;Ставропольский край;165_195_days;EpiVacCorona;2311;785;3096;1590669;616030;2206699
2022.01_13-10-2022;Ставропольский край;165_195_days;SputnikLite;24292;5812;30104;1590669;616030;2206699
2022.01_13-10-2022;Ставропольский край;165_195_days;SputnikV;106803;18763;125566;1590669;616030;2206699
2022.01_13-10-2022;Ставропольский край;21_45_days;AllVaccines;45837;21337;67174;1590669;616030;2206699
2022.01_13-10-2022;Ставропольский край;21_45_days;CoviVac;366;128;494;1590669;616030;2206699
2022.01_13-10-2022;Ставропольский край;21_45_days;EpiVacCorona;2775;1087;3862;1590669;616030;2206699
2022.01_13-10-2022;Ставропольский край;21_45_days;SputnikLite;23435;14591;38026;1590669;616030;2206699
2022.01_13-10-2022;Ставропольский край;21_45_days;SputnikV;19261;5531;24792;1590669;616030;2206699
2022.01_13-10-2022;Ставропольский край;45_75_days;AllVaccines;142424;50420;192844;1590669;616030;2206699
2022.01_13-10-2022;Ставропольский край;45_75_days;CoviVac;835;271;1106;1590669;616030;2206699
2022.01_13-10-2022;Ставропольский край;45_75_days;EpiVacCorona;3747;1616;5363;1590669;616030;2206699
2022.01_13-10-2022;Ставропольский край;45_75_days;SputnikLite;36963;18124;55087;1590669;616030;2206699
2022.01_13-10-2022;Ставропольский край;45_75_days;SputnikV;100879;30409;131288;1590669;616030;2206699
2022.01_13-10-2022;Ставропольский край;75_90_days;AllVaccines;96994;33903;130897;1590669;616030;2206699
2022.01_13-10-2022;Ставропольский край;75_90_days;CoviVac;772;214;986;1590669;616030;2206699
2022.01_13-10-2022;Ставропольский край;75_90_days;EpiVacCorona;2175;906;3081;1590669;616030;2206699
2022.01_13-10-2022;Ставропольский край;75_90_days;SputnikLite;21245;13263;34508;1590669;616030;2206699
2022.01_13-10-2022;Ставропольский край;75_90_days;SputnikV;72802;19520;92322;1590669;616030;2206699
2022.01_13-10-2022;Ставропольский край;90_105_days;AllVaccines;42587;18778;61365;1590669;616030;2206699
2022.01_13-10-2022;Ставропольский край;90_105_days;CoviVac;798;218;1016;1590669;616030;2206699
2022.01_13-10-2022;Ставропольский край;90_105_days;EpiVacCorona;1332;465;1797;1590669;616030;2206699
2022.01_13-10-2022;Ставропольский край;90_105_days;SputnikLite;11416;5902;17318;1590669;616030;2206699
2022.01_13-10-2022;Ставропольский край;90_105_days;SputnikV;29041;12193;41234;1590669;616030;2206699
2022.01_13-10-2022;Тамбовская область;105_165_days;AllVaccines;58441;37483;95924;545785;279936;825721
2022.01_13-10-2022;Тамбовская область;105_165_days;CoviVac;108;15;123;545785;279936;825721
2022.01_13-10-2022;Тамбовская область;105_165_days;EpiVacCorona;157;384;541;545785;279936;825721
2022.01_13-10-2022;Тамбовская область;105_165_days;SputnikLite;42477;21029;63506;545785;279936;825721
2022.01_13-10-2022;Тамбовская область;105_165_days;SputnikV;15699;16055;31754;545785;279936;825721
2022.01_13-10-2022;Тамбовская область;165_195_days;AllVaccines;83865;17332;101197;545785;279936;825721
2022.01_13-10-2022;Тамбовская область;165_195_days;CoviVac;111;14;125;545785;279936;825721
2022.01_13-10-2022;Тамбовская область;165_195_days;EpiVacCorona;989;679;1668;545785;279936;825721
2022.01_13-10-2022;Тамбовская область;165_195_days;SputnikLite;35327;5963;41290;545785;279936;825721
2022.01_13-10-2022;Тамбовская область;165_195_days;SputnikV;47438;10676;58114;545785;279936;825721
2022.01_13-10-2022;Тамбовская область;21_45_days;AllVaccines;19615;10745;30360;545785;279936;825721
2022.01_13-10-2022;Тамбовская область;21_45_days;CoviVac;330;51;381;545785;279936;825721
2022.01_13-10-2022;Тамбовская область;21_45_days;EpiVacCorona;942;615;1557;545785;279936;825721
2022.01_13-10-2022;Тамбовская область;21_45_days;SputnikLite;13331;5462;18793;545785;279936;825721
2022.01_13-10-2022;Тамбовская область;21_45_days;SputnikV;5012;4617;9629;545785;279936;825721
2022.01_13-10-2022;Тамбовская область;45_75_days;AllVaccines;32853;22589;55442;545785;279936;825721
2022.01_13-10-2022;Тамбовская область;45_75_days;CoviVac;883;165;1048;545785;279936;825721
2022.01_13-10-2022;Тамбовская область;45_75_days;EpiVacCorona;965;748;1713;545785;279936;825721
2022.01_13-10-2022;Тамбовская область;45_75_days;SputnikLite;16834;9556;26390;545785;279936;825721
2022.01_13-10-2022;Тамбовская область;45_75_days;SputnikV;14171;12120;26291;545785;279936;825721
2022.01_13-10-2022;Тамбовская область;75_90_days;AllVaccines;22153;14834;36987;545785;279936;825721
2022.01_13-10-2022;Тамбовская область;75_90_days;CoviVac;437;96;533;545785;279936;825721
2022.01_13-10-2022;Тамбовская область;75_90_days;EpiVacCorona;415;243;658;545785;279936;825721
2022.01_13-10-2022;Тамбовская область;75_90_days;SputnikLite;12253;6816;19069;545785;279936;825721
2022.01_13-10-2022;Тамбовская область;75_90_days;SputnikV;9048;7679;16727;545785;279936;825721
2022.01_13-10-2022;Тамбовская область;90_105_days;AllVaccines;19371;15424;34795;545785;279936;825721
2022.01_13-10-2022;Тамбовская область;90_105_days;CoviVac;621;145;766;545785;279936;825721
2022.01_13-10-2022;Тамбовская область;90_105_days;EpiVacCorona;246;133;379;545785;279936;825721
2022.01_13-10-2022;Тамбовская область;90_105_days;SputnikLite;10476;7218;17694;545785;279936;825721
2022.01_13-10-2022;Тамбовская область;90_105_days;SputnikV;8028;7928;15956;545785;279936;825721
2022.01_13-10-2022;Тверская область;105_165_days;AllVaccines;53609;37915;91524;681519;330234;1011753
2022.01_13-10-2022;Тверская область;105_165_days;CoviVac;737;158;895;681519;330234;1011753
2022.01_13-10-2022;Тверская область;105_165_days;EpiVacCorona;901;429;1330;681519;330234;1011753
2022.01_13-10-2022;Тверская область;105_165_days;SputnikLite;26099;24416;50515;681519;330234;1011753
2022.01_13-10-2022;Тверская область;105_165_days;SputnikV;25872;12912;38784;681519;330234;1011753
2022.01_13-10-2022;Тверская область;165_195_days;AllVaccines;73265;20199;93464;681519;330234;1011753
2022.01_13-10-2022;Тверская область;165_195_days;CoviVac;892;136;1028;681519;330234;1011753
2022.01_13-10-2022;Тверская область;165_195_days;EpiVacCorona;1737;615;2352;681519;330234;1011753
2022.01_13-10-2022;Тверская область;165_195_days;SputnikLite;6095;2288;8383;681519;330234;1011753
2022.01_13-10-2022;Тверская область;165_195_days;SputnikV;64541;17160;81701;681519;330234;1011753
2022.01_13-10-2022;Тверская область;21_45_days;AllVaccines;18745;10923;29668;681519;330234;1011753
2022.01_13-10-2022;Тверская область;21_45_days;CoviVac;420;76;496;681519;330234;1011753
2022.01_13-10-2022;Тверская область;21_45_days;EpiVacCorona;824;494;1318;681519;330234;1011753
2022.01_13-10-2022;Тверская область;21_45_days;SputnikLite;13129;8243;21372;681519;330234;1011753
2022.01_13-10-2022;Тверская область;21_45_days;SputnikV;4372;2110;6482;681519;330234;1011753
2022.01_13-10-2022;Тверская область;45_75_days;AllVaccines;37833;25495;63328;681519;330234;1011753
2022.01_13-10-2022;Тверская область;45_75_days;CoviVac;1075;303;1378;681519;330234;1011753
2022.01_13-10-2022;Тверская область;45_75_days;EpiVacCorona;2834;1952;4786;681519;330234;1011753
2022.01_13-10-2022;Тверская область;45_75_days;SputnikLite;10895;10065;20960;681519;330234;1011753
2022.01_13-10-2022;Тверская область;45_75_days;SputnikV;23029;13175;36204;681519;330234;1011753
2022.01_13-10-2022;Тверская область;75_90_days;AllVaccines;30024;17778;47802;681519;330234;1011753
2022.01_13-10-2022;Тверская область;75_90_days;CoviVac;373;94;467;681519;330234;1011753
2022.01_13-10-2022;Тверская область;75_90_days;EpiVacCorona;1900;904;2804;681519;330234;1011753
2022.01_13-10-2022;Тверская область;75_90_days;SputnikLite;7767;8378;16145;681519;330234;1011753
2022.01_13-10-2022;Тверская область;75_90_days;SputnikV;19984;8402;28386;681519;330234;1011753
2022.01_13-10-2022;Тверская область;90_105_days;AllVaccines;22420;14803;37223;681519;330234;1011753
2022.01_13-10-2022;Тверская область;90_105_days;CoviVac;487;130;617;681519;330234;1011753
2022.01_13-10-2022;Тверская область;90_105_days;EpiVacCorona;815;306;1121;681519;330234;1011753
2022.01_13-10-2022;Тверская область;90_105_days;SputnikLite;8885;8090;16975;681519;330234;1011753
2022.01_13-10-2022;Тверская область;90_105_days;SputnikV;12233;6277;18510;681519;330234;1011753
2022.01_13-10-2022;Томская область;105_165_days;AllVaccines;45071;22173;67244;621613;222482;844095
2022.01_13-10-2022;Томская область;105_165_days;CoviVac;198;22;220;621613;222482;844095
2022.01_13-10-2022;Томская область;105_165_days;EpiVacCorona;368;113;481;621613;222482;844095
2022.01_13-10-2022;Томская область;105_165_days;SputnikLite;25755;15798;41553;621613;222482;844095
2022.01_13-10-2022;Томская область;105_165_days;SputnikV;18750;6240;24990;621613;222482;844095
2022.01_13-10-2022;Томская область;165_195_days;AllVaccines;42858;11030;53888;621613;222482;844095
2022.01_13-10-2022;Томская область;165_195_days;CoviVac;361;25;386;621613;222482;844095
2022.01_13-10-2022;Томская область;165_195_days;EpiVacCorona;1099;276;1375;621613;222482;844095
2022.01_13-10-2022;Томская область;165_195_days;SputnikLite;6318;1428;7746;621613;222482;844095
2022.01_13-10-2022;Томская область;165_195_days;SputnikV;35080;9301;44381;621613;222482;844095
2022.01_13-10-2022;Томская область;21_45_days;AllVaccines;22751;10452;33203;621613;222482;844095
2022.01_13-10-2022;Томская область;21_45_days;CoviVac;253;41;294;621613;222482;844095
2022.01_13-10-2022;Томская область;21_45_days;EpiVacCorona;1034;433;1467;621613;222482;844095
2022.01_13-10-2022;Томская область;21_45_days;SputnikLite;13457;7732;21189;621613;222482;844095
2022.01_13-10-2022;Томская область;21_45_days;SputnikV;8007;2246;10253;621613;222482;844095
2022.01_13-10-2022;Томская область;45_75_days;AllVaccines;66742;23539;90281;621613;222482;844095
2022.01_13-10-2022;Томская область;45_75_days;CoviVac;1341;192;1533;621613;222482;844095
2022.01_13-10-2022;Томская область;45_75_days;EpiVacCorona;1045;416;1461;621613;222482;844095
2022.01_13-10-2022;Томская область;45_75_days;SputnikLite;15505;10906;26411;621613;222482;844095
2022.01_13-10-2022;Томская область;45_75_days;SputnikV;48851;12025;60876;621613;222482;844095
2022.01_13-10-2022;Томская область;75_90_days;AllVaccines;43119;12949;56068;621613;222482;844095
2022.01_13-10-2022;Томская область;75_90_days;CoviVac;1313;183;1496;621613;222482;844095
2022.01_13-10-2022;Томская область;75_90_days;EpiVacCorona;724;190;914;621613;222482;844095
2022.01_13-10-2022;Томская область;75_90_days;SputnikLite;11336;6661;17997;621613;222482;844095
2022.01_13-10-2022;Томская область;75_90_days;SputnikV;29746;5915;35661;621613;222482;844095
2022.01_13-10-2022;Томская область;90_105_days;AllVaccines;25968;10185;36153;621613;222482;844095
2022.01_13-10-2022;Томская область;90_105_days;CoviVac;638;63;701;621613;222482;844095
2022.01_13-10-2022;Томская область;90_105_days;EpiVacCorona;246;74;320;621613;222482;844095
2022.01_13-10-2022;Томская область;90_105_days;SputnikLite;11227;6452;17679;621613;222482;844095
2022.01_13-10-2022;Томская область;90_105_days;SputnikV;13857;3596;17453;621613;222482;844095
2022.01_13-10-2022;Тульская область;105_165_days;AllVaccines;56249;33521;89770;804510;401385;1205895
2022.01_13-10-2022;Тульская область;105_165_days;CoviVac;504;179;683;804510;401385;1205895
2022.01_13-10-2022;Тульская область;105_165_days;EpiVacCorona;969;770;1739;804510;401385;1205895
2022.01_13-10-2022;Тульская область;105_165_days;SputnikLite;27803;18543;46346;804510;401385;1205895
2022.01_13-10-2022;Тульская область;105_165_days;SputnikV;26973;14029;41002;804510;401385;1205895
2022.01_13-10-2022;Тульская область;165_195_days;AllVaccines;100660;23397;124057;804510;401385;1205895
2022.01_13-10-2022;Тульская область;165_195_days;CoviVac;435;65;500;804510;401385;1205895
2022.01_13-10-2022;Тульская область;165_195_days;EpiVacCorona;936;436;1372;804510;401385;1205895
2022.01_13-10-2022;Тульская область;165_195_days;SputnikLite;8954;1885;10839;804510;401385;1205895
2022.01_13-10-2022;Тульская область;165_195_days;SputnikV;90335;21011;111346;804510;401385;1205895
2022.01_13-10-2022;Тульская область;21_45_days;AllVaccines;26637;14481;41118;804510;401385;1205895
2022.01_13-10-2022;Тульская область;21_45_days;CoviVac;196;75;271;804510;401385;1205895
2022.01_13-10-2022;Тульская область;21_45_days;EpiVacCorona;657;791;1448;804510;401385;1205895
2022.01_13-10-2022;Тульская область;21_45_days;SputnikLite;19435;9810;29245;804510;401385;1205895
2022.01_13-10-2022;Тульская область;21_45_days;SputnikV;6349;3805;10154;804510;401385;1205895
2022.01_13-10-2022;Тульская область;45_75_days;AllVaccines;56050;32672;88722;804510;401385;1205895
2022.01_13-10-2022;Тульская область;45_75_days;CoviVac;540;217;757;804510;401385;1205895
2022.01_13-10-2022;Тульская область;45_75_days;EpiVacCorona;2317;1579;3896;804510;401385;1205895
2022.01_13-10-2022;Тульская область;45_75_days;SputnikLite;14176;11586;25762;804510;401385;1205895
2022.01_13-10-2022;Тульская область;45_75_days;SputnikV;39017;19290;58307;804510;401385;1205895
2022.01_13-10-2022;Тульская область;75_90_days;AllVaccines;30028;18855;48883;804510;401385;1205895
2022.01_13-10-2022;Тульская область;75_90_days;CoviVac;594;186;780;804510;401385;1205895
2022.01_13-10-2022;Тульская область;75_90_days;EpiVacCorona;1540;1198;2738;804510;401385;1205895
2022.01_13-10-2022;Тульская область;75_90_days;SputnikLite;11610;8116;19726;804510;401385;1205895
2022.01_13-10-2022;Тульская область;75_90_days;SputnikV;16284;9355;25639;804510;401385;1205895
2022.01_13-10-2022;Тульская область;90_105_days;AllVaccines;28813;19530;48343;804510;401385;1205895
2022.01_13-10-2022;Тульская область;90_105_days;CoviVac;647;257;904;804510;401385;1205895
2022.01_13-10-2022;Тульская область;90_105_days;EpiVacCorona;1341;1561;2902;804510;401385;1205895
2022.01_13-10-2022;Тульская область;90_105_days;SputnikLite;16938;9834;26772;804510;401385;1205895
2022.01_13-10-2022;Тульская область;90_105_days;SputnikV;9887;7878;17765;804510;401385;1205895
2022.01_13-10-2022;Тюменская область;105_165_days;AllVaccines;100537;34237;134774;870789;301209;1171998
2022.01_13-10-2022;Тюменская область;105_165_days;CoviVac;201;50;251;870789;301209;1171998
2022.01_13-10-2022;Тюменская область;105_165_days;EpiVacCorona;560;318;878;870789;301209;1171998
2022.01_13-10-2022;Тюменская область;105_165_days;SputnikLite;72370;24894;97264;870789;301209;1171998
2022.01_13-10-2022;Тюменская область;105_165_days;SputnikV;27406;8975;36381;870789;301209;1171998
2022.01_13-10-2022;Тюменская область;165_195_days;AllVaccines;104276;22170;126446;870789;301209;1171998
2022.01_13-10-2022;Тюменская область;165_195_days;CoviVac;344;60;404;870789;301209;1171998
2022.01_13-10-2022;Тюменская область;165_195_days;EpiVacCorona;1255;421;1676;870789;301209;1171998
2022.01_13-10-2022;Тюменская область;165_195_days;SputnikLite;27500;5895;33395;870789;301209;1171998
2022.01_13-10-2022;Тюменская область;165_195_days;SputnikV;75177;15794;90971;870789;301209;1171998
2022.01_13-10-2022;Тюменская область;21_45_days;AllVaccines;45136;20187;65323;870789;301209;1171998
2022.01_13-10-2022;Тюменская область;21_45_days;CoviVac;121;34;155;870789;301209;1171998
2022.01_13-10-2022;Тюменская область;21_45_days;EpiVacCorona;90;66;156;870789;301209;1171998
2022.01_13-10-2022;Тюменская область;21_45_days;SputnikLite;34350;16577;50927;870789;301209;1171998
2022.01_13-10-2022;Тюменская область;21_45_days;SputnikV;10575;3510;14085;870789;301209;1171998
2022.01_13-10-2022;Тюменская область;45_75_days;AllVaccines;106032;42411;148443;870789;301209;1171998
2022.01_13-10-2022;Тюменская область;45_75_days;CoviVac;403;89;492;870789;301209;1171998
2022.01_13-10-2022;Тюменская область;45_75_days;EpiVacCorona;449;174;623;870789;301209;1171998
2022.01_13-10-2022;Тюменская область;45_75_days;SputnikLite;30473;20905;51378;870789;301209;1171998
2022.01_13-10-2022;Тюменская область;45_75_days;SputnikV;74707;21243;95950;870789;301209;1171998
2022.01_13-10-2022;Тюменская область;75_90_days;AllVaccines;68459;26361;94820;870789;301209;1171998
2022.01_13-10-2022;Тюменская область;75_90_days;CoviVac;889;149;1038;870789;301209;1171998
2022.01_13-10-2022;Тюменская область;75_90_days;EpiVacCorona;824;164;988;870789;301209;1171998
2022.01_13-10-2022;Тюменская область;75_90_days;SputnikLite;19121;14450;33571;870789;301209;1171998
2022.01_13-10-2022;Тюменская область;75_90_days;SputnikV;47625;11598;59223;870789;301209;1171998
2022.01_13-10-2022;Тюменская область;90_105_days;AllVaccines;22620;7087;29707;870789;301209;1171998
2022.01_13-10-2022;Тюменская область;90_105_days;CoviVac;303;61;364;870789;301209;1171998
2022.01_13-10-2022;Тюменская область;90_105_days;EpiVacCorona;269;113;382;870789;301209;1171998
2022.01_13-10-2022;Тюменская область;90_105_days;SputnikLite;7986;3043;11029;870789;301209;1171998
2022.01_13-10-2022;Тюменская область;90_105_days;SputnikV;14062;3870;17932;870789;301209;1171998
2022.01_13-10-2022;Удмуртская Республика;105_165_days;AllVaccines;98757;36353;135110;818861;336450;1155311
2022.01_13-10-2022;Удмуртская Республика;105_165_days;CoviVac;110;11;121;818861;336450;1155311
2022.01_13-10-2022;Удмуртская Республика;105_165_days;EpiVacCorona;5254;3481;8735;818861;336450;1155311
2022.01_13-10-2022;Удмуртская Республика;105_165_days;SputnikLite;62963;21053;84016;818861;336450;1155311
2022.01_13-10-2022;Удмуртская Республика;105_165_days;SputnikV;30430;11808;42238;818861;336450;1155311
2022.01_13-10-2022;Удмуртская Республика;165_195_days;AllVaccines;78694;18611;97305;818861;336450;1155311
2022.01_13-10-2022;Удмуртская Республика;165_195_days;CoviVac;502;58;560;818861;336450;1155311
2022.01_13-10-2022;Удмуртская Республика;165_195_days;EpiVacCorona;3259;1818;5077;818861;336450;1155311
2022.01_13-10-2022;Удмуртская Республика;165_195_days;SputnikLite;24639;2596;27235;818861;336450;1155311
2022.01_13-10-2022;Удмуртская Республика;165_195_days;SputnikV;50294;14139;64433;818861;336450;1155311
2022.01_13-10-2022;Удмуртская Республика;21_45_days;AllVaccines;23374;14928;38302;818861;336450;1155311
2022.01_13-10-2022;Удмуртская Республика;21_45_days;CoviVac;363;70;433;818861;336450;1155311
2022.01_13-10-2022;Удмуртская Республика;21_45_days;EpiVacCorona;924;741;1665;818861;336450;1155311
2022.01_13-10-2022;Удмуртская Республика;21_45_days;SputnikLite;13339;10612;23951;818861;336450;1155311
2022.01_13-10-2022;Удмуртская Республика;21_45_days;SputnikV;8748;3505;12253;818861;336450;1155311
2022.01_13-10-2022;Удмуртская Республика;45_75_days;AllVaccines;63971;31150;95121;818861;336450;1155311
2022.01_13-10-2022;Удмуртская Республика;45_75_days;CoviVac;1930;297;2227;818861;336450;1155311
2022.01_13-10-2022;Удмуртская Республика;45_75_days;EpiVacCorona;2697;1516;4213;818861;336450;1155311
2022.01_13-10-2022;Удмуртская Республика;45_75_days;SputnikLite;11262;11859;23121;818861;336450;1155311
2022.01_13-10-2022;Удмуртская Республика;45_75_days;SputnikV;48082;17478;65560;818861;336450;1155311
2022.01_13-10-2022;Удмуртская Республика;75_90_days;AllVaccines;69097;27526;96623;818861;336450;1155311
2022.01_13-10-2022;Удмуртская Республика;75_90_days;CoviVac;730;104;834;818861;336450;1155311
2022.01_13-10-2022;Удмуртская Республика;75_90_days;EpiVacCorona;3088;1317;4405;818861;336450;1155311
2022.01_13-10-2022;Удмуртская Республика;75_90_days;SputnikLite;10301;10248;20549;818861;336450;1155311
2022.01_13-10-2022;Удмуртская Республика;75_90_days;SputnikV;54978;15857;70835;818861;336450;1155311
2022.01_13-10-2022;Удмуртская Республика;90_105_days;AllVaccines;33542;11248;44790;818861;336450;1155311
2022.01_13-10-2022;Удмуртская Республика;90_105_days;CoviVac;784;111;895;818861;336450;1155311
2022.01_13-10-2022;Удмуртская Республика;90_105_days;EpiVacCorona;2516;1282;3798;818861;336450;1155311
2022.01_13-10-2022;Удмуртская Республика;90_105_days;SputnikLite;2922;1706;4628;818861;336450;1155311
2022.01_13-10-2022;Удмуртская Республика;90_105_days;SputnikV;27320;8149;35469;818861;336450;1155311
2022.01_13-10-2022;Ульяновская область;105_165_days;AllVaccines;69669;34422;104091;672149;320065;992214
2022.01_13-10-2022;Ульяновская область;105_165_days;CoviVac;92;22;114;672149;320065;992214
2022.01_13-10-2022;Ульяновская область;105_165_days;EpiVacCorona;853;257;1110;672149;320065;992214
2022.01_13-10-2022;Ульяновская область;105_165_days;SputnikLite;34826;23692;58518;672149;320065;992214
2022.01_13-10-2022;Ульяновская область;105_165_days;SputnikV;33898;10451;44349;672149;320065;992214
2022.01_13-10-2022;Ульяновская область;165_195_days;AllVaccines;66125;14231;80356;672149;320065;992214
2022.01_13-10-2022;Ульяновская область;165_195_days;CoviVac;205;20;225;672149;320065;992214
2022.01_13-10-2022;Ульяновская область;165_195_days;EpiVacCorona;1562;386;1948;672149;320065;992214
2022.01_13-10-2022;Ульяновская область;165_195_days;SputnikLite;14617;3141;17758;672149;320065;992214
2022.01_13-10-2022;Ульяновская область;165_195_days;SputnikV;49741;10684;60425;672149;320065;992214
2022.01_13-10-2022;Ульяновская область;21_45_days;AllVaccines;19912;11161;31073;672149;320065;992214
2022.01_13-10-2022;Ульяновская область;21_45_days;CoviVac;150;38;188;672149;320065;992214
2022.01_13-10-2022;Ульяновская область;21_45_days;EpiVacCorona;548;348;896;672149;320065;992214
2022.01_13-10-2022;Ульяновская область;21_45_days;SputnikLite;12721;8059;20780;672149;320065;992214
2022.01_13-10-2022;Ульяновская область;21_45_days;SputnikV;6493;2716;9209;672149;320065;992214
2022.01_13-10-2022;Ульяновская область;45_75_days;AllVaccines;58205;31577;89782;672149;320065;992214
2022.01_13-10-2022;Ульяновская область;45_75_days;CoviVac;762;174;936;672149;320065;992214
2022.01_13-10-2022;Ульяновская область;45_75_days;EpiVacCorona;1964;991;2955;672149;320065;992214
2022.01_13-10-2022;Ульяновская область;45_75_days;SputnikLite;12571;12032;24603;672149;320065;992214
2022.01_13-10-2022;Ульяновская область;45_75_days;SputnikV;42908;18380;61288;672149;320065;992214
2022.01_13-10-2022;Ульяновская область;75_90_days;AllVaccines;41372;20695;62067;672149;320065;992214
2022.01_13-10-2022;Ульяновская область;75_90_days;CoviVac;962;210;1172;672149;320065;992214
2022.01_13-10-2022;Ульяновская область;75_90_days;EpiVacCorona;974;344;1318;672149;320065;992214
2022.01_13-10-2022;Ульяновская область;75_90_days;SputnikLite;8063;8445;16508;672149;320065;992214
2022.01_13-10-2022;Ульяновская область;75_90_days;SputnikV;31373;11696;43069;672149;320065;992214
2022.01_13-10-2022;Ульяновская область;90_105_days;AllVaccines;25744;12631;38375;672149;320065;992214
2022.01_13-10-2022;Ульяновская область;90_105_days;CoviVac;639;161;800;672149;320065;992214
2022.01_13-10-2022;Ульяновская область;90_105_days;EpiVacCorona;709;252;961;672149;320065;992214
2022.01_13-10-2022;Ульяновская область;90_105_days;SputnikLite;6455;5846;12301;672149;320065;992214
2022.01_13-10-2022;Ульяновская область;90_105_days;SputnikV;17941;6372;24313;672149;320065;992214
2022.01_13-10-2022;Хабаровский край;105_165_days;AllVaccines;47789;21279;69068;757169;265178;1022347
2022.01_13-10-2022;Хабаровский край;105_165_days;CoviVac;54;13;67;757169;265178;1022347
2022.01_13-10-2022;Хабаровский край;105_165_days;EpiVacCorona;7;4;11;757169;265178;1022347
2022.01_13-10-2022;Хабаровский край;105_165_days;SputnikLite;24410;12819;37229;757169;265178;1022347
2022.01_13-10-2022;Хабаровский край;105_165_days;SputnikV;23318;8443;31761;757169;265178;1022347
2022.01_13-10-2022;Хабаровский край;165_195_days;AllVaccines;73436;13492;86928;757169;265178;1022347
2022.01_13-10-2022;Хабаровский край;165_195_days;CoviVac;311;22;333;757169;265178;1022347
2022.01_13-10-2022;Хабаровский край;165_195_days;EpiVacCorona;24;39;63;757169;265178;1022347
2022.01_13-10-2022;Хабаровский край;165_195_days;SputnikLite;16933;2523;19456;757169;265178;1022347
2022.01_13-10-2022;Хабаровский край;165_195_days;SputnikV;56168;10908;67076;757169;265178;1022347
2022.01_13-10-2022;Хабаровский край;21_45_days;AllVaccines;26730;12508;39238;757169;265178;1022347
2022.01_13-10-2022;Хабаровский край;21_45_days;CoviVac;357;55;412;757169;265178;1022347
2022.01_13-10-2022;Хабаровский край;21_45_days;EpiVacCorona;1713;654;2367;757169;265178;1022347
2022.01_13-10-2022;Хабаровский край;21_45_days;SputnikLite;12255;7130;19385;757169;265178;1022347
2022.01_13-10-2022;Хабаровский край;21_45_days;SputnikV;12405;4669;17074;757169;265178;1022347
2022.01_13-10-2022;Хабаровский край;45_75_days;AllVaccines;67849;24171;92020;757169;265178;1022347
2022.01_13-10-2022;Хабаровский край;45_75_days;CoviVac;1270;262;1532;757169;265178;1022347
2022.01_13-10-2022;Хабаровский край;45_75_days;EpiVacCorona;4192;1387;5579;757169;265178;1022347
2022.01_13-10-2022;Хабаровский край;45_75_days;SputnikLite;19096;9079;28175;757169;265178;1022347
2022.01_13-10-2022;Хабаровский край;45_75_days;SputnikV;43291;13443;56734;757169;265178;1022347
2022.01_13-10-2022;Хабаровский край;75_90_days;AllVaccines;30133;10945;41078;757169;265178;1022347
2022.01_13-10-2022;Хабаровский край;75_90_days;CoviVac;930;155;1085;757169;265178;1022347
2022.01_13-10-2022;Хабаровский край;75_90_days;EpiVacCorona;1364;329;1693;757169;265178;1022347
2022.01_13-10-2022;Хабаровский край;75_90_days;SputnikLite;12387;5338;17725;757169;265178;1022347
2022.01_13-10-2022;Хабаровский край;75_90_days;SputnikV;15452;5123;20575;757169;265178;1022347
2022.01_13-10-2022;Хабаровский край;90_105_days;AllVaccines;22341;8701;31042;757169;265178;1022347
2022.01_13-10-2022;Хабаровский край;90_105_days;CoviVac;330;105;435;757169;265178;1022347
2022.01_13-10-2022;Хабаровский край;90_105_days;EpiVacCorona;105;72;177;757169;265178;1022347
2022.01_13-10-2022;Хабаровский край;90_105_days;SputnikLite;15546;5399;20945;757169;265178;1022347
2022.01_13-10-2022;Хабаровский край;90_105_days;SputnikV;6360;3125;9485;757169;265178;1022347
2022.01_13-10-2022;Ханты-Мансийский автономный округ - Югра;105_165_days;AllVaccines;106015;21459;127474;1019471;240107;1259578
2022.01_13-10-2022;Ханты-Мансийский автономный округ - Югра;105_165_days;CoviVac;523;101;624;1019471;240107;1259578
2022.01_13-10-2022;Ханты-Мансийский автономный округ - Югра;105_165_days;EpiVacCorona;780;163;943;1019471;240107;1259578
2022.01_13-10-2022;Ханты-Мансийский автономный округ - Югра;105_165_days;SputnikLite;62098;13998;76096;1019471;240107;1259578
2022.01_13-10-2022;Ханты-Мансийский автономный округ - Югра;105_165_days;SputnikV;42614;7197;49811;1019471;240107;1259578
2022.01_13-10-2022;Ханты-Мансийский автономный округ - Югра;165_195_days;AllVaccines;84462;9785;94247;1019471;240107;1259578
2022.01_13-10-2022;Ханты-Мансийский автономный округ - Югра;165_195_days;CoviVac;401;62;463;1019471;240107;1259578
2022.01_13-10-2022;Ханты-Мансийский автономный округ - Югра;165_195_days;EpiVacCorona;989;203;1192;1019471;240107;1259578
2022.01_13-10-2022;Ханты-Мансийский автономный округ - Югра;165_195_days;SputnikLite;14529;1749;16278;1019471;240107;1259578
2022.01_13-10-2022;Ханты-Мансийский автономный округ - Югра;165_195_days;SputnikV;68543;7771;76314;1019471;240107;1259578
2022.01_13-10-2022;Ханты-Мансийский автономный округ - Югра;21_45_days;AllVaccines;43126;10926;54052;1019471;240107;1259578
2022.01_13-10-2022;Ханты-Мансийский автономный округ - Югра;21_45_days;CoviVac;184;42;226;1019471;240107;1259578
2022.01_13-10-2022;Ханты-Мансийский автономный округ - Югра;21_45_days;EpiVacCorona;533;182;715;1019471;240107;1259578
2022.01_13-10-2022;Ханты-Мансийский автономный округ - Югра;21_45_days;SputnikLite;30105;7992;38097;1019471;240107;1259578
2022.01_13-10-2022;Ханты-Мансийский автономный округ - Югра;21_45_days;SputnikV;12304;2710;15014;1019471;240107;1259578
2022.01_13-10-2022;Ханты-Мансийский автономный округ - Югра;45_75_days;AllVaccines;90276;23241;113517;1019471;240107;1259578
2022.01_13-10-2022;Ханты-Мансийский автономный округ - Югра;45_75_days;CoviVac;402;69;471;1019471;240107;1259578
2022.01_13-10-2022;Ханты-Мансийский автономный округ - Югра;45_75_days;EpiVacCorona;1266;501;1767;1019471;240107;1259578
2022.01_13-10-2022;Ханты-Мансийский автономный округ - Югра;45_75_days;SputnikLite;33794;10235;44029;1019471;240107;1259578
2022.01_13-10-2022;Ханты-Мансийский автономный округ - Югра;45_75_days;SputnikV;54814;12436;67250;1019471;240107;1259578
2022.01_13-10-2022;Ханты-Мансийский автономный округ - Югра;75_90_days;AllVaccines;82026;17467;99493;1019471;240107;1259578
2022.01_13-10-2022;Ханты-Мансийский автономный округ - Югра;75_90_days;CoviVac;390;85;475;1019471;240107;1259578
2022.01_13-10-2022;Ханты-Мансийский автономный округ - Югра;75_90_days;EpiVacCorona;1222;372;1594;1019471;240107;1259578
2022.01_13-10-2022;Ханты-Мансийский автономный округ - Югра;75_90_days;SputnikLite;19837;7193;27030;1019471;240107;1259578
2022.01_13-10-2022;Ханты-Мансийский автономный округ - Югра;75_90_days;SputnikV;60577;9817;70394;1019471;240107;1259578
2022.01_13-10-2022;Ханты-Мансийский автономный округ - Югра;90_105_days;AllVaccines;52612;11016;63628;1019471;240107;1259578
2022.01_13-10-2022;Ханты-Мансийский автономный округ - Югра;90_105_days;CoviVac;800;126;926;1019471;240107;1259578
2022.01_13-10-2022;Ханты-Мансийский автономный округ - Югра;90_105_days;EpiVacCorona;308;69;377;1019471;240107;1259578
2022.01_13-10-2022;Ханты-Мансийский автономный округ - Югра;90_105_days;SputnikLite;10357;4254;14611;1019471;240107;1259578
2022.01_13-10-2022;Ханты-Мансийский автономный округ - Югра;90_105_days;SputnikV;41147;6567;47714;1019471;240107;1259578
2022.01_13-10-2022;Челябинская область;105_165_days;AllVaccines;195025;72872;267897;1901705;795956;2697661
2022.01_13-10-2022;Челябинская область;105_165_days;CoviVac;4183;1136;5319;1901705;795956;2697661
2022.01_13-10-2022;Челябинская область;105_165_days;EpiVacCorona;2387;1269;3656;1901705;795956;2697661
2022.01_13-10-2022;Челябинская область;105_165_days;SputnikLite;108377;39199;147576;1901705;795956;2697661
2022.01_13-10-2022;Челябинская область;105_165_days;SputnikV;80078;31268;111346;1901705;795956;2697661
2022.01_13-10-2022;Челябинская область;165_195_days;AllVaccines;160809;35050;195859;1901705;795956;2697661
2022.01_13-10-2022;Челябинская область;165_195_days;CoviVac;1118;187;1305;1901705;795956;2697661
2022.01_13-10-2022;Челябинская область;165_195_days;EpiVacCorona;4486;1994;6480;1901705;795956;2697661
2022.01_13-10-2022;Челябинская область;165_195_days;SputnikLite;44335;5877;50212;1901705;795956;2697661
2022.01_13-10-2022;Челябинская область;165_195_days;SputnikV;110870;26992;137862;1901705;795956;2697661
2022.01_13-10-2022;Челябинская область;21_45_days;AllVaccines;60485;34241;94726;1901705;795956;2697661
2022.01_13-10-2022;Челябинская область;21_45_days;CoviVac;343;128;471;1901705;795956;2697661
2022.01_13-10-2022;Челябинская область;21_45_days;EpiVacCorona;1492;1133;2625;1901705;795956;2697661
2022.01_13-10-2022;Челябинская область;21_45_days;SputnikLite;40597;24230;64827;1901705;795956;2697661
2022.01_13-10-2022;Челябинская область;21_45_days;SputnikV;18053;8750;26803;1901705;795956;2697661
2022.01_13-10-2022;Челябинская область;45_75_days;AllVaccines;181302;84542;265844;1901705;795956;2697661
2022.01_13-10-2022;Челябинская область;45_75_days;CoviVac;1198;349;1547;1901705;795956;2697661
2022.01_13-10-2022;Челябинская область;45_75_days;EpiVacCorona;5292;2741;8033;1901705;795956;2697661
2022.01_13-10-2022;Челябинская область;45_75_days;SputnikLite;47730;27812;75542;1901705;795956;2697661
2022.01_13-10-2022;Челябинская область;45_75_days;SputnikV;127082;53640;180722;1901705;795956;2697661
2022.01_13-10-2022;Челябинская область;75_90_days;AllVaccines;174750;59850;234600;1901705;795956;2697661
2022.01_13-10-2022;Челябинская область;75_90_days;CoviVac;757;183;940;1901705;795956;2697661
2022.01_13-10-2022;Челябинская область;75_90_days;EpiVacCorona;6957;2501;9458;1901705;795956;2697661
2022.01_13-10-2022;Челябинская область;75_90_days;SputnikLite;21525;13024;34549;1901705;795956;2697661
2022.01_13-10-2022;Челябинская область;75_90_days;SputnikV;145511;44142;189653;1901705;795956;2697661
2022.01_13-10-2022;Челябинская область;90_105_days;AllVaccines;116939;41610;158549;1901705;795956;2697661
2022.01_13-10-2022;Челябинская область;90_105_days;CoviVac;2413;376;2789;1901705;795956;2697661
2022.01_13-10-2022;Челябинская область;90_105_days;EpiVacCorona;3509;1261;4770;1901705;795956;2697661
2022.01_13-10-2022;Челябинская область;90_105_days;SputnikLite;22139;10740;32879;1901705;795956;2697661
2022.01_13-10-2022;Челябинская область;90_105_days;SputnikV;88878;29233;118111;1901705;795956;2697661
2022.01_13-10-2022;Чеченская Республика;105_165_days;AllVaccines;65077;14987;80064;809759;137234;946993
2022.01_13-10-2022;Чеченская Республика;105_165_days;CoviVac;604;155;759;809759;137234;946993
2022.01_13-10-2022;Чеченская Республика;105_165_days;EpiVacCorona;1221;287;1508;809759;137234;946993
2022.01_13-10-2022;Чеченская Республика;105_165_days;SputnikLite;10401;1188;11589;809759;137234;946993
2022.01_13-10-2022;Чеченская Республика;105_165_days;SputnikV;52851;13357;66208;809759;137234;946993
2022.01_13-10-2022;Чеченская Республика;165_195_days;AllVaccines;119034;28098;147132;809759;137234;946993
2022.01_13-10-2022;Чеченская Республика;165_195_days;CoviVac;266;89;355;809759;137234;946993
2022.01_13-10-2022;Чеченская Республика;165_195_days;EpiVacCorona;231;51;282;809759;137234;946993
2022.01_13-10-2022;Чеченская Республика;165_195_days;SputnikLite;54;7;61;809759;137234;946993
2022.01_13-10-2022;Чеченская Республика;165_195_days;SputnikV;118483;27951;146434;809759;137234;946993
2022.01_13-10-2022;Чеченская Республика;21_45_days;AllVaccines;13278;1833;15111;809759;137234;946993
2022.01_13-10-2022;Чеченская Республика;21_45_days;CoviVac;16;8;24;809759;137234;946993
2022.01_13-10-2022;Чеченская Республика;21_45_days;EpiVacCorona;409;70;479;809759;137234;946993
2022.01_13-10-2022;Чеченская Республика;21_45_days;SputnikLite;11594;1575;13169;809759;137234;946993
2022.01_13-10-2022;Чеченская Республика;21_45_days;SputnikV;1259;180;1439;809759;137234;946993
2022.01_13-10-2022;Чеченская Республика;45_75_days;AllVaccines;23781;2879;26660;809759;137234;946993
2022.01_13-10-2022;Чеченская Республика;45_75_days;CoviVac;157;28;185;809759;137234;946993
2022.01_13-10-2022;Чеченская Республика;45_75_days;EpiVacCorona;2114;333;2447;809759;137234;946993
2022.01_13-10-2022;Чеченская Республика;45_75_days;SputnikLite;14101;1359;15460;809759;137234;946993
2022.01_13-10-2022;Чеченская Республика;45_75_days;SputnikV;7409;1159;8568;809759;137234;946993
2022.01_13-10-2022;Чеченская Республика;75_90_days;AllVaccines;8544;1198;9742;809759;137234;946993
2022.01_13-10-2022;Чеченская Республика;75_90_days;CoviVac;191;36;227;809759;137234;946993
2022.01_13-10-2022;Чеченская Республика;75_90_days;EpiVacCorona;963;142;1105;809759;137234;946993
2022.01_13-10-2022;Чеченская Республика;75_90_days;SputnikLite;1465;102;1567;809759;137234;946993
2022.01_13-10-2022;Чеченская Республика;75_90_days;SputnikV;5925;918;6843;809759;137234;946993
2022.01_13-10-2022;Чеченская Республика;90_105_days;AllVaccines;9928;1786;11714;809759;137234;946993
2022.01_13-10-2022;Чеченская Республика;90_105_days;CoviVac;170;31;201;809759;137234;946993
2022.01_13-10-2022;Чеченская Республика;90_105_days;EpiVacCorona;954;164;1118;809759;137234;946993
2022.01_13-10-2022;Чеченская Республика;90_105_days;SputnikLite;1559;96;1655;809759;137234;946993
2022.01_13-10-2022;Чеченская Республика;90_105_days;SputnikV;7245;1495;8740;809759;137234;946993
2022.01_13-10-2022;Чувашская Республика;105_165_days;AllVaccines;68988;24005;92993;674689;275580;950269
2022.01_13-10-2022;Чувашская Республика;105_165_days;CoviVac;484;98;582;674689;275580;950269
2022.01_13-10-2022;Чувашская Республика;105_165_days;EpiVacCorona;501;215;716;674689;275580;950269
2022.01_13-10-2022;Чувашская Республика;105_165_days;SputnikLite;45282;15111;60393;674689;275580;950269
2022.01_13-10-2022;Чувашская Республика;105_165_days;SputnikV;22721;8581;31302;674689;275580;950269
2022.01_13-10-2022;Чувашская Республика;165_195_days;AllVaccines;57609;12130;69739;674689;275580;950269
2022.01_13-10-2022;Чувашская Республика;165_195_days;CoviVac;235;18;253;674689;275580;950269
2022.01_13-10-2022;Чувашская Республика;165_195_days;EpiVacCorona;1538;376;1914;674689;275580;950269
2022.01_13-10-2022;Чувашская Республика;165_195_days;SputnikLite;10865;2496;13361;674689;275580;950269
2022.01_13-10-2022;Чувашская Республика;165_195_days;SputnikV;44971;9240;54211;674689;275580;950269
2022.01_13-10-2022;Чувашская Республика;21_45_days;AllVaccines;24265;11347;35612;674689;275580;950269
2022.01_13-10-2022;Чувашская Республика;21_45_days;CoviVac;366;66;432;674689;275580;950269
2022.01_13-10-2022;Чувашская Республика;21_45_days;EpiVacCorona;604;387;991;674689;275580;950269
2022.01_13-10-2022;Чувашская Республика;21_45_days;SputnikLite;13606;7175;20781;674689;275580;950269
2022.01_13-10-2022;Чувашская Республика;21_45_days;SputnikV;9689;3719;13408;674689;275580;950269
2022.01_13-10-2022;Чувашская Республика;45_75_days;AllVaccines;61554;30989;92543;674689;275580;950269
2022.01_13-10-2022;Чувашская Республика;45_75_days;CoviVac;822;102;924;674689;275580;950269
2022.01_13-10-2022;Чувашская Республика;45_75_days;EpiVacCorona;1645;604;2249;674689;275580;950269
2022.01_13-10-2022;Чувашская Республика;45_75_days;SputnikLite;12279;12345;24624;674689;275580;950269
2022.01_13-10-2022;Чувашская Республика;45_75_days;SputnikV;46808;17938;64746;674689;275580;950269
2022.01_13-10-2022;Чувашская Республика;75_90_days;AllVaccines;46263;21168;67431;674689;275580;950269
2022.01_13-10-2022;Чувашская Республика;75_90_days;CoviVac;346;65;411;674689;275580;950269
2022.01_13-10-2022;Чувашская Республика;75_90_days;EpiVacCorona;1128;261;1389;674689;275580;950269
2022.01_13-10-2022;Чувашская Республика;75_90_days;SputnikLite;8974;8787;17761;674689;275580;950269
2022.01_13-10-2022;Чувашская Республика;75_90_days;SputnikV;35815;12055;47870;674689;275580;950269
2022.01_13-10-2022;Чувашская Республика;90_105_days;AllVaccines;26773;8294;35067;674689;275580;950269
2022.01_13-10-2022;Чувашская Республика;90_105_days;CoviVac;815;112;927;674689;275580;950269
2022.01_13-10-2022;Чувашская Республика;90_105_days;EpiVacCorona;960;251;1211;674689;275580;950269
2022.01_13-10-2022;Чувашская Республика;90_105_days;SputnikLite;1313;1194;2507;674689;275580;950269
2022.01_13-10-2022;Чувашская Республика;90_105_days;SputnikV;23685;6737;30422;674689;275580;950269
2022.01_13-10-2022;Чукотский автономный округ;105_165_days;AllVaccines;6396;1059;7455;30806;6299;37105
2022.01_13-10-2022;Чукотский автономный округ;105_165_days;CoviVac;360;37;397;30806;6299;37105
2022.01_13-10-2022;Чукотский автономный округ;105_165_days;EpiVacCorona;4;1;5;30806;6299;37105
2022.01_13-10-2022;Чукотский автономный округ;105_165_days;SputnikLite;5406;892;6298;30806;6299;37105
2022.01_13-10-2022;Чукотский автономный округ;105_165_days;SputnikV;626;129;755;30806;6299;37105
2022.01_13-10-2022;Чукотский автономный округ;165_195_days;AllVaccines;2267;258;2525;30806;6299;37105
2022.01_13-10-2022;Чукотский автономный округ;165_195_days;CoviVac;469;37;506;30806;6299;37105
2022.01_13-10-2022;Чукотский автономный округ;165_195_days;EpiVacCorona;4;2;6;30806;6299;37105
2022.01_13-10-2022;Чукотский автономный округ;165_195_days;SputnikLite;554;51;605;30806;6299;37105
2022.01_13-10-2022;Чукотский автономный округ;165_195_days;SputnikV;1240;168;1408;30806;6299;37105
2022.01_13-10-2022;Чукотский автономный округ;21_45_days;AllVaccines;1284;183;1467;30806;6299;37105
2022.01_13-10-2022;Чукотский автономный округ;21_45_days;CoviVac;41;7;48;30806;6299;37105
2022.01_13-10-2022;Чукотский автономный округ;21_45_days;EpiVacCorona;75;6;81;30806;6299;37105
2022.01_13-10-2022;Чукотский автономный округ;21_45_days;SputnikLite;1012;139;1151;30806;6299;37105
2022.01_13-10-2022;Чукотский автономный округ;21_45_days;SputnikV;156;31;187;30806;6299;37105
2022.01_13-10-2022;Чукотский автономный округ;45_75_days;AllVaccines;2524;449;2973;30806;6299;37105
2022.01_13-10-2022;Чукотский автономный округ;45_75_days;CoviVac;64;11;75;30806;6299;37105
2022.01_13-10-2022;Чукотский автономный округ;45_75_days;EpiVacCorona;293;44;337;30806;6299;37105
2022.01_13-10-2022;Чукотский автономный округ;45_75_days;SputnikLite;1681;332;2013;30806;6299;37105
2022.01_13-10-2022;Чукотский автономный округ;45_75_days;SputnikV;486;62;548;30806;6299;37105
2022.01_13-10-2022;Чукотский автономный округ;75_90_days;AllVaccines;2188;373;2561;30806;6299;37105
2022.01_13-10-2022;Чукотский автономный округ;75_90_days;CoviVac;215;19;234;30806;6299;37105
2022.01_13-10-2022;Чукотский автономный округ;75_90_days;EpiVacCorona;211;26;237;30806;6299;37105
2022.01_13-10-2022;Чукотский автономный округ;75_90_days;SputnikLite;1448;282;1730;30806;6299;37105
2022.01_13-10-2022;Чукотский автономный округ;75_90_days;SputnikV;314;46;360;30806;6299;37105
2022.01_13-10-2022;Чукотский автономный округ;90_105_days;AllVaccines;2250;374;2624;30806;6299;37105
2022.01_13-10-2022;Чукотский автономный округ;90_105_days;CoviVac;297;13;310;30806;6299;37105
2022.01_13-10-2022;Чукотский автономный округ;90_105_days;EpiVacCorona;62;10;72;30806;6299;37105
2022.01_13-10-2022;Чукотский автономный округ;90_105_days;SputnikLite;1746;331;2077;30806;6299;37105
2022.01_13-10-2022;Чукотский автономный округ;90_105_days;SputnikV;145;20;165;30806;6299;37105
2022.01_13-10-2022;Ямало-Ненецкий автономный округ;105_165_days;AllVaccines;40718;4775;45493;346064;56429;402493
2022.01_13-10-2022;Ямало-Ненецкий автономный округ;105_165_days;CoviVac;79;5;84;346064;56429;402493
2022.01_13-10-2022;Ямало-Ненецкий автономный округ;105_165_days;EpiVacCorona;138;13;151;346064;56429;402493
2022.01_13-10-2022;Ямало-Ненецкий автономный округ;105_165_days;SputnikLite;31918;3829;35747;346064;56429;402493
2022.01_13-10-2022;Ямало-Ненецкий автономный округ;105_165_days;SputnikV;8583;928;9511;346064;56429;402493
2022.01_13-10-2022;Ямало-Ненецкий автономный округ;165_195_days;AllVaccines;31210;2109;33319;346064;56429;402493
2022.01_13-10-2022;Ямало-Ненецкий автономный округ;165_195_days;CoviVac;421;34;455;346064;56429;402493
2022.01_13-10-2022;Ямало-Ненецкий автономный округ;165_195_days;EpiVacCorona;69;10;79;346064;56429;402493
2022.01_13-10-2022;Ямало-Ненецкий автономный округ;165_195_days;SputnikLite;11779;734;12513;346064;56429;402493
2022.01_13-10-2022;Ямало-Ненецкий автономный округ;165_195_days;SputnikV;18941;1331;20272;346064;56429;402493
2022.01_13-10-2022;Ямало-Ненецкий автономный округ;21_45_days;AllVaccines;14495;1852;16347;346064;56429;402493
2022.01_13-10-2022;Ямало-Ненецкий автономный округ;21_45_days;CoviVac;91;23;114;346064;56429;402493
2022.01_13-10-2022;Ямало-Ненецкий автономный округ;21_45_days;EpiVacCorona;106;10;116;346064;56429;402493
2022.01_13-10-2022;Ямало-Ненецкий автономный округ;21_45_days;SputnikLite;10944;1453;12397;346064;56429;402493
2022.01_13-10-2022;Ямало-Ненецкий автономный округ;21_45_days;SputnikV;3354;366;3720;346064;56429;402493
2022.01_13-10-2022;Ямало-Ненецкий автономный округ;45_75_days;AllVaccines;25218;3369;28587;346064;56429;402493
2022.01_13-10-2022;Ямало-Ненецкий автономный округ;45_75_days;CoviVac;311;54;365;346064;56429;402493
2022.01_13-10-2022;Ямало-Ненецкий автономный округ;45_75_days;EpiVacCorona;118;23;141;346064;56429;402493
2022.01_13-10-2022;Ямало-Ненецкий автономный округ;45_75_days;SputnikLite;10881;1847;12728;346064;56429;402493
2022.01_13-10-2022;Ямало-Ненецкий автономный округ;45_75_days;SputnikV;13908;1445;15353;346064;56429;402493
2022.01_13-10-2022;Ямало-Ненецкий автономный округ;75_90_days;AllVaccines;20655;2412;23067;346064;56429;402493
2022.01_13-10-2022;Ямало-Ненецкий автономный округ;75_90_days;CoviVac;186;20;206;346064;56429;402493
2022.01_13-10-2022;Ямало-Ненецкий автономный округ;75_90_days;EpiVacCorona;94;8;102;346064;56429;402493
2022.01_13-10-2022;Ямало-Ненецкий автономный округ;75_90_days;SputnikLite;7536;1381;8917;346064;56429;402493
2022.01_13-10-2022;Ямало-Ненецкий автономный округ;75_90_days;SputnikV;12839;1003;13842;346064;56429;402493
2022.01_13-10-2022;Ямало-Ненецкий автономный округ;90_105_days;AllVaccines;22557;2755;25312;346064;56429;402493
2022.01_13-10-2022;Ямало-Ненецкий автономный округ;90_105_days;CoviVac;361;31;392;346064;56429;402493
2022.01_13-10-2022;Ямало-Ненецкий автономный округ;90_105_days;EpiVacCorona;127;11;138;346064;56429;402493
2022.01_13-10-2022;Ямало-Ненецкий автономный округ;90_105_days;SputnikLite;11014;1917;12931;346064;56429;402493
2022.01_13-10-2022;Ямало-Ненецкий автономный округ;90_105_days;SputnikV;11055;796;11851;346064;56429;402493
2022.01_13-10-2022;Ярославская область;105_165_days;AllVaccines;62253;30570;92823;682586;317712;1000298
2022.01_13-10-2022;Ярославская область;105_165_days;CoviVac;150;20;170;682586;317712;1000298
2022.01_13-10-2022;Ярославская область;105_165_days;EpiVacCorona;666;264;930;682586;317712;1000298
2022.01_13-10-2022;Ярославская область;105_165_days;SputnikLite;35901;18016;53917;682586;317712;1000298
2022.01_13-10-2022;Ярославская область;105_165_days;SputnikV;25536;12270;37806;682586;317712;1000298
2022.01_13-10-2022;Ярославская область;165_195_days;AllVaccines;86091;16795;102886;682586;317712;1000298
2022.01_13-10-2022;Ярославская область;165_195_days;CoviVac;801;95;896;682586;317712;1000298
2022.01_13-10-2022;Ярославская область;165_195_days;EpiVacCorona;3023;698;3721;682586;317712;1000298
2022.01_13-10-2022;Ярославская область;165_195_days;SputnikLite;28386;3822;32208;682586;317712;1000298
2022.01_13-10-2022;Ярославская область;165_195_days;SputnikV;53881;12180;66061;682586;317712;1000298
2022.01_13-10-2022;Ярославская область;21_45_days;AllVaccines;20953;12251;33204;682586;317712;1000298
2022.01_13-10-2022;Ярославская область;21_45_days;CoviVac;327;94;421;682586;317712;1000298
2022.01_13-10-2022;Ярославская область;21_45_days;EpiVacCorona;402;198;600;682586;317712;1000298
2022.01_13-10-2022;Ярославская область;21_45_days;SputnikLite;13248;8438;21686;682586;317712;1000298
2022.01_13-10-2022;Ярославская область;21_45_days;SputnikV;6976;3521;10497;682586;317712;1000298
2022.01_13-10-2022;Ярославская область;45_75_days;AllVaccines;45590;24973;70563;682586;317712;1000298
2022.01_13-10-2022;Ярославская область;45_75_days;CoviVac;873;176;1049;682586;317712;1000298
2022.01_13-10-2022;Ярославская область;45_75_days;EpiVacCorona;1203;595;1798;682586;317712;1000298
2022.01_13-10-2022;Ярославская область;45_75_days;SputnikLite;16784;11289;28073;682586;317712;1000298
2022.01_13-10-2022;Ярославская область;45_75_days;SputnikV;26730;12913;39643;682586;317712;1000298
2022.01_13-10-2022;Ярославская область;75_90_days;AllVaccines;29125;15479;44604;682586;317712;1000298
2022.01_13-10-2022;Ярославская область;75_90_days;CoviVac;380;34;414;682586;317712;1000298
2022.01_13-10-2022;Ярославская область;75_90_days;EpiVacCorona;377;145;522;682586;317712;1000298
2022.01_13-10-2022;Ярославская область;75_90_days;SputnikLite;14938;8498;23436;682586;317712;1000298
2022.01_13-10-2022;Ярославская область;75_90_days;SputnikV;13430;6802;20232;682586;317712;1000298
2022.01_13-10-2022;Ярославская область;90_105_days;AllVaccines;24557;14561;39118;682586;317712;1000298
2022.01_13-10-2022;Ярославская область;90_105_days;CoviVac;167;11;178;682586;317712;1000298
2022.01_13-10-2022;Ярославская область;90_105_days;EpiVacCorona;212;110;322;682586;317712;1000298
2022.01_13-10-2022;Ярославская область;90_105_days;SputnikLite;15505;8407;23912;682586;317712;1000298
2022.01_13-10-2022;Ярославская область;90_105_days;SputnikV;8673;6033;14706;682586;317712;1000298
2022.01_13-10-2022;г. Москва;105_165_days;AllVaccines;441628;313384;755012;7299088;3167729;10466817
2022.01_13-10-2022;г. Москва;105_165_days;CoviVac;12660;1992;14652;7299088;3167729;10466817
2022.01_13-10-2022;г. Москва;105_165_days;EpiVacCorona;2710;1888;4598;7299088;3167729;10466817
2022.01_13-10-2022;г. Москва;105_165_days;SputnikLite;178779;178519;357298;7299088;3167729;10466817
2022.01_13-10-2022;г. Москва;105_165_days;SputnikV;247479;130985;378464;7299088;3167729;10466817
2022.01_13-10-2022;г. Москва;165_195_days;AllVaccines;668116;141589;809705;7299088;3167729;10466817
2022.01_13-10-2022;г. Москва;165_195_days;CoviVac;18143;1656;19799;7299088;3167729;10466817
2022.01_13-10-2022;г. Москва;165_195_days;EpiVacCorona;3169;903;4072;7299088;3167729;10466817
2022.01_13-10-2022;г. Москва;165_195_days;SputnikLite;63934;14944;78878;7299088;3167729;10466817
2022.01_13-10-2022;г. Москва;165_195_days;SputnikV;582870;124086;706956;7299088;3167729;10466817
2022.01_13-10-2022;г. Москва;21_45_days;AllVaccines;219647;92431;312078;7299088;3167729;10466817
2022.01_13-10-2022;г. Москва;21_45_days;CoviVac;2582;337;2919;7299088;3167729;10466817
2022.01_13-10-2022;г. Москва;21_45_days;EpiVacCorona;149;76;225;7299088;3167729;10466817
2022.01_13-10-2022;г. Москва;21_45_days;SputnikLite;155268;65727;220995;7299088;3167729;10466817
2022.01_13-10-2022;г. Москва;21_45_days;SputnikV;61648;26291;87939;7299088;3167729;10466817
2022.01_13-10-2022;г. Москва;45_75_days;AllVaccines;347076;201652;548728;7299088;3167729;10466817
2022.01_13-10-2022;г. Москва;45_75_days;CoviVac;17315;1807;19122;7299088;3167729;10466817
2022.01_13-10-2022;г. Москва;45_75_days;EpiVacCorona;1100;676;1776;7299088;3167729;10466817
2022.01_13-10-2022;г. Москва;45_75_days;SputnikLite;98886;82418;181304;7299088;3167729;10466817
2022.01_13-10-2022;г. Москва;45_75_days;SputnikV;229775;116751;346526;7299088;3167729;10466817
2022.01_13-10-2022;г. Москва;75_90_days;AllVaccines;226777;150002;376779;7299088;3167729;10466817
2022.01_13-10-2022;г. Москва;75_90_days;CoviVac;8968;1473;10441;7299088;3167729;10466817
2022.01_13-10-2022;г. Москва;75_90_days;EpiVacCorona;566;409;975;7299088;3167729;10466817
2022.01_13-10-2022;г. Москва;75_90_days;SputnikLite;73062;55549;128611;7299088;3167729;10466817
2022.01_13-10-2022;г. Москва;75_90_days;SputnikV;144181;92571;236752;7299088;3167729;10466817
2022.01_13-10-2022;г. Москва;90_105_days;AllVaccines;178652;142328;320980;7299088;3167729;10466817
2022.01_13-10-2022;г. Москва;90_105_days;CoviVac;5921;1475;7396;7299088;3167729;10466817
2022.01_13-10-2022;г. Москва;90_105_days;EpiVacCorona;797;592;1389;7299088;3167729;10466817
2022.01_13-10-2022;г. Москва;90_105_days;SputnikLite;77126;63595;140721;7299088;3167729;10466817
2022.01_13-10-2022;г. Москва;90_105_days;SputnikV;94808;76666;171474;7299088;3167729;10466817
2022.01_13-10-2022;г. Санкт-Петербург;105_165_days;AllVaccines;377526;137421;514947;3114778;1306302;4421080
2022.01_13-10-2022;г. Санкт-Петербург;105_165_days;CoviVac;12069;691;12760;3114778;1306302;4421080
2022.01_13-10-2022;г. Санкт-Петербург;105_165_days;EpiVacCorona;721;363;1084;3114778;1306302;4421080
2022.01_13-10-2022;г. Санкт-Петербург;105_165_days;SputnikLite;219670;76017;295687;3114778;1306302;4421080
2022.01_13-10-2022;г. Санкт-Петербург;105_165_days;SputnikV;145066;60350;205416;3114778;1306302;4421080
2022.01_13-10-2022;г. Санкт-Петербург;165_195_days;AllVaccines;369203;67711;436914;3114778;1306302;4421080
2022.01_13-10-2022;г. Санкт-Петербург;165_195_days;CoviVac;4996;218;5214;3114778;1306302;4421080
2022.01_13-10-2022;г. Санкт-Петербург;165_195_days;EpiVacCorona;1173;477;1650;3114778;1306302;4421080
2022.01_13-10-2022;г. Санкт-Петербург;165_195_days;SputnikLite;129553;11417;140970;3114778;1306302;4421080
2022.01_13-10-2022;г. Санкт-Петербург;165_195_days;SputnikV;233481;55599;289080;3114778;1306302;4421080
2022.01_13-10-2022;г. Санкт-Петербург;21_45_days;AllVaccines;139839;56268;196107;3114778;1306302;4421080
2022.01_13-10-2022;г. Санкт-Петербург;21_45_days;CoviVac;634;61;695;3114778;1306302;4421080
2022.01_13-10-2022;г. Санкт-Петербург;21_45_days;EpiVacCorona;1204;537;1741;3114778;1306302;4421080
2022.01_13-10-2022;г. Санкт-Петербург;21_45_days;SputnikLite;72065;34124;106189;3114778;1306302;4421080
2022.01_13-10-2022;г. Санкт-Петербург;21_45_days;SputnikV;65936;21546;87482;3114778;1306302;4421080
2022.01_13-10-2022;г. Санкт-Петербург;45_75_days;AllVaccines;371925;133804;505729;3114778;1306302;4421080
2022.01_13-10-2022;г. Санкт-Петербург;45_75_days;CoviVac;2495;194;2689;3114778;1306302;4421080
2022.01_13-10-2022;г. Санкт-Петербург;45_75_days;EpiVacCorona;4420;1985;6405;3114778;1306302;4421080
2022.01_13-10-2022;г. Санкт-Петербург;45_75_days;SputnikLite;112564;58504;171068;3114778;1306302;4421080
2022.01_13-10-2022;г. Санкт-Петербург;45_75_days;SputnikV;252446;73121;325567;3114778;1306302;4421080
2022.01_13-10-2022;г. Санкт-Петербург;75_90_days;AllVaccines;205180;73078;278258;3114778;1306302;4421080
2022.01_13-10-2022;г. Санкт-Петербург;75_90_days;CoviVac;1159;106;1265;3114778;1306302;4421080
2022.01_13-10-2022;г. Санкт-Петербург;75_90_days;EpiVacCorona;1934;821;2755;3114778;1306302;4421080
2022.01_13-10-2022;г. Санкт-Петербург;75_90_days;SputnikLite;69083;31660;100743;3114778;1306302;4421080
2022.01_13-10-2022;г. Санкт-Петербург;75_90_days;SputnikV;133004;40491;173495;3114778;1306302;4421080
2022.01_13-10-2022;г. Санкт-Петербург;90_105_days;AllVaccines;138179;57181;195360;3114778;1306302;4421080
2022.01_13-10-2022;г. Санкт-Петербург;90_105_days;CoviVac;2374;172;2546;3114778;1306302;4421080
2022.01_13-10-2022;г. Санкт-Петербург;90_105_days;EpiVacCorona;1137;562;1699;3114778;1306302;4421080
2022.01_13-10-2022;г. Санкт-Петербург;90_105_days;SputnikLite;68351;29173;97524;3114778;1306302;4421080
2022.01_13-10-2022;г. Санкт-Петербург;90_105_days;SputnikV;66317;27274;93591;3114778;1306302;4421080
2022.01_13-10-2022;г. Севастополь;105_165_days;AllVaccines;26685;11530;38215;293051;116400;409451
2022.01_13-10-2022;г. Севастополь;105_165_days;CoviVac;121;28;149;293051;116400;409451
2022.01_13-10-2022;г. Севастополь;105_165_days;EpiVacCorona;376;181;557;293051;116400;409451
2022.01_13-10-2022;г. Севастополь;105_165_days;SputnikLite;13445;8166;21611;293051;116400;409451
2022.01_13-10-2022;г. Севастополь;105_165_days;SputnikV;12743;3155;15898;293051;116400;409451
2022.01_13-10-2022;г. Севастополь;165_195_days;AllVaccines;14157;3986;18143;293051;116400;409451
2022.01_13-10-2022;г. Севастополь;165_195_days;CoviVac;203;56;259;293051;116400;409451
2022.01_13-10-2022;г. Севастополь;165_195_days;EpiVacCorona;337;200;537;293051;116400;409451
2022.01_13-10-2022;г. Севастополь;165_195_days;SputnikLite;614;407;1021;293051;116400;409451
2022.01_13-10-2022;г. Севастополь;165_195_days;SputnikV;13003;3323;16326;293051;116400;409451
2022.01_13-10-2022;г. Севастополь;21_45_days;AllVaccines;10824;5818;16642;293051;116400;409451
2022.01_13-10-2022;г. Севастополь;21_45_days;CoviVac;71;35;106;293051;116400;409451
2022.01_13-10-2022;г. Севастополь;21_45_days;EpiVacCorona;102;72;174;293051;116400;409451
2022.01_13-10-2022;г. Севастополь;21_45_days;SputnikLite;7042;4849;11891;293051;116400;409451
2022.01_13-10-2022;г. Севастополь;21_45_days;SputnikV;3609;862;4471;293051;116400;409451
2022.01_13-10-2022;г. Севастополь;45_75_days;AllVaccines;23517;10088;33605;293051;116400;409451
2022.01_13-10-2022;г. Севастополь;45_75_days;CoviVac;135;50;185;293051;116400;409451
2022.01_13-10-2022;г. Севастополь;45_75_days;EpiVacCorona;325;170;495;293051;116400;409451
2022.01_13-10-2022;г. Севастополь;45_75_days;SputnikLite;6166;5471;11637;293051;116400;409451
2022.01_13-10-2022;г. Севастополь;45_75_days;SputnikV;16891;4397;21288;293051;116400;409451
2022.01_13-10-2022;г. Севастополь;75_90_days;AllVaccines;25334;10844;36178;293051;116400;409451
2022.01_13-10-2022;г. Севастополь;75_90_days;CoviVac;161;41;202;293051;116400;409451
2022.01_13-10-2022;г. Севастополь;75_90_days;EpiVacCorona;328;124;452;293051;116400;409451
2022.01_13-10-2022;г. Севастополь;75_90_days;SputnikLite;6529;6505;13034;293051;116400;409451
2022.01_13-10-2022;г. Севастополь;75_90_days;SputnikV;18316;4174;22490;293051;116400;409451
2022.01_13-10-2022;г. Севастополь;90_105_days;AllVaccines;19279;4961;24240;293051;116400;409451
2022.01_13-10-2022;г. Севастополь;90_105_days;CoviVac;340;92;432;293051;116400;409451
2022.01_13-10-2022;г. Севастополь;90_105_days;EpiVacCorona;627;188;815;293051;116400;409451
2022.01_13-10-2022;г. Севастополь;90_105_days;SputnikLite;3058;2126;5184;293051;116400;409451
2022.01_13-10-2022;г. Севастополь;90_105_days;SputnikV;15254;2555;17809;293051;116400;409451
2022.02_01-07-2022;Алтайский край;105_165_days;AllVaccines;108334;52838;161172;1240936;570412;1811348
2022.02_01-07-2022;Алтайский край;105_165_days;CoviVac;1015;156;1171;1240936;570412;1811348
2022.02_01-07-2022;Алтайский край;105_165_days;EpiVacCorona;1533;479;2012;1240936;570412;1811348
2022.02_01-07-2022;Алтайский край;105_165_days;SputnikLite;51880;32217;84097;1240936;570412;1811348
2022.02_01-07-2022;Алтайский край;105_165_days;SputnikV;53906;19986;73892;1240936;570412;1811348
2022.02_01-07-2022;Алтайский край;165_195_days;AllVaccines;136654;26399;163053;1240936;570412;1811348
2022.02_01-07-2022;Алтайский край;165_195_days;CoviVac;1836;146;1982;1240936;570412;1811348
2022.02_01-07-2022;Алтайский край;165_195_days;EpiVacCorona;3079;646;3725;1240936;570412;1811348
2022.02_01-07-2022;Алтайский край;165_195_days;SputnikLite;38561;4138;42699;1240936;570412;1811348
2022.02_01-07-2022;Алтайский край;165_195_days;SputnikV;93178;21469;114647;1240936;570412;1811348
2022.02_01-07-2022;Алтайский край;21_45_days;AllVaccines;43745;25365;69110;1240936;570412;1811348
2022.02_01-07-2022;Алтайский край;21_45_days;CoviVac;283;112;395;1240936;570412;1811348
2022.02_01-07-2022;Алтайский край;21_45_days;EpiVacCorona;1564;857;2421;1240936;570412;1811348
2022.02_01-07-2022;Алтайский край;21_45_days;SputnikLite;28501;16247;44748;1240936;570412;1811348
2022.02_01-07-2022;Алтайский край;21_45_days;SputnikV;13397;8149;21546;1240936;570412;1811348
2022.02_01-07-2022;Алтайский край;45_75_days;AllVaccines;101035;62651;163686;1240936;570412;1811348
2022.02_01-07-2022;Алтайский край;45_75_days;CoviVac;1325;240;1565;1240936;570412;1811348
2022.02_01-07-2022;Алтайский край;45_75_days;EpiVacCorona;4946;2055;7001;1240936;570412;1811348
2022.02_01-07-2022;Алтайский край;45_75_days;SputnikLite;26885;22684;49569;1240936;570412;1811348
2022.02_01-07-2022;Алтайский край;45_75_days;SputnikV;67879;37672;105551;1240936;570412;1811348
2022.02_01-07-2022;Алтайский край;75_90_days;AllVaccines;58560;33323;91883;1240936;570412;1811348
2022.02_01-07-2022;Алтайский край;75_90_days;CoviVac;1209;239;1448;1240936;570412;1811348
2022.02_01-07-2022;Алтайский край;75_90_days;EpiVacCorona;5316;2266;7582;1240936;570412;1811348
2022.02_01-07-2022;Алтайский край;75_90_days;SputnikLite;15120;12319;27439;1240936;570412;1811348
2022.02_01-07-2022;Алтайский край;75_90_days;SputnikV;36915;18499;55414;1240936;570412;1811348
2022.02_01-07-2022;Алтайский край;90_105_days;AllVaccines;36474;23558;60032;1240936;570412;1811348
2022.02_01-07-2022;Алтайский край;90_105_days;CoviVac;852;212;1064;1240936;570412;1811348
2022.02_01-07-2022;Алтайский край;90_105_days;EpiVacCorona;2608;1851;4459;1240936;570412;1811348
2022.02_01-07-2022;Алтайский край;90_105_days;SputnikLite;18453;10336;28789;1240936;570412;1811348
2022.02_01-07-2022;Алтайский край;90_105_days;SputnikV;14561;11159;25720;1240936;570412;1811348
2022.02_01-07-2022;Амурская область;105_165_days;AllVaccines;45207;17217;62424;444961;159780;604741
2022.02_01-07-2022;Амурская область;105_165_days;CoviVac;615;199;814;444961;159780;604741
2022.02_01-07-2022;Амурская область;105_165_days;EpiVacCorona;345;156;501;444961;159780;604741
2022.02_01-07-2022;Амурская область;105_165_days;SputnikLite;21852;11536;33388;444961;159780;604741
2022.02_01-07-2022;Амурская область;105_165_days;SputnikV;22395;5326;27721;444961;159780;604741
2022.02_01-07-2022;Амурская область;165_195_days;AllVaccines;62320;8157;70477;444961;159780;604741
2022.02_01-07-2022;Амурская область;165_195_days;CoviVac;22;2;24;444961;159780;604741
2022.02_01-07-2022;Амурская область;165_195_days;EpiVacCorona;934;211;1145;444961;159780;604741
2022.02_01-07-2022;Амурская область;165_195_days;SputnikLite;20205;2367;22572;444961;159780;604741
2022.02_01-07-2022;Амурская область;165_195_days;SputnikV;41159;5577;46736;444961;159780;604741
2022.02_01-07-2022;Амурская область;21_45_days;AllVaccines;18475;6089;24564;444961;159780;604741
2022.02_01-07-2022;Амурская область;21_45_days;CoviVac;149;31;180;444961;159780;604741
2022.02_01-07-2022;Амурская область;21_45_days;EpiVacCorona;1126;355;1481;444961;159780;604741
2022.02_01-07-2022;Амурская область;21_45_days;SputnikLite;10237;4107;14344;444961;159780;604741
2022.02_01-07-2022;Амурская область;21_45_days;SputnikV;6963;1596;8559;444961;159780;604741
2022.02_01-07-2022;Амурская область;45_75_days;AllVaccines;43950;14631;58581;444961;159780;604741
2022.02_01-07-2022;Амурская область;45_75_days;CoviVac;384;117;501;444961;159780;604741
2022.02_01-07-2022;Амурская область;45_75_days;EpiVacCorona;3419;1235;4654;444961;159780;604741
2022.02_01-07-2022;Амурская область;45_75_days;SputnikLite;9637;5208;14845;444961;159780;604741
2022.02_01-07-2022;Амурская область;45_75_days;SputnikV;30510;8071;38581;444961;159780;604741
2022.02_01-07-2022;Амурская область;75_90_days;AllVaccines;25372;9477;34849;444961;159780;604741
2022.02_01-07-2022;Амурская область;75_90_days;CoviVac;481;139;620;444961;159780;604741
2022.02_01-07-2022;Амурская область;75_90_days;EpiVacCorona;1720;553;2273;444961;159780;604741
2022.02_01-07-2022;Амурская область;75_90_days;SputnikLite;5671;3744;9415;444961;159780;604741
2022.02_01-07-2022;Амурская область;75_90_days;SputnikV;17500;5041;22541;444961;159780;604741
2022.02_01-07-2022;Амурская область;90_105_days;AllVaccines;21749;9435;31184;444961;159780;604741
2022.02_01-07-2022;Амурская область;90_105_days;CoviVac;735;199;934;444961;159780;604741
2022.02_01-07-2022;Амурская область;90_105_days;EpiVacCorona;1742;923;2665;444961;159780;604741
2022.02_01-07-2022;Амурская область;90_105_days;SputnikLite;11208;5252;16460;444961;159780;604741
2022.02_01-07-2022;Амурская область;90_105_days;SputnikV;8064;3061;11125;444961;159780;604741
2022.02_01-07-2022;Архангельская область;105_165_days;AllVaccines;68890;29766;98656;595439;264499;859938
2022.02_01-07-2022;Архангельская область;105_165_days;CoviVac;380;83;463;595439;264499;859938
2022.02_01-07-2022;Архангельская область;105_165_days;EpiVacCorona;831;330;1161;595439;264499;859938
2022.02_01-07-2022;Архангельская область;105_165_days;SputnikLite;42981;19590;62571;595439;264499;859938
2022.02_01-07-2022;Архангельская область;105_165_days;SputnikV;24698;9763;34461;595439;264499;859938
2022.02_01-07-2022;Архангельская область;165_195_days;AllVaccines;77508;17546;95054;595439;264499;859938
2022.02_01-07-2022;Архангельская область;165_195_days;CoviVac;453;45;498;595439;264499;859938
2022.02_01-07-2022;Архангельская область;165_195_days;EpiVacCorona;2006;534;2540;595439;264499;859938
2022.02_01-07-2022;Архангельская область;165_195_days;SputnikLite;15644;2378;18022;595439;264499;859938
2022.02_01-07-2022;Архангельская область;165_195_days;SputnikV;59405;14589;73994;595439;264499;859938
2022.02_01-07-2022;Архангельская область;21_45_days;AllVaccines;15232;10106;25338;595439;264499;859938
2022.02_01-07-2022;Архангельская область;21_45_days;CoviVac;137;16;153;595439;264499;859938
2022.02_01-07-2022;Архангельская область;21_45_days;EpiVacCorona;447;230;677;595439;264499;859938
2022.02_01-07-2022;Архангельская область;21_45_days;SputnikLite;9098;7263;16361;595439;264499;859938
2022.02_01-07-2022;Архангельская область;21_45_days;SputnikV;5550;2597;8147;595439;264499;859938
2022.02_01-07-2022;Архангельская область;45_75_days;AllVaccines;46123;32013;78136;595439;264499;859938
2022.02_01-07-2022;Архангельская область;45_75_days;CoviVac;767;94;861;595439;264499;859938
2022.02_01-07-2022;Архангельская область;45_75_days;EpiVacCorona;2587;1374;3961;595439;264499;859938
2022.02_01-07-2022;Архангельская область;45_75_days;SputnikLite;13968;12782;26750;595439;264499;859938
2022.02_01-07-2022;Архангельская область;45_75_days;SputnikV;28801;17763;46564;595439;264499;859938
2022.02_01-07-2022;Архангельская область;75_90_days;AllVaccines;30592;16556;47148;595439;264499;859938
2022.02_01-07-2022;Архангельская область;75_90_days;CoviVac;440;79;519;595439;264499;859938
2022.02_01-07-2022;Архангельская область;75_90_days;EpiVacCorona;2363;942;3305;595439;264499;859938
2022.02_01-07-2022;Архангельская область;75_90_days;SputnikLite;7966;6985;14951;595439;264499;859938
2022.02_01-07-2022;Архангельская область;75_90_days;SputnikV;19823;8550;28373;595439;264499;859938
2022.02_01-07-2022;Архангельская область;90_105_days;AllVaccines;23209;11304;34513;595439;264499;859938
2022.02_01-07-2022;Архангельская область;90_105_days;CoviVac;597;122;719;595439;264499;859938
2022.02_01-07-2022;Архангельская область;90_105_days;EpiVacCorona;1262;496;1758;595439;264499;859938
2022.02_01-07-2022;Архангельская область;90_105_days;SputnikLite;10698;5318;16016;595439;264499;859938
2022.02_01-07-2022;Архангельская область;90_105_days;SputnikV;10652;5368;16020;595439;264499;859938
2022.02_01-07-2022;Астраханская область;105_165_days;AllVaccines;52853;18789;71642;550968;219749;770717
2022.02_01-07-2022;Астраханская область;105_165_days;CoviVac;398;164;562;550968;219749;770717
2022.02_01-07-2022;Астраханская область;105_165_days;EpiVacCorona;833;428;1261;550968;219749;770717
2022.02_01-07-2022;Астраханская область;105_165_days;SputnikLite;25870;11049;36919;550968;219749;770717
2022.02_01-07-2022;Астраханская область;105_165_days;SputnikV;25752;7148;32900;550968;219749;770717
2022.02_01-07-2022;Астраханская область;165_195_days;AllVaccines;59064;9297;68361;550968;219749;770717
2022.02_01-07-2022;Астраханская область;165_195_days;CoviVac;200;48;248;550968;219749;770717
2022.02_01-07-2022;Астраханская область;165_195_days;EpiVacCorona;680;204;884;550968;219749;770717
2022.02_01-07-2022;Астраханская область;165_195_days;SputnikLite;7276;1092;8368;550968;219749;770717
2022.02_01-07-2022;Астраханская область;165_195_days;SputnikV;50908;7953;58861;550968;219749;770717
2022.02_01-07-2022;Астраханская область;21_45_days;AllVaccines;17511;6610;24121;550968;219749;770717
2022.02_01-07-2022;Астраханская область;21_45_days;CoviVac;183;57;240;550968;219749;770717
2022.02_01-07-2022;Астраханская область;21_45_days;EpiVacCorona;314;90;404;550968;219749;770717
2022.02_01-07-2022;Астраханская область;21_45_days;SputnikLite;10402;4410;14812;550968;219749;770717
2022.02_01-07-2022;Астраханская область;21_45_days;SputnikV;6612;2053;8665;550968;219749;770717
2022.02_01-07-2022;Астраханская область;45_75_days;AllVaccines;43476;15436;58912;550968;219749;770717
2022.02_01-07-2022;Астраханская область;45_75_days;CoviVac;697;228;925;550968;219749;770717
2022.02_01-07-2022;Астраханская область;45_75_days;EpiVacCorona;2646;939;3585;550968;219749;770717
2022.02_01-07-2022;Астраханская область;45_75_days;SputnikLite;12642;5873;18515;550968;219749;770717
2022.02_01-07-2022;Астраханская область;45_75_days;SputnikV;27491;8396;35887;550968;219749;770717
2022.02_01-07-2022;Астраханская область;75_90_days;AllVaccines;24665;9595;34260;550968;219749;770717
2022.02_01-07-2022;Астраханская область;75_90_days;CoviVac;319;142;461;550968;219749;770717
2022.02_01-07-2022;Астраханская область;75_90_days;EpiVacCorona;1251;428;1679;550968;219749;770717
2022.02_01-07-2022;Астраханская область;75_90_days;SputnikLite;7412;4169;11581;550968;219749;770717
2022.02_01-07-2022;Астраханская область;75_90_days;SputnikV;15683;4856;20539;550968;219749;770717
2022.02_01-07-2022;Астраханская область;90_105_days;AllVaccines;23066;8431;31497;550968;219749;770717
2022.02_01-07-2022;Астраханская область;90_105_days;CoviVac;244;105;349;550968;219749;770717
2022.02_01-07-2022;Астраханская область;90_105_days;EpiVacCorona;993;373;1366;550968;219749;770717
2022.02_01-07-2022;Астраханская область;90_105_days;SputnikLite;9564;4382;13946;550968;219749;770717
2022.02_01-07-2022;Астраханская область;90_105_days;SputnikV;12265;3571;15836;550968;219749;770717
2022.02_01-07-2022;Белгородская область;105_165_days;AllVaccines;90709;55819;146528;867731;383871;1251602
2022.02_01-07-2022;Белгородская область;105_165_days;CoviVac;1142;378;1520;867731;383871;1251602
2022.02_01-07-2022;Белгородская область;105_165_days;EpiVacCorona;652;350;1002;867731;383871;1251602
2022.02_01-07-2022;Белгородская область;105_165_days;SputnikLite;50774;37775;88549;867731;383871;1251602
2022.02_01-07-2022;Белгородская область;105_165_days;SputnikV;38141;17316;55457;867731;383871;1251602
2022.02_01-07-2022;Белгородская область;165_195_days;AllVaccines;102778;23812;126590;867731;383871;1251602
2022.02_01-07-2022;Белгородская область;165_195_days;CoviVac;1804;338;2142;867731;383871;1251602
2022.02_01-07-2022;Белгородская область;165_195_days;EpiVacCorona;2575;1034;3609;867731;383871;1251602
2022.02_01-07-2022;Белгородская область;165_195_days;SputnikLite;13551;3356;16907;867731;383871;1251602
2022.02_01-07-2022;Белгородская область;165_195_days;SputnikV;84848;19084;103932;867731;383871;1251602
2022.02_01-07-2022;Белгородская область;21_45_days;AllVaccines;42710;18367;61077;867731;383871;1251602
2022.02_01-07-2022;Белгородская область;21_45_days;CoviVac;191;76;267;867731;383871;1251602
2022.02_01-07-2022;Белгородская область;21_45_days;EpiVacCorona;346;195;541;867731;383871;1251602
2022.02_01-07-2022;Белгородская область;21_45_days;SputnikLite;32492;14681;47173;867731;383871;1251602
2022.02_01-07-2022;Белгородская область;21_45_days;SputnikV;9681;3415;13096;867731;383871;1251602
2022.02_01-07-2022;Белгородская область;45_75_days;AllVaccines;95874;40417;136291;867731;383871;1251602
2022.02_01-07-2022;Белгородская область;45_75_days;CoviVac;592;209;801;867731;383871;1251602
2022.02_01-07-2022;Белгородская область;45_75_days;EpiVacCorona;862;388;1250;867731;383871;1251602
2022.02_01-07-2022;Белгородская область;45_75_days;SputnikLite;36535;20458;56993;867731;383871;1251602
2022.02_01-07-2022;Белгородская область;45_75_days;SputnikV;57885;19362;77247;867731;383871;1251602
2022.02_01-07-2022;Белгородская область;75_90_days;AllVaccines;57033;29275;86308;867731;383871;1251602
2022.02_01-07-2022;Белгородская область;75_90_days;CoviVac;382;123;505;867731;383871;1251602
2022.02_01-07-2022;Белгородская область;75_90_days;EpiVacCorona;660;284;944;867731;383871;1251602
2022.02_01-07-2022;Белгородская область;75_90_days;SputnikLite;24997;16156;41153;867731;383871;1251602
2022.02_01-07-2022;Белгородская область;75_90_days;SputnikV;30994;12712;43706;867731;383871;1251602
2022.02_01-07-2022;Белгородская область;90_105_days;AllVaccines;40045;20716;60761;867731;383871;1251602
2022.02_01-07-2022;Белгородская область;90_105_days;CoviVac;600;246;846;867731;383871;1251602
2022.02_01-07-2022;Белгородская область;90_105_days;EpiVacCorona;787;394;1181;867731;383871;1251602
2022.02_01-07-2022;Белгородская область;90_105_days;SputnikLite;19627;11685;31312;867731;383871;1251602
2022.02_01-07-2022;Белгородская область;90_105_days;SputnikV;19031;8391;27422;867731;383871;1251602
2022.02_01-07-2022;Брянская область;105_165_days;AllVaccines;69638;28980;98618;659625;298625;958250
2022.02_01-07-2022;Брянская область;105_165_days;CoviVac;574;155;729;659625;298625;958250
2022.02_01-07-2022;Брянская область;105_165_days;EpiVacCorona;407;206;613;659625;298625;958250
2022.02_01-07-2022;Брянская область;105_165_days;SputnikLite;35840;19244;55084;659625;298625;958250
2022.02_01-07-2022;Брянская область;105_165_days;SputnikV;32817;9375;42192;659625;298625;958250
2022.02_01-07-2022;Брянская область;165_195_days;AllVaccines;58825;13759;72584;659625;298625;958250
2022.02_01-07-2022;Брянская область;165_195_days;CoviVac;252;55;307;659625;298625;958250
2022.02_01-07-2022;Брянская область;165_195_days;EpiVacCorona;894;288;1182;659625;298625;958250
2022.02_01-07-2022;Брянская область;165_195_days;SputnikLite;7465;1574;9039;659625;298625;958250
2022.02_01-07-2022;Брянская область;165_195_days;SputnikV;50214;11842;62056;659625;298625;958250
2022.02_01-07-2022;Брянская область;21_45_days;AllVaccines;21799;12939;34738;659625;298625;958250
2022.02_01-07-2022;Брянская область;21_45_days;CoviVac;236;71;307;659625;298625;958250
2022.02_01-07-2022;Брянская область;21_45_days;EpiVacCorona;628;325;953;659625;298625;958250
2022.02_01-07-2022;Брянская область;21_45_days;SputnikLite;15593;9716;25309;659625;298625;958250
2022.02_01-07-2022;Брянская область;21_45_days;SputnikV;5342;2827;8169;659625;298625;958250
2022.02_01-07-2022;Брянская область;45_75_days;AllVaccines;48388;29137;77525;659625;298625;958250
2022.02_01-07-2022;Брянская область;45_75_days;CoviVac;1071;285;1356;659625;298625;958250
2022.02_01-07-2022;Брянская область;45_75_days;EpiVacCorona;3894;1970;5864;659625;298625;958250
2022.02_01-07-2022;Брянская область;45_75_days;SputnikLite;12006;10452;22458;659625;298625;958250
2022.02_01-07-2022;Брянская область;45_75_days;SputnikV;31417;16430;47847;659625;298625;958250
2022.02_01-07-2022;Брянская область;75_90_days;AllVaccines;35352;21825;57177;659625;298625;958250
2022.02_01-07-2022;Брянская область;75_90_days;CoviVac;873;239;1112;659625;298625;958250
2022.02_01-07-2022;Брянская область;75_90_days;EpiVacCorona;2854;1208;4062;659625;298625;958250
2022.02_01-07-2022;Брянская область;75_90_days;SputnikLite;11361;9579;20940;659625;298625;958250
2022.02_01-07-2022;Брянская область;75_90_days;SputnikV;20264;10799;31063;659625;298625;958250
2022.02_01-07-2022;Брянская область;90_105_days;AllVaccines;16898;10746;27644;659625;298625;958250
2022.02_01-07-2022;Брянская область;90_105_days;CoviVac;474;148;622;659625;298625;958250
2022.02_01-07-2022;Брянская область;90_105_days;EpiVacCorona;1530;705;2235;659625;298625;958250
2022.02_01-07-2022;Брянская область;90_105_days;SputnikLite;4283;2829;7112;659625;298625;958250
2022.02_01-07-2022;Брянская область;90_105_days;SputnikV;10611;7064;17675;659625;298625;958250
2022.02_01-07-2022;Владимирская область;105_165_days;AllVaccines;66273;34702;100975;739166;354521;1093687
2022.02_01-07-2022;Владимирская область;105_165_days;CoviVac;667;142;809;739166;354521;1093687
2022.02_01-07-2022;Владимирская область;105_165_days;EpiVacCorona;771;335;1106;739166;354521;1093687
2022.02_01-07-2022;Владимирская область;105_165_days;SputnikLite;35759;22506;58265;739166;354521;1093687
2022.02_01-07-2022;Владимирская область;105_165_days;SputnikV;29076;11719;40795;739166;354521;1093687
2022.02_01-07-2022;Владимирская область;165_195_days;AllVaccines;70788;17085;87873;739166;354521;1093687
2022.02_01-07-2022;Владимирская область;165_195_days;CoviVac;603;110;713;739166;354521;1093687
2022.02_01-07-2022;Владимирская область;165_195_days;EpiVacCorona;1474;474;1948;739166;354521;1093687
2022.02_01-07-2022;Владимирская область;165_195_days;SputnikLite;24172;5364;29536;739166;354521;1093687
2022.02_01-07-2022;Владимирская область;165_195_days;SputnikV;44539;11137;55676;739166;354521;1093687
2022.02_01-07-2022;Владимирская область;21_45_days;AllVaccines;16116;10571;26687;739166;354521;1093687
2022.02_01-07-2022;Владимирская область;21_45_days;CoviVac;93;27;120;739166;354521;1093687
2022.02_01-07-2022;Владимирская область;21_45_days;EpiVacCorona;802;583;1385;739166;354521;1093687
2022.02_01-07-2022;Владимирская область;21_45_days;SputnikLite;9806;7583;17389;739166;354521;1093687
2022.02_01-07-2022;Владимирская область;21_45_days;SputnikV;5415;2378;7793;739166;354521;1093687
2022.02_01-07-2022;Владимирская область;45_75_days;AllVaccines;59213;29745;88958;739166;354521;1093687
2022.02_01-07-2022;Владимирская область;45_75_days;CoviVac;737;201;938;739166;354521;1093687
2022.02_01-07-2022;Владимирская область;45_75_days;EpiVacCorona;3988;2355;6343;739166;354521;1093687
2022.02_01-07-2022;Владимирская область;45_75_days;SputnikLite;15149;11084;26233;739166;354521;1093687
2022.02_01-07-2022;Владимирская область;45_75_days;SputnikV;39339;16105;55444;739166;354521;1093687
2022.02_01-07-2022;Владимирская область;75_90_days;AllVaccines;41254;20755;62009;739166;354521;1093687
2022.02_01-07-2022;Владимирская область;75_90_days;CoviVac;1071;229;1300;739166;354521;1093687
2022.02_01-07-2022;Владимирская область;75_90_days;EpiVacCorona;2519;1206;3725;739166;354521;1093687
2022.02_01-07-2022;Владимирская область;75_90_days;SputnikLite;13439;9747;23186;739166;354521;1093687
2022.02_01-07-2022;Владимирская область;75_90_days;SputnikV;24225;9573;33798;739166;354521;1093687
2022.02_01-07-2022;Владимирская область;90_105_days;AllVaccines;28491;15338;43829;739166;354521;1093687
2022.02_01-07-2022;Владимирская область;90_105_days;CoviVac;681;172;853;739166;354521;1093687
2022.02_01-07-2022;Владимирская область;90_105_days;EpiVacCorona;1071;554;1625;739166;354521;1093687
2022.02_01-07-2022;Владимирская область;90_105_days;SputnikLite;16699;9084;25783;739166;354521;1093687
2022.02_01-07-2022;Владимирская область;90_105_days;SputnikV;10040;5528;15568;739166;354521;1093687
2022.02_01-07-2022;Волгоградская область;105_165_days;AllVaccines;141160;58724;199884;1387837;615020;2002857
2022.02_01-07-2022;Волгоградская область;105_165_days;CoviVac;1800;413;2213;1387837;615020;2002857
2022.02_01-07-2022;Волгоградская область;105_165_days;EpiVacCorona;2477;958;3435;1387837;615020;2002857
2022.02_01-07-2022;Волгоградская область;105_165_days;SputnikLite;59369;34088;93457;1387837;615020;2002857
2022.02_01-07-2022;Волгоградская область;105_165_days;SputnikV;77514;23265;100779;1387837;615020;2002857
2022.02_01-07-2022;Волгоградская область;165_195_days;AllVaccines;173727;31779;205506;1387837;615020;2002857
2022.02_01-07-2022;Волгоградская область;165_195_days;CoviVac;2508;269;2777;1387837;615020;2002857
2022.02_01-07-2022;Волгоградская область;165_195_days;EpiVacCorona;4210;1005;5215;1387837;615020;2002857
2022.02_01-07-2022;Волгоградская область;165_195_days;SputnikLite;46139;8342;54481;1387837;615020;2002857
2022.02_01-07-2022;Волгоградская область;165_195_days;SputnikV;120870;22163;143033;1387837;615020;2002857
2022.02_01-07-2022;Волгоградская область;21_45_days;AllVaccines;50520;28785;79305;1387837;615020;2002857
2022.02_01-07-2022;Волгоградская область;21_45_days;CoviVac;286;115;401;1387837;615020;2002857
2022.02_01-07-2022;Волгоградская область;21_45_days;EpiVacCorona;1240;2180;3420;1387837;615020;2002857
2022.02_01-07-2022;Волгоградская область;21_45_days;SputnikLite;34452;17744;52196;1387837;615020;2002857
2022.02_01-07-2022;Волгоградская область;21_45_days;SputnikV;14542;8746;23288;1387837;615020;2002857
2022.02_01-07-2022;Волгоградская область;45_75_days;AllVaccines;121472;69916;191388;1387837;615020;2002857
2022.02_01-07-2022;Волгоградская область;45_75_days;CoviVac;830;261;1091;1387837;615020;2002857
2022.02_01-07-2022;Волгоградская область;45_75_days;EpiVacCorona;2832;1502;4334;1387837;615020;2002857
2022.02_01-07-2022;Волгоградская область;45_75_days;SputnikLite;39346;26817;66163;1387837;615020;2002857
2022.02_01-07-2022;Волгоградская область;45_75_days;SputnikV;78464;41336;119800;1387837;615020;2002857
2022.02_01-07-2022;Волгоградская область;75_90_days;AllVaccines;88865;48580;137445;1387837;615020;2002857
2022.02_01-07-2022;Волгоградская область;75_90_days;CoviVac;247;61;308;1387837;615020;2002857
2022.02_01-07-2022;Волгоградская область;75_90_days;EpiVacCorona;2159;850;3009;1387837;615020;2002857
2022.02_01-07-2022;Волгоградская область;75_90_days;SputnikLite;19089;15230;34319;1387837;615020;2002857
2022.02_01-07-2022;Волгоградская область;75_90_days;SputnikV;67370;32439;99809;1387837;615020;2002857
2022.02_01-07-2022;Волгоградская область;90_105_days;AllVaccines;43898;22218;66116;1387837;615020;2002857
2022.02_01-07-2022;Волгоградская область;90_105_days;CoviVac;393;129;522;1387837;615020;2002857
2022.02_01-07-2022;Волгоградская область;90_105_days;EpiVacCorona;1487;721;2208;1387837;615020;2002857
2022.02_01-07-2022;Волгоградская область;90_105_days;SputnikLite;8081;3215;11296;1387837;615020;2002857
2022.02_01-07-2022;Волгоградская область;90_105_days;SputnikV;33937;18153;52090;1387837;615020;2002857
2022.02_01-07-2022;Вологодская область;105_165_days;AllVaccines;72934;29510;102444;628100;275171;903271
2022.02_01-07-2022;Вологодская область;105_165_days;CoviVac;76;9;85;628100;275171;903271
2022.02_01-07-2022;Вологодская область;105_165_days;EpiVacCorona;259;191;450;628100;275171;903271
2022.02_01-07-2022;Вологодская область;105_165_days;SputnikLite;59759;19795;79554;628100;275171;903271
2022.02_01-07-2022;Вологодская область;105_165_days;SputnikV;12840;9515;22355;628100;275171;903271
2022.02_01-07-2022;Вологодская область;165_195_days;AllVaccines;61486;14507;75993;628100;275171;903271
2022.02_01-07-2022;Вологодская область;165_195_days;CoviVac;429;46;475;628100;275171;903271
2022.02_01-07-2022;Вологодская область;165_195_days;EpiVacCorona;557;363;920;628100;275171;903271
2022.02_01-07-2022;Вологодская область;165_195_days;SputnikLite;26024;2737;28761;628100;275171;903271
2022.02_01-07-2022;Вологодская область;165_195_days;SputnikV;34476;11361;45837;628100;275171;903271
2022.02_01-07-2022;Вологодская область;21_45_days;AllVaccines;20807;10985;31792;628100;275171;903271
2022.02_01-07-2022;Вологодская область;21_45_days;CoviVac;506;98;604;628100;275171;903271
2022.02_01-07-2022;Вологодская область;21_45_days;EpiVacCorona;842;437;1279;628100;275171;903271
2022.02_01-07-2022;Вологодская область;21_45_days;SputnikLite;9822;6717;16539;628100;275171;903271
2022.02_01-07-2022;Вологодская область;21_45_days;SputnikV;9637;3733;13370;628100;275171;903271
2022.02_01-07-2022;Вологодская область;45_75_days;AllVaccines;68885;32030;100915;628100;275171;903271
2022.02_01-07-2022;Вологодская область;45_75_days;CoviVac;1752;284;2036;628100;275171;903271
2022.02_01-07-2022;Вологодская область;45_75_days;EpiVacCorona;3006;1061;4067;628100;275171;903271
2022.02_01-07-2022;Вологодская область;45_75_days;SputnikLite;13777;11348;25125;628100;275171;903271
2022.02_01-07-2022;Вологодская область;45_75_days;SputnikV;50350;19337;69687;628100;275171;903271
2022.02_01-07-2022;Вологодская область;75_90_days;AllVaccines;34407;20140;54547;628100;275171;903271
2022.02_01-07-2022;Вологодская область;75_90_days;CoviVac;1085;169;1254;628100;275171;903271
2022.02_01-07-2022;Вологодская область;75_90_days;EpiVacCorona;1339;635;1974;628100;275171;903271
2022.02_01-07-2022;Вологодская область;75_90_days;SputnikLite;8602;7458;16060;628100;275171;903271
2022.02_01-07-2022;Вологодская область;75_90_days;SputnikV;23381;11878;35259;628100;275171;903271
2022.02_01-07-2022;Вологодская область;90_105_days;AllVaccines;14447;8329;22776;628100;275171;903271
2022.02_01-07-2022;Вологодская область;90_105_days;CoviVac;664;117;781;628100;275171;903271
2022.02_01-07-2022;Вологодская область;90_105_days;EpiVacCorona;650;285;935;628100;275171;903271
2022.02_01-07-2022;Вологодская область;90_105_days;SputnikLite;5008;1573;6581;628100;275171;903271
2022.02_01-07-2022;Вологодская область;90_105_days;SputnikV;8125;6354;14479;628100;275171;903271
2022.02_01-07-2022;Воронежская область;105_165_days;AllVaccines;141379;74917;216296;1293123;602333;1895456
2022.02_01-07-2022;Воронежская область;105_165_days;CoviVac;2354;799;3153;1293123;602333;1895456
2022.02_01-07-2022;Воронежская область;105_165_days;EpiVacCorona;1440;792;2232;1293123;602333;1895456
2022.02_01-07-2022;Воронежская область;105_165_days;SputnikLite;77874;47849;125723;1293123;602333;1895456
2022.02_01-07-2022;Воронежская область;105_165_days;SputnikV;59711;25477;85188;1293123;602333;1895456
2022.02_01-07-2022;Воронежская область;165_195_days;AllVaccines;121416;27768;149184;1293123;602333;1895456
2022.02_01-07-2022;Воронежская область;165_195_days;CoviVac;2323;534;2857;1293123;602333;1895456
2022.02_01-07-2022;Воронежская область;165_195_days;EpiVacCorona;3482;1341;4823;1293123;602333;1895456
2022.02_01-07-2022;Воронежская область;165_195_days;SputnikLite;30178;8414;38592;1293123;602333;1895456
2022.02_01-07-2022;Воронежская область;165_195_days;SputnikV;85433;17479;102912;1293123;602333;1895456
2022.02_01-07-2022;Воронежская область;21_45_days;AllVaccines;37447;21116;58563;1293123;602333;1895456
2022.02_01-07-2022;Воронежская область;21_45_days;CoviVac;342;146;488;1293123;602333;1895456
2022.02_01-07-2022;Воронежская область;21_45_days;EpiVacCorona;1205;699;1904;1293123;602333;1895456
2022.02_01-07-2022;Воронежская область;21_45_days;SputnikLite;25177;15308;40485;1293123;602333;1895456
2022.02_01-07-2022;Воронежская область;21_45_days;SputnikV;10723;4963;15686;1293123;602333;1895456
2022.02_01-07-2022;Воронежская область;45_75_days;AllVaccines;107033;52385;159418;1293123;602333;1895456
2022.02_01-07-2022;Воронежская область;45_75_days;CoviVac;650;198;848;1293123;602333;1895456
2022.02_01-07-2022;Воронежская область;45_75_days;EpiVacCorona;4976;2873;7849;1293123;602333;1895456
2022.02_01-07-2022;Воронежская область;45_75_days;SputnikLite;25653;20769;46422;1293123;602333;1895456
2022.02_01-07-2022;Воронежская область;45_75_days;SputnikV;75754;28545;104299;1293123;602333;1895456
2022.02_01-07-2022;Воронежская область;75_90_days;AllVaccines;81841;40040;121881;1293123;602333;1895456
2022.02_01-07-2022;Воронежская область;75_90_days;CoviVac;460;130;590;1293123;602333;1895456
2022.02_01-07-2022;Воронежская область;75_90_days;EpiVacCorona;2384;1164;3548;1293123;602333;1895456
2022.02_01-07-2022;Воронежская область;75_90_days;SputnikLite;24918;19949;44867;1293123;602333;1895456
2022.02_01-07-2022;Воронежская область;75_90_days;SputnikV;54079;18797;72876;1293123;602333;1895456
2022.02_01-07-2022;Воронежская область;90_105_days;AllVaccines;86994;24432;111426;1293123;602333;1895456
2022.02_01-07-2022;Воронежская область;90_105_days;CoviVac;495;163;658;1293123;602333;1895456
2022.02_01-07-2022;Воронежская область;90_105_days;EpiVacCorona;3348;1051;4399;1293123;602333;1895456
2022.02_01-07-2022;Воронежская область;90_105_days;SputnikLite;8620;6164;14784;1293123;602333;1895456
2022.02_01-07-2022;Воронежская область;90_105_days;SputnikV;74531;17054;91585;1293123;602333;1895456
2022.02_01-07-2022;Еврейская автономная область;105_165_days;AllVaccines;4745;2576;7321;88207;31969;120176
2022.02_01-07-2022;Еврейская автономная область;105_165_days;CoviVac;17;2;19;88207;31969;120176
2022.02_01-07-2022;Еврейская автономная область;105_165_days;EpiVacCorona;76;24;100;88207;31969;120176
2022.02_01-07-2022;Еврейская автономная область;105_165_days;SputnikLite;2206;1625;3831;88207;31969;120176
2022.02_01-07-2022;Еврейская автономная область;105_165_days;SputnikV;2446;925;3371;88207;31969;120176
2022.02_01-07-2022;Еврейская автономная область;165_195_days;AllVaccines;5256;1038;6294;88207;31969;120176
2022.02_01-07-2022;Еврейская автономная область;165_195_days;CoviVac;49;1;50;88207;31969;120176
2022.02_01-07-2022;Еврейская автономная область;165_195_days;EpiVacCorona;465;94;559;88207;31969;120176
2022.02_01-07-2022;Еврейская автономная область;165_195_days;SputnikLite;235;102;337;88207;31969;120176
2022.02_01-07-2022;Еврейская автономная область;165_195_days;SputnikV;4507;841;5348;88207;31969;120176
2022.02_01-07-2022;Еврейская автономная область;21_45_days;AllVaccines;4074;1447;5521;88207;31969;120176
2022.02_01-07-2022;Еврейская автономная область;21_45_days;CoviVac;341;54;395;88207;31969;120176
2022.02_01-07-2022;Еврейская автономная область;21_45_days;EpiVacCorona;768;211;979;88207;31969;120176
2022.02_01-07-2022;Еврейская автономная область;21_45_days;SputnikLite;1888;933;2821;88207;31969;120176
2022.02_01-07-2022;Еврейская автономная область;21_45_days;SputnikV;1077;249;1326;88207;31969;120176
2022.02_01-07-2022;Еврейская автономная область;45_75_days;AllVaccines;12375;3517;15892;88207;31969;120176
2022.02_01-07-2022;Еврейская автономная область;45_75_days;CoviVac;298;54;352;88207;31969;120176
2022.02_01-07-2022;Еврейская автономная область;45_75_days;EpiVacCorona;707;159;866;88207;31969;120176
2022.02_01-07-2022;Еврейская автономная область;45_75_days;SputnikLite;2324;1219;3543;88207;31969;120176
2022.02_01-07-2022;Еврейская автономная область;45_75_days;SputnikV;9046;2085;11131;88207;31969;120176
2022.02_01-07-2022;Еврейская автономная область;75_90_days;AllVaccines;4238;1296;5534;88207;31969;120176
2022.02_01-07-2022;Еврейская автономная область;75_90_days;CoviVac;2;0;2;88207;31969;120176
2022.02_01-07-2022;Еврейская автономная область;75_90_days;EpiVacCorona;665;85;750;88207;31969;120176
2022.02_01-07-2022;Еврейская автономная область;75_90_days;SputnikLite;1020;615;1635;88207;31969;120176
2022.02_01-07-2022;Еврейская автономная область;75_90_days;SputnikV;2551;596;3147;88207;31969;120176
2022.02_01-07-2022;Еврейская автономная область;90_105_days;AllVaccines;2988;1032;4020;88207;31969;120176
2022.02_01-07-2022;Еврейская автономная область;90_105_days;CoviVac;4;1;5;88207;31969;120176
2022.02_01-07-2022;Еврейская автономная область;90_105_days;EpiVacCorona;482;75;557;88207;31969;120176
2022.02_01-07-2022;Еврейская автономная область;90_105_days;SputnikLite;1079;526;1605;88207;31969;120176
2022.02_01-07-2022;Еврейская автономная область;90_105_days;SputnikV;1423;430;1853;88207;31969;120176
2022.02_01-07-2022;Забайкальский край;105_165_days;AllVaccines;60658;23116;83774;596322;191826;788148
2022.02_01-07-2022;Забайкальский край;105_165_days;CoviVac;354;27;381;596322;191826;788148
2022.02_01-07-2022;Забайкальский край;105_165_days;EpiVacCorona;285;77;362;596322;191826;788148
2022.02_01-07-2022;Забайкальский край;105_165_days;SputnikLite;42315;16404;58719;596322;191826;788148
2022.02_01-07-2022;Забайкальский край;105_165_days;SputnikV;17704;6608;24312;596322;191826;788148
2022.02_01-07-2022;Забайкальский край;165_195_days;AllVaccines;65851;10780;76631;596322;191826;788148
2022.02_01-07-2022;Забайкальский край;165_195_days;CoviVac;302;11;313;596322;191826;788148
2022.02_01-07-2022;Забайкальский край;165_195_days;EpiVacCorona;1152;369;1521;596322;191826;788148
2022.02_01-07-2022;Забайкальский край;165_195_days;SputnikLite;19018;710;19728;596322;191826;788148
2022.02_01-07-2022;Забайкальский край;165_195_days;SputnikV;45379;9690;55069;596322;191826;788148
2022.02_01-07-2022;Забайкальский край;21_45_days;AllVaccines;25235;8219;33454;596322;191826;788148
2022.02_01-07-2022;Забайкальский край;21_45_days;CoviVac;195;36;231;596322;191826;788148
2022.02_01-07-2022;Забайкальский край;21_45_days;EpiVacCorona;2224;692;2916;596322;191826;788148
2022.02_01-07-2022;Забайкальский край;21_45_days;SputnikLite;13433;4577;18010;596322;191826;788148
2022.02_01-07-2022;Забайкальский край;21_45_days;SputnikV;9383;2914;12297;596322;191826;788148
2022.02_01-07-2022;Забайкальский край;45_75_days;AllVaccines;61167;23240;84407;596322;191826;788148
2022.02_01-07-2022;Забайкальский край;45_75_days;CoviVac;536;41;577;596322;191826;788148
2022.02_01-07-2022;Забайкальский край;45_75_days;EpiVacCorona;4380;1452;5832;596322;191826;788148
2022.02_01-07-2022;Забайкальский край;45_75_days;SputnikLite;18182;8128;26310;596322;191826;788148
2022.02_01-07-2022;Забайкальский край;45_75_days;SputnikV;38069;13619;51688;596322;191826;788148
2022.02_01-07-2022;Забайкальский край;75_90_days;AllVaccines;37428;15237;52665;596322;191826;788148
2022.02_01-07-2022;Забайкальский край;75_90_days;CoviVac;499;52;551;596322;191826;788148
2022.02_01-07-2022;Забайкальский край;75_90_days;EpiVacCorona;1608;569;2177;596322;191826;788148
2022.02_01-07-2022;Забайкальский край;75_90_days;SputnikLite;12714;5952;18666;596322;191826;788148
2022.02_01-07-2022;Забайкальский край;75_90_days;SputnikV;22607;8664;31271;596322;191826;788148
2022.02_01-07-2022;Забайкальский край;90_105_days;AllVaccines;21739;10127;31866;596322;191826;788148
2022.02_01-07-2022;Забайкальский край;90_105_days;CoviVac;303;25;328;596322;191826;788148
2022.02_01-07-2022;Забайкальский край;90_105_days;EpiVacCorona;426;164;590;596322;191826;788148
2022.02_01-07-2022;Забайкальский край;90_105_days;SputnikLite;13154;5697;18851;596322;191826;788148
2022.02_01-07-2022;Забайкальский край;90_105_days;SputnikV;7856;4241;12097;596322;191826;788148
2022.02_01-07-2022;Ивановская область;105_165_days;AllVaccines;36343;24136;60479;549803;255947;805750
2022.02_01-07-2022;Ивановская область;105_165_days;CoviVac;155;27;182;549803;255947;805750
2022.02_01-07-2022;Ивановская область;105_165_days;EpiVacCorona;255;191;446;549803;255947;805750
2022.02_01-07-2022;Ивановская область;105_165_days;SputnikLite;21988;16512;38500;549803;255947;805750
2022.02_01-07-2022;Ивановская область;105_165_days;SputnikV;13945;7406;21351;549803;255947;805750
2022.02_01-07-2022;Ивановская область;165_195_days;AllVaccines;52437;9694;62131;549803;255947;805750
2022.02_01-07-2022;Ивановская область;165_195_days;CoviVac;363;35;398;549803;255947;805750
2022.02_01-07-2022;Ивановская область;165_195_days;EpiVacCorona;506;328;834;549803;255947;805750
2022.02_01-07-2022;Ивановская область;165_195_days;SputnikLite;7990;1838;9828;549803;255947;805750
2022.02_01-07-2022;Ивановская область;165_195_days;SputnikV;43578;7493;51071;549803;255947;805750
2022.02_01-07-2022;Ивановская область;21_45_days;AllVaccines;11888;7024;18912;549803;255947;805750
2022.02_01-07-2022;Ивановская область;21_45_days;CoviVac;90;17;107;549803;255947;805750
2022.02_01-07-2022;Ивановская область;21_45_days;EpiVacCorona;574;273;847;549803;255947;805750
2022.02_01-07-2022;Ивановская область;21_45_days;SputnikLite;8424;4987;13411;549803;255947;805750
2022.02_01-07-2022;Ивановская область;21_45_days;SputnikV;2800;1747;4547;549803;255947;805750
2022.02_01-07-2022;Ивановская область;45_75_days;AllVaccines;20962;16556;37518;549803;255947;805750
2022.02_01-07-2022;Ивановская область;45_75_days;CoviVac;387;65;452;549803;255947;805750
2022.02_01-07-2022;Ивановская область;45_75_days;EpiVacCorona;1173;1053;2226;549803;255947;805750
2022.02_01-07-2022;Ивановская область;45_75_days;SputnikLite;7400;6754;14154;549803;255947;805750
2022.02_01-07-2022;Ивановская область;45_75_days;SputnikV;12002;8684;20686;549803;255947;805750
2022.02_01-07-2022;Ивановская область;75_90_days;AllVaccines;15738;12637;28375;549803;255947;805750
2022.02_01-07-2022;Ивановская область;75_90_days;CoviVac;96;19;115;549803;255947;805750
2022.02_01-07-2022;Ивановская область;75_90_days;EpiVacCorona;335;257;592;549803;255947;805750
2022.02_01-07-2022;Ивановская область;75_90_days;SputnikLite;6153;6444;12597;549803;255947;805750
2022.02_01-07-2022;Ивановская область;75_90_days;SputnikV;9154;5917;15071;549803;255947;805750
2022.02_01-07-2022;Ивановская область;90_105_days;AllVaccines;15515;12646;28161;549803;255947;805750
2022.02_01-07-2022;Ивановская область;90_105_days;CoviVac;222;44;266;549803;255947;805750
2022.02_01-07-2022;Ивановская область;90_105_days;EpiVacCorona;256;209;465;549803;255947;805750
2022.02_01-07-2022;Ивановская область;90_105_days;SputnikLite;8729;7061;15790;549803;255947;805750
2022.02_01-07-2022;Ивановская область;90_105_days;SputnikV;6308;5332;11640;549803;255947;805750
2022.02_01-07-2022;Иркутская область;105_165_days;AllVaccines;107651;51086;158737;1316761;480655;1797416
2022.02_01-07-2022;Иркутская область;105_165_days;CoviVac;1395;387;1782;1316761;480655;1797416
2022.02_01-07-2022;Иркутская область;105_165_days;EpiVacCorona;3963;1353;5316;1316761;480655;1797416
2022.02_01-07-2022;Иркутская область;105_165_days;SputnikLite;44804;32620;77424;1316761;480655;1797416
2022.02_01-07-2022;Иркутская область;105_165_days;SputnikV;57489;16726;74215;1316761;480655;1797416
2022.02_01-07-2022;Иркутская область;165_195_days;AllVaccines;87369;21998;109367;1316761;480655;1797416
2022.02_01-07-2022;Иркутская область;165_195_days;CoviVac;1696;372;2068;1316761;480655;1797416
2022.02_01-07-2022;Иркутская область;165_195_days;EpiVacCorona;4848;1300;6148;1316761;480655;1797416
2022.02_01-07-2022;Иркутская область;165_195_days;SputnikLite;10175;3911;14086;1316761;480655;1797416
2022.02_01-07-2022;Иркутская область;165_195_days;SputnikV;70650;16415;87065;1316761;480655;1797416
2022.02_01-07-2022;Иркутская область;21_45_days;AllVaccines;50428;22202;72630;1316761;480655;1797416
2022.02_01-07-2022;Иркутская область;21_45_days;CoviVac;256;75;331;1316761;480655;1797416
2022.02_01-07-2022;Иркутская область;21_45_days;EpiVacCorona;1220;655;1875;1316761;480655;1797416
2022.02_01-07-2022;Иркутская область;21_45_days;SputnikLite;25550;16332;41882;1316761;480655;1797416
2022.02_01-07-2022;Иркутская область;21_45_days;SputnikV;23402;5140;28542;1316761;480655;1797416
2022.02_01-07-2022;Иркутская область;45_75_days;AllVaccines;175899;55091;230990;1316761;480655;1797416
2022.02_01-07-2022;Иркутская область;45_75_days;CoviVac;1637;361;1998;1316761;480655;1797416
2022.02_01-07-2022;Иркутская область;45_75_days;EpiVacCorona;3280;1108;4388;1316761;480655;1797416
2022.02_01-07-2022;Иркутская область;45_75_days;SputnikLite;37964;26937;64901;1316761;480655;1797416
2022.02_01-07-2022;Иркутская область;45_75_days;SputnikV;133018;26685;159703;1316761;480655;1797416
2022.02_01-07-2022;Иркутская область;75_90_days;AllVaccines;102767;32537;135304;1316761;480655;1797416
2022.02_01-07-2022;Иркутская область;75_90_days;CoviVac;1408;288;1696;1316761;480655;1797416
2022.02_01-07-2022;Иркутская область;75_90_days;EpiVacCorona;1841;546;2387;1316761;480655;1797416
2022.02_01-07-2022;Иркутская область;75_90_days;SputnikLite;22908;17107;40015;1316761;480655;1797416
2022.02_01-07-2022;Иркутская область;75_90_days;SputnikV;76610;14596;91206;1316761;480655;1797416
2022.02_01-07-2022;Иркутская область;90_105_days;AllVaccines;45849;16756;62605;1316761;480655;1797416
2022.02_01-07-2022;Иркутская область;90_105_days;CoviVac;1088;206;1294;1316761;480655;1797416
2022.02_01-07-2022;Иркутская область;90_105_days;EpiVacCorona;1523;475;1998;1316761;480655;1797416
2022.02_01-07-2022;Иркутская область;90_105_days;SputnikLite;10889;7402;18291;1316761;480655;1797416
2022.02_01-07-2022;Иркутская область;90_105_days;SputnikV;32349;8673;41022;1316761;480655;1797416
2022.02_01-07-2022;Кабардино-Балкарская Республика;105_165_days;AllVaccines;36517;11151;47668;502388;159241;661629
2022.02_01-07-2022;Кабардино-Балкарская Республика;105_165_days;CoviVac;228;72;300;502388;159241;661629
2022.02_01-07-2022;Кабардино-Балкарская Республика;105_165_days;EpiVacCorona;108;51;159;502388;159241;661629
2022.02_01-07-2022;Кабардино-Балкарская Республика;105_165_days;SputnikLite;23573;6905;30478;502388;159241;661629
2022.02_01-07-2022;Кабардино-Балкарская Республика;105_165_days;SputnikV;12608;4123;16731;502388;159241;661629
2022.02_01-07-2022;Кабардино-Балкарская Республика;165_195_days;AllVaccines;45850;9721;55571;502388;159241;661629
2022.02_01-07-2022;Кабардино-Балкарская Республика;165_195_days;CoviVac;319;47;366;502388;159241;661629
2022.02_01-07-2022;Кабардино-Балкарская Республика;165_195_days;EpiVacCorona;911;198;1109;502388;159241;661629
2022.02_01-07-2022;Кабардино-Балкарская Республика;165_195_days;SputnikLite;8739;1672;10411;502388;159241;661629
2022.02_01-07-2022;Кабардино-Балкарская Республика;165_195_days;SputnikV;35881;7804;43685;502388;159241;661629
2022.02_01-07-2022;Кабардино-Балкарская Республика;21_45_days;AllVaccines;12513;4732;17245;502388;159241;661629
2022.02_01-07-2022;Кабардино-Балкарская Республика;21_45_days;CoviVac;80;35;115;502388;159241;661629
2022.02_01-07-2022;Кабардино-Балкарская Республика;21_45_days;EpiVacCorona;747;189;936;502388;159241;661629
2022.02_01-07-2022;Кабардино-Балкарская Республика;21_45_days;SputnikLite;8745;3423;12168;502388;159241;661629
2022.02_01-07-2022;Кабардино-Балкарская Республика;21_45_days;SputnikV;2941;1085;4026;502388;159241;661629
2022.02_01-07-2022;Кабардино-Балкарская Республика;45_75_days;AllVaccines;18492;6617;25109;502388;159241;661629
2022.02_01-07-2022;Кабардино-Балкарская Республика;45_75_days;CoviVac;171;46;217;502388;159241;661629
2022.02_01-07-2022;Кабардино-Балкарская Республика;45_75_days;EpiVacCorona;906;257;1163;502388;159241;661629
2022.02_01-07-2022;Кабардино-Балкарская Республика;45_75_days;SputnikLite;9022;2823;11845;502388;159241;661629
2022.02_01-07-2022;Кабардино-Балкарская Республика;45_75_days;SputnikV;8393;3491;11884;502388;159241;661629
2022.02_01-07-2022;Кабардино-Балкарская Республика;75_90_days;AllVaccines;13485;4087;17572;502388;159241;661629
2022.02_01-07-2022;Кабардино-Балкарская Республика;75_90_days;CoviVac;73;15;88;502388;159241;661629
2022.02_01-07-2022;Кабардино-Балкарская Республика;75_90_days;EpiVacCorona;470;120;590;502388;159241;661629
2022.02_01-07-2022;Кабардино-Балкарская Республика;75_90_days;SputnikLite;5639;1834;7473;502388;159241;661629
2022.02_01-07-2022;Кабардино-Балкарская Республика;75_90_days;SputnikV;7303;2118;9421;502388;159241;661629
2022.02_01-07-2022;Кабардино-Балкарская Республика;90_105_days;AllVaccines;18054;5350;23404;502388;159241;661629
2022.02_01-07-2022;Кабардино-Балкарская Республика;90_105_days;CoviVac;85;25;110;502388;159241;661629
2022.02_01-07-2022;Кабардино-Балкарская Республика;90_105_days;EpiVacCorona;132;36;168;502388;159241;661629
2022.02_01-07-2022;Кабардино-Балкарская Республика;90_105_days;SputnikLite;13395;3529;16924;502388;159241;661629
2022.02_01-07-2022;Кабардино-Балкарская Республика;90_105_days;SputnikV;4442;1760;6202;502388;159241;661629
2022.02_01-07-2022;Калининградская область;105_165_days;AllVaccines;70804;27569;98373;585700;231702;817402
2022.02_01-07-2022;Калининградская область;105_165_days;CoviVac;529;134;663;585700;231702;817402
2022.02_01-07-2022;Калининградская область;105_165_days;EpiVacCorona;1142;406;1548;585700;231702;817402
2022.02_01-07-2022;Калининградская область;105_165_days;SputnikLite;40726;15784;56510;585700;231702;817402
2022.02_01-07-2022;Калининградская область;105_165_days;SputnikV;28407;11245;39652;585700;231702;817402
2022.02_01-07-2022;Калининградская область;165_195_days;AllVaccines;63843;11739;75582;585700;231702;817402
2022.02_01-07-2022;Калининградская область;165_195_days;CoviVac;259;48;307;585700;231702;817402
2022.02_01-07-2022;Калининградская область;165_195_days;EpiVacCorona;7415;1419;8834;585700;231702;817402
2022.02_01-07-2022;Калининградская область;165_195_days;SputnikLite;19193;3084;22277;585700;231702;817402
2022.02_01-07-2022;Калининградская область;165_195_days;SputnikV;36976;7188;44164;585700;231702;817402
2022.02_01-07-2022;Калининградская область;21_45_days;AllVaccines;20641;11432;32073;585700;231702;817402
2022.02_01-07-2022;Калининградская область;21_45_days;CoviVac;293;88;381;585700;231702;817402
2022.02_01-07-2022;Калининградская область;21_45_days;EpiVacCorona;680;320;1000;585700;231702;817402
2022.02_01-07-2022;Калининградская область;21_45_days;SputnikLite;11843;7821;19664;585700;231702;817402
2022.02_01-07-2022;Калининградская область;21_45_days;SputnikV;7825;3203;11028;585700;231702;817402
2022.02_01-07-2022;Калининградская область;45_75_days;AllVaccines;50771;26023;76794;585700;231702;817402
2022.02_01-07-2022;Калининградская область;45_75_days;CoviVac;996;276;1272;585700;231702;817402
2022.02_01-07-2022;Калининградская область;45_75_days;EpiVacCorona;1519;498;2017;585700;231702;817402
2022.02_01-07-2022;Калининградская область;45_75_days;SputnikLite;11213;10251;21464;585700;231702;817402
2022.02_01-07-2022;Калининградская область;45_75_days;SputnikV;37043;14998;52041;585700;231702;817402
2022.02_01-07-2022;Калининградская область;75_90_days;AllVaccines;32592;17235;49827;585700;231702;817402
2022.02_01-07-2022;Калининградская область;75_90_days;CoviVac;546;97;643;585700;231702;817402
2022.02_01-07-2022;Калининградская область;75_90_days;EpiVacCorona;976;346;1322;585700;231702;817402
2022.02_01-07-2022;Калининградская область;75_90_days;SputnikLite;6859;6798;13657;585700;231702;817402
2022.02_01-07-2022;Калининградская область;75_90_days;SputnikV;24211;9994;34205;585700;231702;817402
2022.02_01-07-2022;Калининградская область;90_105_days;AllVaccines;28570;12120;40690;585700;231702;817402
2022.02_01-07-2022;Калининградская область;90_105_days;CoviVac;170;56;226;585700;231702;817402
2022.02_01-07-2022;Калининградская область;90_105_days;EpiVacCorona;893;348;1241;585700;231702;817402
2022.02_01-07-2022;Калининградская область;90_105_days;SputnikLite;4911;4069;8980;585700;231702;817402
2022.02_01-07-2022;Калининградская область;90_105_days;SputnikV;22596;7647;30243;585700;231702;817402
2022.02_01-07-2022;Калужская область;105_165_days;AllVaccines;56508;25339;81847;559789;253023;812812
2022.02_01-07-2022;Калужская область;105_165_days;CoviVac;545;122;667;559789;253023;812812
2022.02_01-07-2022;Калужская область;105_165_days;EpiVacCorona;1181;615;1796;559789;253023;812812
2022.02_01-07-2022;Калужская область;105_165_days;SputnikLite;34957;17025;51982;559789;253023;812812
2022.02_01-07-2022;Калужская область;105_165_days;SputnikV;19825;7577;27402;559789;253023;812812
2022.02_01-07-2022;Калужская область;165_195_days;AllVaccines;48297;12553;60850;559789;253023;812812
2022.02_01-07-2022;Калужская область;165_195_days;CoviVac;266;48;314;559789;253023;812812
2022.02_01-07-2022;Калужская область;165_195_days;EpiVacCorona;2058;699;2757;559789;253023;812812
2022.02_01-07-2022;Калужская область;165_195_days;SputnikLite;7526;2888;10414;559789;253023;812812
2022.02_01-07-2022;Калужская область;165_195_days;SputnikV;38447;8918;47365;559789;253023;812812
2022.02_01-07-2022;Калужская область;21_45_days;AllVaccines;18606;10369;28975;559789;253023;812812
2022.02_01-07-2022;Калужская область;21_45_days;CoviVac;123;40;163;559789;253023;812812
2022.02_01-07-2022;Калужская область;21_45_days;EpiVacCorona;498;266;764;559789;253023;812812
2022.02_01-07-2022;Калужская область;21_45_days;SputnikLite;9715;7188;16903;559789;253023;812812
2022.02_01-07-2022;Калужская область;21_45_days;SputnikV;8270;2875;11145;559789;253023;812812
2022.02_01-07-2022;Калужская область;45_75_days;AllVaccines;67915;25900;93815;559789;253023;812812
2022.02_01-07-2022;Калужская область;45_75_days;CoviVac;495;126;621;559789;253023;812812
2022.02_01-07-2022;Калужская область;45_75_days;EpiVacCorona;2644;993;3637;559789;253023;812812
2022.02_01-07-2022;Калужская область;45_75_days;SputnikLite;12121;9298;21419;559789;253023;812812
2022.02_01-07-2022;Калужская область;45_75_days;SputnikV;52655;15483;68138;559789;253023;812812
2022.02_01-07-2022;Калужская область;75_90_days;AllVaccines;56772;17003;73775;559789;253023;812812
2022.02_01-07-2022;Калужская область;75_90_days;CoviVac;1503;344;1847;559789;253023;812812
2022.02_01-07-2022;Калужская область;75_90_days;EpiVacCorona;2109;600;2709;559789;253023;812812
2022.02_01-07-2022;Калужская область;75_90_days;SputnikLite;7362;5753;13115;559789;253023;812812
2022.02_01-07-2022;Калужская область;75_90_days;SputnikV;45798;10306;56104;559789;253023;812812
2022.02_01-07-2022;Калужская область;90_105_days;AllVaccines;23203;8588;31791;559789;253023;812812
2022.02_01-07-2022;Калужская область;90_105_days;CoviVac;971;244;1215;559789;253023;812812
2022.02_01-07-2022;Калужская область;90_105_days;EpiVacCorona;1356;505;1861;559789;253023;812812
2022.02_01-07-2022;Калужская область;90_105_days;SputnikLite;5102;2330;7432;559789;253023;812812
2022.02_01-07-2022;Калужская область;90_105_days;SputnikV;15774;5509;21283;559789;253023;812812
2022.02_01-07-2022;Камчатский край;105_165_days;AllVaccines;18304;5436;23740;189425;56856;246281
2022.02_01-07-2022;Камчатский край;105_165_days;CoviVac;20;7;27;189425;56856;246281
2022.02_01-07-2022;Камчатский край;105_165_days;EpiVacCorona;1141;259;1400;189425;56856;246281
2022.02_01-07-2022;Камчатский край;105_165_days;SputnikLite;8973;3558;12531;189425;56856;246281
2022.02_01-07-2022;Камчатский край;105_165_days;SputnikV;8170;1612;9782;189425;56856;246281
2022.02_01-07-2022;Камчатский край;165_195_days;AllVaccines;16651;3038;19689;189425;56856;246281
2022.02_01-07-2022;Камчатский край;165_195_days;CoviVac;36;14;50;189425;56856;246281
2022.02_01-07-2022;Камчатский край;165_195_days;EpiVacCorona;985;191;1176;189425;56856;246281
2022.02_01-07-2022;Камчатский край;165_195_days;SputnikLite;3285;604;3889;189425;56856;246281
2022.02_01-07-2022;Камчатский край;165_195_days;SputnikV;12345;2229;14574;189425;56856;246281
2022.02_01-07-2022;Камчатский край;21_45_days;AllVaccines;4903;1688;6591;189425;56856;246281
2022.02_01-07-2022;Камчатский край;21_45_days;CoviVac;15;3;18;189425;56856;246281
2022.02_01-07-2022;Камчатский край;21_45_days;EpiVacCorona;126;57;183;189425;56856;246281
2022.02_01-07-2022;Камчатский край;21_45_days;SputnikLite;3129;1324;4453;189425;56856;246281
2022.02_01-07-2022;Камчатский край;21_45_days;SputnikV;1633;304;1937;189425;56856;246281
2022.02_01-07-2022;Камчатский край;45_75_days;AllVaccines;14909;4166;19075;189425;56856;246281
2022.02_01-07-2022;Камчатский край;45_75_days;CoviVac;206;51;257;189425;56856;246281
2022.02_01-07-2022;Камчатский край;45_75_days;EpiVacCorona;460;179;639;189425;56856;246281
2022.02_01-07-2022;Камчатский край;45_75_days;SputnikLite;5611;2001;7612;189425;56856;246281
2022.02_01-07-2022;Камчатский край;45_75_days;SputnikV;8632;1935;10567;189425;56856;246281
2022.02_01-07-2022;Камчатский край;75_90_days;AllVaccines;8971;2629;11600;189425;56856;246281
2022.02_01-07-2022;Камчатский край;75_90_days;CoviVac;166;25;191;189425;56856;246281
2022.02_01-07-2022;Камчатский край;75_90_days;EpiVacCorona;315;91;406;189425;56856;246281
2022.02_01-07-2022;Камчатский край;75_90_days;SputnikLite;3815;1553;5368;189425;56856;246281
2022.02_01-07-2022;Камчатский край;75_90_days;SputnikV;4675;960;5635;189425;56856;246281
2022.02_01-07-2022;Камчатский край;90_105_days;AllVaccines;7912;2670;10582;189425;56856;246281
2022.02_01-07-2022;Камчатский край;90_105_days;CoviVac;63;9;72;189425;56856;246281
2022.02_01-07-2022;Камчатский край;90_105_days;EpiVacCorona;148;40;188;189425;56856;246281
2022.02_01-07-2022;Камчатский край;90_105_days;SputnikLite;5751;1996;7747;189425;56856;246281
2022.02_01-07-2022;Камчатский край;90_105_days;SputnikV;1950;625;2575;189425;56856;246281
2022.02_01-07-2022;Карачаево-Черкесская Республика;105_165_days;AllVaccines;17145;5884;23029;266261;94005;360266
2022.02_01-07-2022;Карачаево-Черкесская Республика;105_165_days;CoviVac;98;35;133;266261;94005;360266
2022.02_01-07-2022;Карачаево-Черкесская Республика;105_165_days;EpiVacCorona;425;54;479;266261;94005;360266
2022.02_01-07-2022;Карачаево-Черкесская Республика;105_165_days;SputnikLite;8424;3278;11702;266261;94005;360266
2022.02_01-07-2022;Карачаево-Черкесская Республика;105_165_days;SputnikV;8198;2517;10715;266261;94005;360266
2022.02_01-07-2022;Карачаево-Черкесская Республика;165_195_days;AllVaccines;21709;4320;26029;266261;94005;360266
2022.02_01-07-2022;Карачаево-Черкесская Республика;165_195_days;CoviVac;362;85;447;266261;94005;360266
2022.02_01-07-2022;Карачаево-Черкесская Республика;165_195_days;EpiVacCorona;1308;170;1478;266261;94005;360266
2022.02_01-07-2022;Карачаево-Черкесская Республика;165_195_days;SputnikLite;5146;1107;6253;266261;94005;360266
2022.02_01-07-2022;Карачаево-Черкесская Республика;165_195_days;SputnikV;14893;2958;17851;266261;94005;360266
2022.02_01-07-2022;Карачаево-Черкесская Республика;21_45_days;AllVaccines;8293;2873;11166;266261;94005;360266
2022.02_01-07-2022;Карачаево-Черкесская Республика;21_45_days;CoviVac;62;20;82;266261;94005;360266
2022.02_01-07-2022;Карачаево-Черкесская Республика;21_45_days;EpiVacCorona;488;129;617;266261;94005;360266
2022.02_01-07-2022;Карачаево-Черкесская Республика;21_45_days;SputnikLite;4917;1906;6823;266261;94005;360266
2022.02_01-07-2022;Карачаево-Черкесская Республика;21_45_days;SputnikV;2826;818;3644;266261;94005;360266
2022.02_01-07-2022;Карачаево-Черкесская Республика;45_75_days;AllVaccines;12242;4218;16460;266261;94005;360266
2022.02_01-07-2022;Карачаево-Черкесская Республика;45_75_days;CoviVac;121;46;167;266261;94005;360266
2022.02_01-07-2022;Карачаево-Черкесская Республика;45_75_days;EpiVacCorona;231;74;305;266261;94005;360266
2022.02_01-07-2022;Карачаево-Черкесская Республика;45_75_days;SputnikLite;7031;2290;9321;266261;94005;360266
2022.02_01-07-2022;Карачаево-Черкесская Республика;45_75_days;SputnikV;4859;1808;6667;266261;94005;360266
2022.02_01-07-2022;Карачаево-Черкесская Республика;75_90_days;AllVaccines;7603;2757;10360;266261;94005;360266
2022.02_01-07-2022;Карачаево-Черкесская Республика;75_90_days;CoviVac;34;9;43;266261;94005;360266
2022.02_01-07-2022;Карачаево-Черкесская Республика;75_90_days;EpiVacCorona;50;15;65;266261;94005;360266
2022.02_01-07-2022;Карачаево-Черкесская Республика;75_90_days;SputnikLite;4918;1659;6577;266261;94005;360266
2022.02_01-07-2022;Карачаево-Черкесская Республика;75_90_days;SputnikV;2601;1074;3675;266261;94005;360266
2022.02_01-07-2022;Карачаево-Черкесская Республика;90_105_days;AllVaccines;7667;2973;10640;266261;94005;360266
2022.02_01-07-2022;Карачаево-Черкесская Республика;90_105_days;CoviVac;5;6;11;266261;94005;360266
2022.02_01-07-2022;Карачаево-Черкесская Республика;90_105_days;EpiVacCorona;45;18;63;266261;94005;360266
2022.02_01-07-2022;Карачаево-Черкесская Республика;90_105_days;SputnikLite;5685;1763;7448;266261;94005;360266
2022.02_01-07-2022;Карачаево-Черкесская Республика;90_105_days;SputnikV;1932;1186;3118;266261;94005;360266
2022.02_01-07-2022;Кемеровская область;105_165_days;AllVaccines;104407;46196;150603;1453976;610256;2064232
2022.02_01-07-2022;Кемеровская область;105_165_days;CoviVac;1841;386;2227;1453976;610256;2064232
2022.02_01-07-2022;Кемеровская область;105_165_days;EpiVacCorona;1137;419;1556;1453976;610256;2064232
2022.02_01-07-2022;Кемеровская область;105_165_days;SputnikLite;23317;25511;48828;1453976;610256;2064232
2022.02_01-07-2022;Кемеровская область;105_165_days;SputnikV;78112;19880;97992;1453976;610256;2064232
2022.02_01-07-2022;Кемеровская область;165_195_days;AllVaccines;147970;27322;175292;1453976;610256;2064232
2022.02_01-07-2022;Кемеровская область;165_195_days;CoviVac;666;115;781;1453976;610256;2064232
2022.02_01-07-2022;Кемеровская область;165_195_days;EpiVacCorona;1463;449;1912;1453976;610256;2064232
2022.02_01-07-2022;Кемеровская область;165_195_days;SputnikLite;4722;2032;6754;1453976;610256;2064232
2022.02_01-07-2022;Кемеровская область;165_195_days;SputnikV;141119;24726;165845;1453976;610256;2064232
2022.02_01-07-2022;Кемеровская область;21_45_days;AllVaccines;60819;27608;88427;1453976;610256;2064232
2022.02_01-07-2022;Кемеровская область;21_45_days;CoviVac;308;85;393;1453976;610256;2064232
2022.02_01-07-2022;Кемеровская область;21_45_days;EpiVacCorona;4510;2647;7157;1453976;610256;2064232
2022.02_01-07-2022;Кемеровская область;21_45_days;SputnikLite;35139;17563;52702;1453976;610256;2064232
2022.02_01-07-2022;Кемеровская область;21_45_days;SputnikV;20862;7313;28175;1453976;610256;2064232
2022.02_01-07-2022;Кемеровская область;45_75_days;AllVaccines;140510;58498;199008;1453976;610256;2064232
2022.02_01-07-2022;Кемеровская область;45_75_days;CoviVac;1462;304;1766;1453976;610256;2064232
2022.02_01-07-2022;Кемеровская область;45_75_days;EpiVacCorona;5241;2103;7344;1453976;610256;2064232
2022.02_01-07-2022;Кемеровская область;45_75_days;SputnikLite;25039;19772;44811;1453976;610256;2064232
2022.02_01-07-2022;Кемеровская область;45_75_days;SputnikV;108768;36319;145087;1453976;610256;2064232
2022.02_01-07-2022;Кемеровская область;75_90_days;AllVaccines;45195;25790;70985;1453976;610256;2064232
2022.02_01-07-2022;Кемеровская область;75_90_days;CoviVac;982;152;1134;1453976;610256;2064232
2022.02_01-07-2022;Кемеровская область;75_90_days;EpiVacCorona;2433;1255;3688;1453976;610256;2064232
2022.02_01-07-2022;Кемеровская область;75_90_days;SputnikLite;12045;11220;23265;1453976;610256;2064232
2022.02_01-07-2022;Кемеровская область;75_90_days;SputnikV;29735;13163;42898;1453976;610256;2064232
2022.02_01-07-2022;Кемеровская область;90_105_days;AllVaccines;32186;20667;52853;1453976;610256;2064232
2022.02_01-07-2022;Кемеровская область;90_105_days;CoviVac;471;104;575;1453976;610256;2064232
2022.02_01-07-2022;Кемеровская область;90_105_days;EpiVacCorona;1027;650;1677;1453976;610256;2064232
2022.02_01-07-2022;Кемеровская область;90_105_days;SputnikLite;11358;9795;21153;1453976;610256;2064232
2022.02_01-07-2022;Кемеровская область;90_105_days;SputnikV;19330;10118;29448;1453976;610256;2064232
2022.02_01-07-2022;Кировская область;105_165_days;AllVaccines;68322;39111;107433;663621;334585;998206
2022.02_01-07-2022;Кировская область;105_165_days;CoviVac;798;92;890;663621;334585;998206
2022.02_01-07-2022;Кировская область;105_165_days;EpiVacCorona;428;187;615;663621;334585;998206
2022.02_01-07-2022;Кировская область;105_165_days;SputnikLite;54761;28840;83601;663621;334585;998206
2022.02_01-07-2022;Кировская область;105_165_days;SputnikV;12335;9992;22327;663621;334585;998206
2022.02_01-07-2022;Кировская область;165_195_days;AllVaccines;48555;15818;64373;663621;334585;998206
2022.02_01-07-2022;Кировская область;165_195_days;CoviVac;236;19;255;663621;334585;998206
2022.02_01-07-2022;Кировская область;165_195_days;EpiVacCorona;842;306;1148;663621;334585;998206
2022.02_01-07-2022;Кировская область;165_195_days;SputnikLite;15919;3330;19249;663621;334585;998206
2022.02_01-07-2022;Кировская область;165_195_days;SputnikV;31558;12163;43721;663621;334585;998206
2022.02_01-07-2022;Кировская область;21_45_days;AllVaccines;26784;17542;44326;663621;334585;998206
2022.02_01-07-2022;Кировская область;21_45_days;CoviVac;398;83;481;663621;334585;998206
2022.02_01-07-2022;Кировская область;21_45_days;EpiVacCorona;1102;567;1669;663621;334585;998206
2022.02_01-07-2022;Кировская область;21_45_days;SputnikLite;19134;12624;31758;663621;334585;998206
2022.02_01-07-2022;Кировская область;21_45_days;SputnikV;6150;4268;10418;663621;334585;998206
2022.02_01-07-2022;Кировская область;45_75_days;AllVaccines;66184;40451;106635;663621;334585;998206
2022.02_01-07-2022;Кировская область;45_75_days;CoviVac;1186;167;1353;663621;334585;998206
2022.02_01-07-2022;Кировская область;45_75_days;EpiVacCorona;3452;1433;4885;663621;334585;998206
2022.02_01-07-2022;Кировская область;45_75_days;SputnikLite;20350;14333;34683;663621;334585;998206
2022.02_01-07-2022;Кировская область;45_75_days;SputnikV;41196;24518;65714;663621;334585;998206
2022.02_01-07-2022;Кировская область;75_90_days;AllVaccines;59581;30483;90064;663621;334585;998206
2022.02_01-07-2022;Кировская область;75_90_days;CoviVac;1797;190;1987;663621;334585;998206
2022.02_01-07-2022;Кировская область;75_90_days;EpiVacCorona;2567;936;3503;663621;334585;998206
2022.02_01-07-2022;Кировская область;75_90_days;SputnikLite;21261;13535;34796;663621;334585;998206
2022.02_01-07-2022;Кировская область;75_90_days;SputnikV;33956;15822;49778;663621;334585;998206
2022.02_01-07-2022;Кировская область;90_105_days;AllVaccines;31912;18049;49961;663621;334585;998206
2022.02_01-07-2022;Кировская область;90_105_days;CoviVac;1144;119;1263;663621;334585;998206
2022.02_01-07-2022;Кировская область;90_105_days;EpiVacCorona;1480;549;2029;663621;334585;998206
2022.02_01-07-2022;Кировская область;90_105_days;SputnikLite;14524;8976;23500;663621;334585;998206
2022.02_01-07-2022;Кировская область;90_105_days;SputnikV;14764;8405;23169;663621;334585;998206
2022.02_01-07-2022;Костромская область;105_165_days;AllVaccines;36287;17722;54009;339046;160543;499589
2022.02_01-07-2022;Костромская область;105_165_days;CoviVac;51;16;67;339046;160543;499589
2022.02_01-07-2022;Костромская область;105_165_days;EpiVacCorona;27;17;44;339046;160543;499589
2022.02_01-07-2022;Костромская область;105_165_days;SputnikLite;24458;12213;36671;339046;160543;499589
2022.02_01-07-2022;Костромская область;105_165_days;SputnikV;11751;5476;17227;339046;160543;499589
2022.02_01-07-2022;Костромская область;165_195_days;AllVaccines;39513;8578;48091;339046;160543;499589
2022.02_01-07-2022;Костромская область;165_195_days;CoviVac;427;47;474;339046;160543;499589
2022.02_01-07-2022;Костромская область;165_195_days;EpiVacCorona;2;0;2;339046;160543;499589
2022.02_01-07-2022;Костромская область;165_195_days;SputnikLite;9063;1696;10759;339046;160543;499589
2022.02_01-07-2022;Костромская область;165_195_days;SputnikV;30021;6835;36856;339046;160543;499589
2022.02_01-07-2022;Костромская область;21_45_days;AllVaccines;7565;4463;12028;339046;160543;499589
2022.02_01-07-2022;Костромская область;21_45_days;CoviVac;128;29;157;339046;160543;499589
2022.02_01-07-2022;Костромская область;21_45_days;EpiVacCorona;645;293;938;339046;160543;499589
2022.02_01-07-2022;Костромская область;21_45_days;SputnikLite;4489;3110;7599;339046;160543;499589
2022.02_01-07-2022;Костромская область;21_45_days;SputnikV;2303;1031;3334;339046;160543;499589
2022.02_01-07-2022;Костромская область;45_75_days;AllVaccines;29193;15090;44283;339046;160543;499589
2022.02_01-07-2022;Костромская область;45_75_days;CoviVac;288;81;369;339046;160543;499589
2022.02_01-07-2022;Костромская область;45_75_days;EpiVacCorona;3770;1420;5190;339046;160543;499589
2022.02_01-07-2022;Костромская область;45_75_days;SputnikLite;11826;6500;18326;339046;160543;499589
2022.02_01-07-2022;Костромская область;45_75_days;SputnikV;13309;7089;20398;339046;160543;499589
2022.02_01-07-2022;Костромская область;75_90_days;AllVaccines;17280;10130;27410;339046;160543;499589
2022.02_01-07-2022;Костромская область;75_90_days;CoviVac;358;91;449;339046;160543;499589
2022.02_01-07-2022;Костромская область;75_90_days;EpiVacCorona;1034;466;1500;339046;160543;499589
2022.02_01-07-2022;Костромская область;75_90_days;SputnikLite;8406;5170;13576;339046;160543;499589
2022.02_01-07-2022;Костромская область;75_90_days;SputnikV;7482;4403;11885;339046;160543;499589
2022.02_01-07-2022;Костромская область;90_105_days;AllVaccines;18971;8667;27638;339046;160543;499589
2022.02_01-07-2022;Костромская область;90_105_days;CoviVac;477;145;622;339046;160543;499589
2022.02_01-07-2022;Костромская область;90_105_days;EpiVacCorona;185;125;310;339046;160543;499589
2022.02_01-07-2022;Костромская область;90_105_days;SputnikLite;13157;5095;18252;339046;160543;499589
2022.02_01-07-2022;Костромская область;90_105_days;SputnikV;5152;3302;8454;339046;160543;499589
2022.02_01-07-2022;Краснодарский край;105_165_days;AllVaccines;269425;144511;413936;3157155;1334085;4491240
2022.02_01-07-2022;Краснодарский край;105_165_days;CoviVac;5016;1498;6514;3157155;1334085;4491240
2022.02_01-07-2022;Краснодарский край;105_165_days;EpiVacCorona;5353;2627;7980;3157155;1334085;4491240
2022.02_01-07-2022;Краснодарский край;105_165_days;SputnikLite;42067;56342;98409;3157155;1334085;4491240
2022.02_01-07-2022;Краснодарский край;105_165_days;SputnikV;216989;84044;301033;3157155;1334085;4491240
2022.02_01-07-2022;Краснодарский край;165_195_days;AllVaccines;432731;80278;513009;3157155;1334085;4491240
2022.02_01-07-2022;Краснодарский край;165_195_days;CoviVac;3333;716;4049;3157155;1334085;4491240
2022.02_01-07-2022;Краснодарский край;165_195_days;EpiVacCorona;2023;654;2677;3157155;1334085;4491240
2022.02_01-07-2022;Краснодарский край;165_195_days;SputnikLite;10012;7619;17631;3157155;1334085;4491240
2022.02_01-07-2022;Краснодарский край;165_195_days;SputnikV;417363;71289;488652;3157155;1334085;4491240
2022.02_01-07-2022;Краснодарский край;21_45_days;AllVaccines;115347;62047;177394;3157155;1334085;4491240
2022.02_01-07-2022;Краснодарский край;21_45_days;CoviVac;621;196;817;3157155;1334085;4491240
2022.02_01-07-2022;Краснодарский край;21_45_days;EpiVacCorona;2069;1131;3200;3157155;1334085;4491240
2022.02_01-07-2022;Краснодарский край;21_45_days;SputnikLite;51328;30582;81910;3157155;1334085;4491240
2022.02_01-07-2022;Краснодарский край;21_45_days;SputnikV;61329;30138;91467;3157155;1334085;4491240
2022.02_01-07-2022;Краснодарский край;45_75_days;AllVaccines;325657;152034;477691;3157155;1334085;4491240
2022.02_01-07-2022;Краснодарский край;45_75_days;CoviVac;2010;673;2683;3157155;1334085;4491240
2022.02_01-07-2022;Краснодарский край;45_75_days;EpiVacCorona;5642;2824;8466;3157155;1334085;4491240
2022.02_01-07-2022;Краснодарский край;45_75_days;SputnikLite;50257;45671;95928;3157155;1334085;4491240
2022.02_01-07-2022;Краснодарский край;45_75_days;SputnikV;267748;102866;370614;3157155;1334085;4491240
2022.02_01-07-2022;Краснодарский край;75_90_days;AllVaccines;157321;73143;230464;3157155;1334085;4491240
2022.02_01-07-2022;Краснодарский край;75_90_days;CoviVac;1680;476;2156;3157155;1334085;4491240
2022.02_01-07-2022;Краснодарский край;75_90_days;EpiVacCorona;2787;1555;4342;3157155;1334085;4491240
2022.02_01-07-2022;Краснодарский край;75_90_days;SputnikLite;28173;27233;55406;3157155;1334085;4491240
2022.02_01-07-2022;Краснодарский край;75_90_days;SputnikV;124681;43879;168560;3157155;1334085;4491240
2022.02_01-07-2022;Краснодарский край;90_105_days;AllVaccines;100464;51628;152092;3157155;1334085;4491240
2022.02_01-07-2022;Краснодарский край;90_105_days;CoviVac;2024;654;2678;3157155;1334085;4491240
2022.02_01-07-2022;Краснодарский край;90_105_days;EpiVacCorona;2368;1262;3630;3157155;1334085;4491240
2022.02_01-07-2022;Краснодарский край;90_105_days;SputnikLite;12777;15908;28685;3157155;1334085;4491240
2022.02_01-07-2022;Краснодарский край;90_105_days;SputnikV;83295;33804;117099;3157155;1334085;4491240
2022.02_01-07-2022;Красноярский край;105_165_days;AllVaccines;180120;57318;237438;1637377;585822;2223199
2022.02_01-07-2022;Красноярский край;105_165_days;CoviVac;2403;398;2801;1637377;585822;2223199
2022.02_01-07-2022;Красноярский край;105_165_days;EpiVacCorona;2133;906;3039;1637377;585822;2223199
2022.02_01-07-2022;Красноярский край;105_165_days;SputnikLite;96404;32529;128933;1637377;585822;2223199
2022.02_01-07-2022;Красноярский край;105_165_days;SputnikV;79180;23485;102665;1637377;585822;2223199
2022.02_01-07-2022;Красноярский край;165_195_days;AllVaccines;205552;35665;241217;1637377;585822;2223199
2022.02_01-07-2022;Красноярский край;165_195_days;CoviVac;2177;226;2403;1637377;585822;2223199
2022.02_01-07-2022;Красноярский край;165_195_days;EpiVacCorona;5628;1764;7392;1637377;585822;2223199
2022.02_01-07-2022;Красноярский край;165_195_days;SputnikLite;67417;5926;73343;1637377;585822;2223199
2022.02_01-07-2022;Красноярский край;165_195_days;SputnikV;130330;27749;158079;1637377;585822;2223199
2022.02_01-07-2022;Красноярский край;21_45_days;AllVaccines;71963;30299;102262;1637377;585822;2223199
2022.02_01-07-2022;Красноярский край;21_45_days;CoviVac;594;137;731;1637377;585822;2223199
2022.02_01-07-2022;Красноярский край;21_45_days;EpiVacCorona;2213;1242;3455;1637377;585822;2223199
2022.02_01-07-2022;Красноярский край;21_45_days;SputnikLite;39378;19991;59369;1637377;585822;2223199
2022.02_01-07-2022;Красноярский край;21_45_days;SputnikV;29778;8929;38707;1637377;585822;2223199
2022.02_01-07-2022;Красноярский край;45_75_days;AllVaccines;169837;64784;234621;1637377;585822;2223199
2022.02_01-07-2022;Красноярский край;45_75_days;CoviVac;1811;423;2234;1637377;585822;2223199
2022.02_01-07-2022;Красноярский край;45_75_days;EpiVacCorona;7463;3848;11311;1637377;585822;2223199
2022.02_01-07-2022;Красноярский край;45_75_days;SputnikLite;41856;23387;65243;1637377;585822;2223199
2022.02_01-07-2022;Красноярский край;45_75_days;SputnikV;118707;37126;155833;1637377;585822;2223199
2022.02_01-07-2022;Красноярский край;75_90_days;AllVaccines;82620;35423;118043;1637377;585822;2223199
2022.02_01-07-2022;Красноярский край;75_90_days;CoviVac;1369;349;1718;1637377;585822;2223199
2022.02_01-07-2022;Красноярский край;75_90_days;EpiVacCorona;3726;1893;5619;1637377;585822;2223199
2022.02_01-07-2022;Красноярский край;75_90_days;SputnikLite;26436;15369;41805;1637377;585822;2223199
2022.02_01-07-2022;Красноярский край;75_90_days;SputnikV;51089;17812;68901;1637377;585822;2223199
2022.02_01-07-2022;Красноярский край;90_105_days;AllVaccines;39728;17263;56991;1637377;585822;2223199
2022.02_01-07-2022;Красноярский край;90_105_days;CoviVac;875;171;1046;1637377;585822;2223199
2022.02_01-07-2022;Красноярский край;90_105_days;EpiVacCorona;1433;850;2283;1637377;585822;2223199
2022.02_01-07-2022;Красноярский край;90_105_days;SputnikLite;16115;4764;20879;1637377;585822;2223199
2022.02_01-07-2022;Красноярский край;90_105_days;SputnikV;21305;11478;32783;1637377;585822;2223199
2022.02_01-07-2022;Курганская область;105_165_days;AllVaccines;51212;24786;75998;425081;217502;642583
2022.02_01-07-2022;Курганская область;105_165_days;CoviVac;351;97;448;425081;217502;642583
2022.02_01-07-2022;Курганская область;105_165_days;EpiVacCorona;95;73;168;425081;217502;642583
2022.02_01-07-2022;Курганская область;105_165_days;SputnikLite;30758;17634;48392;425081;217502;642583
2022.02_01-07-2022;Курганская область;105_165_days;SputnikV;20008;6982;26990;425081;217502;642583
2022.02_01-07-2022;Курганская область;165_195_days;AllVaccines;35589;13181;48770;425081;217502;642583
2022.02_01-07-2022;Курганская область;165_195_days;CoviVac;351;80;431;425081;217502;642583
2022.02_01-07-2022;Курганская область;165_195_days;EpiVacCorona;103;47;150;425081;217502;642583
2022.02_01-07-2022;Курганская область;165_195_days;SputnikLite;5482;3517;8999;425081;217502;642583
2022.02_01-07-2022;Курганская область;165_195_days;SputnikV;29653;9537;39190;425081;217502;642583
2022.02_01-07-2022;Курганская область;21_45_days;AllVaccines;20480;12881;33361;425081;217502;642583
2022.02_01-07-2022;Курганская область;21_45_days;CoviVac;129;43;172;425081;217502;642583
2022.02_01-07-2022;Курганская область;21_45_days;EpiVacCorona;1017;754;1771;425081;217502;642583
2022.02_01-07-2022;Курганская область;21_45_days;SputnikLite;13896;9384;23280;425081;217502;642583
2022.02_01-07-2022;Курганская область;21_45_days;SputnikV;5438;2700;8138;425081;217502;642583
2022.02_01-07-2022;Курганская область;45_75_days;AllVaccines;35274;21978;57252;425081;217502;642583
2022.02_01-07-2022;Курганская область;45_75_days;CoviVac;632;229;861;425081;217502;642583
2022.02_01-07-2022;Курганская область;45_75_days;EpiVacCorona;731;473;1204;425081;217502;642583
2022.02_01-07-2022;Курганская область;45_75_days;SputnikLite;10164;10551;20715;425081;217502;642583
2022.02_01-07-2022;Курганская область;45_75_days;SputnikV;23747;10725;34472;425081;217502;642583
2022.02_01-07-2022;Курганская область;75_90_days;AllVaccines;33241;15352;48593;425081;217502;642583
2022.02_01-07-2022;Курганская область;75_90_days;CoviVac;478;134;612;425081;217502;642583
2022.02_01-07-2022;Курганская область;75_90_days;EpiVacCorona;313;148;461;425081;217502;642583
2022.02_01-07-2022;Курганская область;75_90_days;SputnikLite;6108;6824;12932;425081;217502;642583
2022.02_01-07-2022;Курганская область;75_90_days;SputnikV;26342;8246;34588;425081;217502;642583
2022.02_01-07-2022;Курганская область;90_105_days;AllVaccines;38928;15641;54569;425081;217502;642583
2022.02_01-07-2022;Курганская область;90_105_days;CoviVac;680;218;898;425081;217502;642583
2022.02_01-07-2022;Курганская область;90_105_days;EpiVacCorona;455;147;602;425081;217502;642583
2022.02_01-07-2022;Курганская область;90_105_days;SputnikLite;6435;7517;13952;425081;217502;642583
2022.02_01-07-2022;Курганская область;90_105_days;SputnikV;31358;7759;39117;425081;217502;642583
2022.02_01-07-2022;Курская область;105_165_days;AllVaccines;71363;38122;109485;604409;285634;890043
2022.02_01-07-2022;Курская область;105_165_days;CoviVac;798;124;922;604409;285634;890043
2022.02_01-07-2022;Курская область;105_165_days;EpiVacCorona;587;304;891;604409;285634;890043
2022.02_01-07-2022;Курская область;105_165_days;SputnikLite;39090;26444;65534;604409;285634;890043
2022.02_01-07-2022;Курская область;105_165_days;SputnikV;30888;11250;42138;604409;285634;890043
2022.02_01-07-2022;Курская область;165_195_days;AllVaccines;82839;16901;99740;604409;285634;890043
2022.02_01-07-2022;Курская область;165_195_days;CoviVac;566;62;628;604409;285634;890043
2022.02_01-07-2022;Курская область;165_195_days;EpiVacCorona;1040;373;1413;604409;285634;890043
2022.02_01-07-2022;Курская область;165_195_days;SputnikLite;11540;3614;15154;604409;285634;890043
2022.02_01-07-2022;Курская область;165_195_days;SputnikV;69693;12852;82545;604409;285634;890043
2022.02_01-07-2022;Курская область;21_45_days;AllVaccines;22800;10997;33797;604409;285634;890043
2022.02_01-07-2022;Курская область;21_45_days;CoviVac;291;64;355;604409;285634;890043
2022.02_01-07-2022;Курская область;21_45_days;EpiVacCorona;1167;595;1762;604409;285634;890043
2022.02_01-07-2022;Курская область;21_45_days;SputnikLite;16672;8123;24795;604409;285634;890043
2022.02_01-07-2022;Курская область;21_45_days;SputnikV;4670;2215;6885;604409;285634;890043
2022.02_01-07-2022;Курская область;45_75_days;AllVaccines;47415;24446;71861;604409;285634;890043
2022.02_01-07-2022;Курская область;45_75_days;CoviVac;1666;389;2055;604409;285634;890043
2022.02_01-07-2022;Курская область;45_75_days;EpiVacCorona;3311;1605;4916;604409;285634;890043
2022.02_01-07-2022;Курская область;45_75_days;SputnikLite;15273;9199;24472;604409;285634;890043
2022.02_01-07-2022;Курская область;45_75_days;SputnikV;27165;13253;40418;604409;285634;890043
2022.02_01-07-2022;Курская область;75_90_days;AllVaccines;28947;16178;45125;604409;285634;890043
2022.02_01-07-2022;Курская область;75_90_days;CoviVac;217;41;258;604409;285634;890043
2022.02_01-07-2022;Курская область;75_90_days;EpiVacCorona;1004;524;1528;604409;285634;890043
2022.02_01-07-2022;Курская область;75_90_days;SputnikLite;10631;7487;18118;604409;285634;890043
2022.02_01-07-2022;Курская область;75_90_days;SputnikV;17095;8126;25221;604409;285634;890043
2022.02_01-07-2022;Курская область;90_105_days;AllVaccines;34095;19366;53461;604409;285634;890043
2022.02_01-07-2022;Курская область;90_105_days;CoviVac;594;133;727;604409;285634;890043
2022.02_01-07-2022;Курская область;90_105_days;EpiVacCorona;1461;614;2075;604409;285634;890043
2022.02_01-07-2022;Курская область;90_105_days;SputnikLite;12884;11203;24087;604409;285634;890043
2022.02_01-07-2022;Курская область;90_105_days;SputnikV;19156;7416;26572;604409;285634;890043
2022.02_01-07-2022;Ленинградская область;105_165_days;AllVaccines;107545;45554;153099;1100343;462742;1563085
2022.02_01-07-2022;Ленинградская область;105_165_days;CoviVac;2361;327;2688;1100343;462742;1563085
2022.02_01-07-2022;Ленинградская область;105_165_days;EpiVacCorona;208;105;313;1100343;462742;1563085
2022.02_01-07-2022;Ленинградская область;105_165_days;SputnikLite;55364;25651;81015;1100343;462742;1563085
2022.02_01-07-2022;Ленинградская область;105_165_days;SputnikV;49612;19471;69083;1100343;462742;1563085
2022.02_01-07-2022;Ленинградская область;165_195_days;AllVaccines;114197;26729;140926;1100343;462742;1563085
2022.02_01-07-2022;Ленинградская область;165_195_days;CoviVac;2599;236;2835;1100343;462742;1563085
2022.02_01-07-2022;Ленинградская область;165_195_days;EpiVacCorona;942;293;1235;1100343;462742;1563085
2022.02_01-07-2022;Ленинградская область;165_195_days;SputnikLite;20032;3099;23131;1100343;462742;1563085
2022.02_01-07-2022;Ленинградская область;165_195_days;SputnikV;90624;23101;113725;1100343;462742;1563085
2022.02_01-07-2022;Ленинградская область;21_45_days;AllVaccines;32174;18040;50214;1100343;462742;1563085
2022.02_01-07-2022;Ленинградская область;21_45_days;CoviVac;339;72;411;1100343;462742;1563085
2022.02_01-07-2022;Ленинградская область;21_45_days;EpiVacCorona;785;484;1269;1100343;462742;1563085
2022.02_01-07-2022;Ленинградская область;21_45_days;SputnikLite;14964;11466;26430;1100343;462742;1563085
2022.02_01-07-2022;Ленинградская область;21_45_days;SputnikV;16086;6018;22104;1100343;462742;1563085
2022.02_01-07-2022;Ленинградская область;45_75_days;AllVaccines;93119;47515;140634;1100343;462742;1563085
2022.02_01-07-2022;Ленинградская область;45_75_days;CoviVac;1057;140;1197;1100343;462742;1563085
2022.02_01-07-2022;Ленинградская область;45_75_days;EpiVacCorona;2256;1363;3619;1100343;462742;1563085
2022.02_01-07-2022;Ленинградская область;45_75_days;SputnikLite;19889;16888;36777;1100343;462742;1563085
2022.02_01-07-2022;Ленинградская область;45_75_days;SputnikV;69917;29124;99041;1100343;462742;1563085
2022.02_01-07-2022;Ленинградская область;75_90_days;AllVaccines;57830;28118;85948;1100343;462742;1563085
2022.02_01-07-2022;Ленинградская область;75_90_days;CoviVac;647;112;759;1100343;462742;1563085
2022.02_01-07-2022;Ленинградская область;75_90_days;EpiVacCorona;1438;611;2049;1100343;462742;1563085
2022.02_01-07-2022;Ленинградская область;75_90_days;SputnikLite;16601;12538;29139;1100343;462742;1563085
2022.02_01-07-2022;Ленинградская область;75_90_days;SputnikV;39144;14857;54001;1100343;462742;1563085
2022.02_01-07-2022;Ленинградская область;90_105_days;AllVaccines;31619;14900;46519;1100343;462742;1563085
2022.02_01-07-2022;Ленинградская область;90_105_days;CoviVac;686;97;783;1100343;462742;1563085
2022.02_01-07-2022;Ленинградская область;90_105_days;EpiVacCorona;660;343;1003;1100343;462742;1563085
2022.02_01-07-2022;Ленинградская область;90_105_days;SputnikLite;9482;4769;14251;1100343;462742;1563085
2022.02_01-07-2022;Ленинградская область;90_105_days;SputnikV;20791;9691;30482;1100343;462742;1563085
2022.02_01-07-2022;Липецкая область;105_165_days;AllVaccines;67036;32028;99064;621641;290878;912519
2022.02_01-07-2022;Липецкая область;105_165_days;CoviVac;1310;107;1417;621641;290878;912519
2022.02_01-07-2022;Липецкая область;105_165_days;EpiVacCorona;720;249;969;621641;290878;912519
2022.02_01-07-2022;Липецкая область;105_165_days;SputnikLite;28099;21414;49513;621641;290878;912519
2022.02_01-07-2022;Липецкая область;105_165_days;SputnikV;36907;10258;47165;621641;290878;912519
2022.02_01-07-2022;Липецкая область;165_195_days;AllVaccines;73425;12418;85843;621641;290878;912519
2022.02_01-07-2022;Липецкая область;165_195_days;CoviVac;1069;42;1111;621641;290878;912519
2022.02_01-07-2022;Липецкая область;165_195_days;EpiVacCorona;658;283;941;621641;290878;912519
2022.02_01-07-2022;Липецкая область;165_195_days;SputnikLite;5301;2155;7456;621641;290878;912519
2022.02_01-07-2022;Липецкая область;165_195_days;SputnikV;66397;9938;76335;621641;290878;912519
2022.02_01-07-2022;Липецкая область;21_45_days;AllVaccines;19002;9597;28599;621641;290878;912519
2022.02_01-07-2022;Липецкая область;21_45_days;CoviVac;105;16;121;621641;290878;912519
2022.02_01-07-2022;Липецкая область;21_45_days;EpiVacCorona;2057;712;2769;621641;290878;912519
2022.02_01-07-2022;Липецкая область;21_45_days;SputnikLite;10594;6928;17522;621641;290878;912519
2022.02_01-07-2022;Липецкая область;21_45_days;SputnikV;6246;1941;8187;621641;290878;912519
2022.02_01-07-2022;Липецкая область;45_75_days;AllVaccines;54155;23296;77451;621641;290878;912519
2022.02_01-07-2022;Липецкая область;45_75_days;CoviVac;393;46;439;621641;290878;912519
2022.02_01-07-2022;Липецкая область;45_75_days;EpiVacCorona;3499;1217;4716;621641;290878;912519
2022.02_01-07-2022;Липецкая область;45_75_days;SputnikLite;10622;9677;20299;621641;290878;912519
2022.02_01-07-2022;Липецкая область;45_75_days;SputnikV;39641;12356;51997;621641;290878;912519
2022.02_01-07-2022;Липецкая область;75_90_days;AllVaccines;55895;19118;75013;621641;290878;912519
2022.02_01-07-2022;Липецкая область;75_90_days;CoviVac;77;17;94;621641;290878;912519
2022.02_01-07-2022;Липецкая область;75_90_days;EpiVacCorona;2345;456;2801;621641;290878;912519
2022.02_01-07-2022;Липецкая область;75_90_days;SputnikLite;10418;9062;19480;621641;290878;912519
2022.02_01-07-2022;Липецкая область;75_90_days;SputnikV;43055;9583;52638;621641;290878;912519
2022.02_01-07-2022;Липецкая область;90_105_days;AllVaccines;49054;17584;66638;621641;290878;912519
2022.02_01-07-2022;Липецкая область;90_105_days;CoviVac;179;23;202;621641;290878;912519
2022.02_01-07-2022;Липецкая область;90_105_days;EpiVacCorona;2164;342;2506;621641;290878;912519
2022.02_01-07-2022;Липецкая область;90_105_days;SputnikLite;12446;10325;22771;621641;290878;912519
2022.02_01-07-2022;Липецкая область;90_105_days;SputnikV;34265;6894;41159;621641;290878;912519
2022.02_01-07-2022;Магаданская область;105_165_days;AllVaccines;9800;2720;12520;83196;26810;110006
2022.02_01-07-2022;Магаданская область;105_165_days;CoviVac;98;23;121;83196;26810;110006
2022.02_01-07-2022;Магаданская область;105_165_days;EpiVacCorona;1;1;2;83196;26810;110006
2022.02_01-07-2022;Магаданская область;105_165_days;SputnikLite;6483;1909;8392;83196;26810;110006
2022.02_01-07-2022;Магаданская область;105_165_days;SputnikV;3218;787;4005;83196;26810;110006
2022.02_01-07-2022;Магаданская область;165_195_days;AllVaccines;8615;1285;9900;83196;26810;110006
2022.02_01-07-2022;Магаданская область;165_195_days;CoviVac;128;28;156;83196;26810;110006
2022.02_01-07-2022;Магаданская область;165_195_days;EpiVacCorona;1;0;1;83196;26810;110006
2022.02_01-07-2022;Магаданская область;165_195_days;SputnikLite;3054;303;3357;83196;26810;110006
2022.02_01-07-2022;Магаданская область;165_195_days;SputnikV;5432;954;6386;83196;26810;110006
2022.02_01-07-2022;Магаданская область;21_45_days;AllVaccines;4100;1226;5326;83196;26810;110006
2022.02_01-07-2022;Магаданская область;21_45_days;CoviVac;94;16;110;83196;26810;110006
2022.02_01-07-2022;Магаданская область;21_45_days;EpiVacCorona;202;43;245;83196;26810;110006
2022.02_01-07-2022;Магаданская область;21_45_days;SputnikLite;2772;948;3720;83196;26810;110006
2022.02_01-07-2022;Магаданская область;21_45_days;SputnikV;1032;219;1251;83196;26810;110006
2022.02_01-07-2022;Магаданская область;45_75_days;AllVaccines;8213;2070;10283;83196;26810;110006
2022.02_01-07-2022;Магаданская область;45_75_days;CoviVac;79;9;88;83196;26810;110006
2022.02_01-07-2022;Магаданская область;45_75_days;EpiVacCorona;948;113;1061;83196;26810;110006
2022.02_01-07-2022;Магаданская область;45_75_days;SputnikLite;3498;1202;4700;83196;26810;110006
2022.02_01-07-2022;Магаданская область;45_75_days;SputnikV;3688;746;4434;83196;26810;110006
2022.02_01-07-2022;Магаданская область;75_90_days;AllVaccines;3950;1327;5277;83196;26810;110006
2022.02_01-07-2022;Магаданская область;75_90_days;CoviVac;18;7;25;83196;26810;110006
2022.02_01-07-2022;Магаданская область;75_90_days;EpiVacCorona;480;68;548;83196;26810;110006
2022.02_01-07-2022;Магаданская область;75_90_days;SputnikLite;2024;926;2950;83196;26810;110006
2022.02_01-07-2022;Магаданская область;75_90_days;SputnikV;1428;326;1754;83196;26810;110006
2022.02_01-07-2022;Магаданская область;90_105_days;AllVaccines;2862;1093;3955;83196;26810;110006
2022.02_01-07-2022;Магаданская область;90_105_days;CoviVac;143;38;181;83196;26810;110006
2022.02_01-07-2022;Магаданская область;90_105_days;EpiVacCorona;9;2;11;83196;26810;110006
2022.02_01-07-2022;Магаданская область;90_105_days;SputnikLite;2056;852;2908;83196;26810;110006
2022.02_01-07-2022;Магаданская область;90_105_days;SputnikV;654;201;855;83196;26810;110006
2022.02_01-07-2022;Московская область;105_165_days;AllVaccines;373619;168542;542161;4485323;1674471;6159794
2022.02_01-07-2022;Московская область;105_165_days;CoviVac;5998;2008;8006;4485323;1674471;6159794
2022.02_01-07-2022;Московская область;105_165_days;EpiVacCorona;3779;2415;6194;4485323;1674471;6159794
2022.02_01-07-2022;Московская область;105_165_days;SputnikLite;97288;93671;190959;4485323;1674471;6159794
2022.02_01-07-2022;Московская область;105_165_days;SputnikV;266554;70448;337002;4485323;1674471;6159794
2022.02_01-07-2022;Московская область;165_195_days;AllVaccines;622630;115298;737928;4485323;1674471;6159794
2022.02_01-07-2022;Московская область;165_195_days;CoviVac;7206;1676;8882;4485323;1674471;6159794
2022.02_01-07-2022;Московская область;165_195_days;EpiVacCorona;3826;1789;5615;4485323;1674471;6159794
2022.02_01-07-2022;Московская область;165_195_days;SputnikLite;20078;10213;30291;4485323;1674471;6159794
2022.02_01-07-2022;Московская область;165_195_days;SputnikV;591520;101620;693140;4485323;1674471;6159794
2022.02_01-07-2022;Московская область;21_45_days;AllVaccines;139394;65399;204793;4485323;1674471;6159794
2022.02_01-07-2022;Московская область;21_45_days;CoviVac;557;223;780;4485323;1674471;6159794
2022.02_01-07-2022;Московская область;21_45_days;EpiVacCorona;1355;1182;2537;4485323;1674471;6159794
2022.02_01-07-2022;Московская область;21_45_days;SputnikLite;79385;44898;124283;4485323;1674471;6159794
2022.02_01-07-2022;Московская область;21_45_days;SputnikV;58097;19096;77193;4485323;1674471;6159794
2022.02_01-07-2022;Московская область;45_75_days;AllVaccines;276323;133215;409538;4485323;1674471;6159794
2022.02_01-07-2022;Московская область;45_75_days;CoviVac;3761;1443;5204;4485323;1674471;6159794
2022.02_01-07-2022;Московская область;45_75_days;EpiVacCorona;4702;3762;8464;4485323;1674471;6159794
2022.02_01-07-2022;Московская область;45_75_days;SputnikLite;54714;46479;101193;4485323;1674471;6159794
2022.02_01-07-2022;Московская область;45_75_days;SputnikV;213146;81531;294677;4485323;1674471;6159794
2022.02_01-07-2022;Московская область;75_90_days;AllVaccines;174858;86818;261676;4485323;1674471;6159794
2022.02_01-07-2022;Московская область;75_90_days;CoviVac;1738;693;2431;4485323;1674471;6159794
2022.02_01-07-2022;Московская область;75_90_days;EpiVacCorona;3354;2609;5963;4485323;1674471;6159794
2022.02_01-07-2022;Московская область;75_90_days;SputnikLite;35105;31045;66150;4485323;1674471;6159794
2022.02_01-07-2022;Московская область;75_90_days;SputnikV;134661;52471;187132;4485323;1674471;6159794
2022.02_01-07-2022;Московская область;90_105_days;AllVaccines;148251;81340;229591;4485323;1674471;6159794
2022.02_01-07-2022;Московская область;90_105_days;CoviVac;2031;962;2993;4485323;1674471;6159794
2022.02_01-07-2022;Московская область;90_105_days;EpiVacCorona;2001;1846;3847;4485323;1674471;6159794
2022.02_01-07-2022;Московская область;90_105_days;SputnikLite;36608;33830;70438;4485323;1674471;6159794
2022.02_01-07-2022;Московская область;90_105_days;SputnikV;107611;44702;152313;4485323;1674471;6159794
2022.02_01-07-2022;Мурманская область;105_165_days;AllVaccines;53249;14475;67724;436555;144366;580921
2022.02_01-07-2022;Мурманская область;105_165_days;CoviVac;150;18;168;436555;144366;580921
2022.02_01-07-2022;Мурманская область;105_165_days;EpiVacCorona;450;128;578;436555;144366;580921
2022.02_01-07-2022;Мурманская область;105_165_days;SputnikLite;27894;9192;37086;436555;144366;580921
2022.02_01-07-2022;Мурманская область;105_165_days;SputnikV;24755;5137;29892;436555;144366;580921
2022.02_01-07-2022;Мурманская область;165_195_days;AllVaccines;57818;7919;65737;436555;144366;580921
2022.02_01-07-2022;Мурманская область;165_195_days;CoviVac;638;64;702;436555;144366;580921
2022.02_01-07-2022;Мурманская область;165_195_days;EpiVacCorona;347;76;423;436555;144366;580921
2022.02_01-07-2022;Мурманская область;165_195_days;SputnikLite;19964;1512;21476;436555;144366;580921
2022.02_01-07-2022;Мурманская область;165_195_days;SputnikV;36869;6267;43136;436555;144366;580921
2022.02_01-07-2022;Мурманская область;21_45_days;AllVaccines;15601;5942;21543;436555;144366;580921
2022.02_01-07-2022;Мурманская область;21_45_days;CoviVac;185;27;212;436555;144366;580921
2022.02_01-07-2022;Мурманская область;21_45_days;EpiVacCorona;411;166;577;436555;144366;580921
2022.02_01-07-2022;Мурманская область;21_45_days;SputnikLite;8514;4009;12523;436555;144366;580921
2022.02_01-07-2022;Мурманская область;21_45_days;SputnikV;6491;1740;8231;436555;144366;580921
2022.02_01-07-2022;Мурманская область;45_75_days;AllVaccines;44274;14216;58490;436555;144366;580921
2022.02_01-07-2022;Мурманская область;45_75_days;CoviVac;813;83;896;436555;144366;580921
2022.02_01-07-2022;Мурманская область;45_75_days;EpiVacCorona;2075;619;2694;436555;144366;580921
2022.02_01-07-2022;Мурманская область;45_75_days;SputnikLite;16594;6669;23263;436555;144366;580921
2022.02_01-07-2022;Мурманская область;45_75_days;SputnikV;24792;6845;31637;436555;144366;580921
2022.02_01-07-2022;Мурманская область;75_90_days;AllVaccines;19541;7320;26861;436555;144366;580921
2022.02_01-07-2022;Мурманская область;75_90_days;CoviVac;309;47;356;436555;144366;580921
2022.02_01-07-2022;Мурманская область;75_90_days;EpiVacCorona;617;283;900;436555;144366;580921
2022.02_01-07-2022;Мурманская область;75_90_days;SputnikLite;11321;4289;15610;436555;144366;580921
2022.02_01-07-2022;Мурманская область;75_90_days;SputnikV;7294;2701;9995;436555;144366;580921
2022.02_01-07-2022;Мурманская область;90_105_days;AllVaccines;19314;6865;26179;436555;144366;580921
2022.02_01-07-2022;Мурманская область;90_105_days;CoviVac;300;44;344;436555;144366;580921
2022.02_01-07-2022;Мурманская область;90_105_days;EpiVacCorona;314;211;525;436555;144366;580921
2022.02_01-07-2022;Мурманская область;90_105_days;SputnikLite;13193;4560;17753;436555;144366;580921
2022.02_01-07-2022;Мурманская область;90_105_days;SputnikV;5507;2050;7557;436555;144366;580921
2022.02_01-07-2022;Ненецкий автономный округ;105_165_days;AllVaccines;2053;878;2931;24931;7449;32380
2022.02_01-07-2022;Ненецкий автономный округ;105_165_days;CoviVac;94;5;99;24931;7449;32380
2022.02_01-07-2022;Ненецкий автономный округ;105_165_days;EpiVacCorona;19;10;29;24931;7449;32380
2022.02_01-07-2022;Ненецкий автономный округ;105_165_days;SputnikLite;1721;813;2534;24931;7449;32380
2022.02_01-07-2022;Ненецкий автономный округ;105_165_days;SputnikV;219;50;269;24931;7449;32380
2022.02_01-07-2022;Ненецкий автономный округ;165_195_days;AllVaccines;1527;304;1831;24931;7449;32380
2022.02_01-07-2022;Ненецкий автономный округ;165_195_days;CoviVac;89;17;106;24931;7449;32380
2022.02_01-07-2022;Ненецкий автономный округ;165_195_days;EpiVacCorona;610;86;696;24931;7449;32380
2022.02_01-07-2022;Ненецкий автономный округ;165_195_days;SputnikLite;474;135;609;24931;7449;32380
2022.02_01-07-2022;Ненецкий автономный округ;165_195_days;SputnikV;354;66;420;24931;7449;32380
2022.02_01-07-2022;Ненецкий автономный округ;21_45_days;AllVaccines;782;244;1026;24931;7449;32380
2022.02_01-07-2022;Ненецкий автономный округ;21_45_days;EpiVacCorona;13;2;15;24931;7449;32380
2022.02_01-07-2022;Ненецкий автономный округ;21_45_days;SputnikLite;659;232;891;24931;7449;32380
2022.02_01-07-2022;Ненецкий автономный округ;21_45_days;SputnikV;110;10;120;24931;7449;32380
2022.02_01-07-2022;Ненецкий автономный округ;45_75_days;AllVaccines;1662;569;2231;24931;7449;32380
2022.02_01-07-2022;Ненецкий автономный округ;45_75_days;EpiVacCorona;81;12;93;24931;7449;32380
2022.02_01-07-2022;Ненецкий автономный округ;45_75_days;SputnikLite;1149;484;1633;24931;7449;32380
2022.02_01-07-2022;Ненецкий автономный округ;45_75_days;SputnikV;432;73;505;24931;7449;32380
2022.02_01-07-2022;Ненецкий автономный округ;75_90_days;AllVaccines;1488;431;1919;24931;7449;32380
2022.02_01-07-2022;Ненецкий автономный округ;75_90_days;EpiVacCorona;31;2;33;24931;7449;32380
2022.02_01-07-2022;Ненецкий автономный округ;75_90_days;SputnikLite;1205;381;1586;24931;7449;32380
2022.02_01-07-2022;Ненецкий автономный округ;75_90_days;SputnikV;252;48;300;24931;7449;32380
2022.02_01-07-2022;Ненецкий автономный округ;90_105_days;AllVaccines;1114;413;1527;24931;7449;32380
2022.02_01-07-2022;Ненецкий автономный округ;90_105_days;CoviVac;3;0;3;24931;7449;32380
2022.02_01-07-2022;Ненецкий автономный округ;90_105_days;EpiVacCorona;18;3;21;24931;7449;32380
2022.02_01-07-2022;Ненецкий автономный округ;90_105_days;SputnikLite;966;377;1343;24931;7449;32380
2022.02_01-07-2022;Ненецкий автономный округ;90_105_days;SputnikV;127;33;160;24931;7449;32380
2022.02_01-07-2022;Нижегородская область;105_165_days;AllVaccines;190778;85696;276474;1769909;800663;2570572
2022.02_01-07-2022;Нижегородская область;105_165_days;CoviVac;3919;713;4632;1769909;800663;2570572
2022.02_01-07-2022;Нижегородская область;105_165_days;EpiVacCorona;1659;1146;2805;1769909;800663;2570572
2022.02_01-07-2022;Нижегородская область;105_165_days;SputnikLite;118637;54229;172866;1769909;800663;2570572
2022.02_01-07-2022;Нижегородская область;105_165_days;SputnikV;66563;29608;96171;1769909;800663;2570572
2022.02_01-07-2022;Нижегородская область;165_195_days;AllVaccines;196622;34864;231486;1769909;800663;2570572
2022.02_01-07-2022;Нижегородская область;165_195_days;CoviVac;2726;308;3034;1769909;800663;2570572
2022.02_01-07-2022;Нижегородская область;165_195_days;EpiVacCorona;6687;2198;8885;1769909;800663;2570572
2022.02_01-07-2022;Нижегородская область;165_195_days;SputnikLite;60985;8612;69597;1769909;800663;2570572
2022.02_01-07-2022;Нижегородская область;165_195_days;SputnikV;126224;23746;149970;1769909;800663;2570572
2022.02_01-07-2022;Нижегородская область;21_45_days;AllVaccines;50539;31820;82359;1769909;800663;2570572
2022.02_01-07-2022;Нижегородская область;21_45_days;CoviVac;392;123;515;1769909;800663;2570572
2022.02_01-07-2022;Нижегородская область;21_45_days;EpiVacCorona;1806;1553;3359;1769909;800663;2570572
2022.02_01-07-2022;Нижегородская область;21_45_days;SputnikLite;32286;21455;53741;1769909;800663;2570572
2022.02_01-07-2022;Нижегородская область;21_45_days;SputnikV;16055;8689;24744;1769909;800663;2570572
2022.02_01-07-2022;Нижегородская область;45_75_days;AllVaccines;136380;84890;221270;1769909;800663;2570572
2022.02_01-07-2022;Нижегородская область;45_75_days;CoviVac;376;86;462;1769909;800663;2570572
2022.02_01-07-2022;Нижегородская область;45_75_days;EpiVacCorona;3419;2674;6093;1769909;800663;2570572
2022.02_01-07-2022;Нижегородская область;45_75_days;SputnikLite;39702;33925;73627;1769909;800663;2570572
2022.02_01-07-2022;Нижегородская область;45_75_days;SputnikV;92883;48205;141088;1769909;800663;2570572
2022.02_01-07-2022;Нижегородская область;75_90_days;AllVaccines;109248;61845;171093;1769909;800663;2570572
2022.02_01-07-2022;Нижегородская область;75_90_days;CoviVac;490;98;588;1769909;800663;2570572
2022.02_01-07-2022;Нижегородская область;75_90_days;EpiVacCorona;2147;1189;3336;1769909;800663;2570572
2022.02_01-07-2022;Нижегородская область;75_90_days;SputnikLite;31719;29875;61594;1769909;800663;2570572
2022.02_01-07-2022;Нижегородская область;75_90_days;SputnikV;74892;30683;105575;1769909;800663;2570572
2022.02_01-07-2022;Нижегородская область;90_105_days;AllVaccines;62078;30498;92576;1769909;800663;2570572
2022.02_01-07-2022;Нижегородская область;90_105_days;CoviVac;517;94;611;1769909;800663;2570572
2022.02_01-07-2022;Нижегородская область;90_105_days;EpiVacCorona;1365;714;2079;1769909;800663;2570572
2022.02_01-07-2022;Нижегородская область;90_105_days;SputnikLite;14733;10914;25647;1769909;800663;2570572
2022.02_01-07-2022;Нижегородская область;90_105_days;SputnikV;45463;18776;64239;1769909;800663;2570572
2022.02_01-07-2022;Новгородская область;105_165_days;AllVaccines;36420;17049;53469;317276;158308;475584
2022.02_01-07-2022;Новгородская область;105_165_days;CoviVac;71;22;93;317276;158308;475584
2022.02_01-07-2022;Новгородская область;105_165_days;EpiVacCorona;154;89;243;317276;158308;475584
2022.02_01-07-2022;Новгородская область;105_165_days;SputnikLite;29791;13376;43167;317276;158308;475584
2022.02_01-07-2022;Новгородская область;105_165_days;SputnikV;6404;3562;9966;317276;158308;475584
2022.02_01-07-2022;Новгородская область;165_195_days;AllVaccines;34728;7934;42662;317276;158308;475584
2022.02_01-07-2022;Новгородская область;165_195_days;CoviVac;195;33;228;317276;158308;475584
2022.02_01-07-2022;Новгородская область;165_195_days;EpiVacCorona;325;95;420;317276;158308;475584
2022.02_01-07-2022;Новгородская область;165_195_days;SputnikLite;14100;1714;15814;317276;158308;475584
2022.02_01-07-2022;Новгородская область;165_195_days;SputnikV;20108;6092;26200;317276;158308;475584
2022.02_01-07-2022;Новгородская область;21_45_days;AllVaccines;8131;6178;14309;317276;158308;475584
2022.02_01-07-2022;Новгородская область;21_45_days;CoviVac;230;96;326;317276;158308;475584
2022.02_01-07-2022;Новгородская область;21_45_days;EpiVacCorona;624;353;977;317276;158308;475584
2022.02_01-07-2022;Новгородская область;21_45_days;SputnikLite;4106;3471;7577;317276;158308;475584
2022.02_01-07-2022;Новгородская область;21_45_days;SputnikV;3171;2258;5429;317276;158308;475584
2022.02_01-07-2022;Новгородская область;45_75_days;AllVaccines;21594;13881;35475;317276;158308;475584
2022.02_01-07-2022;Новгородская область;45_75_days;CoviVac;893;310;1203;317276;158308;475584
2022.02_01-07-2022;Новгородская область;45_75_days;EpiVacCorona;1943;1104;3047;317276;158308;475584
2022.02_01-07-2022;Новгородская область;45_75_days;SputnikLite;4833;4680;9513;317276;158308;475584
2022.02_01-07-2022;Новгородская область;45_75_days;SputnikV;13925;7787;21712;317276;158308;475584
2022.02_01-07-2022;Новгородская область;75_90_days;AllVaccines;14886;9580;24466;317276;158308;475584
2022.02_01-07-2022;Новгородская область;75_90_days;CoviVac;104;40;144;317276;158308;475584
2022.02_01-07-2022;Новгородская область;75_90_days;EpiVacCorona;663;263;926;317276;158308;475584
2022.02_01-07-2022;Новгородская область;75_90_days;SputnikLite;5252;5039;10291;317276;158308;475584
2022.02_01-07-2022;Новгородская область;75_90_days;SputnikV;8867;4238;13105;317276;158308;475584
2022.02_01-07-2022;Новгородская область;90_105_days;AllVaccines;10516;6451;16967;317276;158308;475584
2022.02_01-07-2022;Новгородская область;90_105_days;CoviVac;251;65;316;317276;158308;475584
2022.02_01-07-2022;Новгородская область;90_105_days;EpiVacCorona;280;116;396;317276;158308;475584
2022.02_01-07-2022;Новгородская область;90_105_days;SputnikLite;5807;3771;9578;317276;158308;475584
2022.02_01-07-2022;Новгородская область;90_105_days;SputnikV;4178;2499;6677;317276;158308;475584
2022.02_01-07-2022;Новосибирская область;105_165_days;AllVaccines;131808;58123;189931;1571829;624100;2195929
2022.02_01-07-2022;Новосибирская область;105_165_days;CoviVac;2996;608;3604;1571829;624100;2195929
2022.02_01-07-2022;Новосибирская область;105_165_days;EpiVacCorona;1951;1218;3169;1571829;624100;2195929
2022.02_01-07-2022;Новосибирская область;105_165_days;SputnikLite;77236;35814;113050;1571829;624100;2195929
2022.02_01-07-2022;Новосибирская область;105_165_days;SputnikV;49625;20483;70108;1571829;624100;2195929
2022.02_01-07-2022;Новосибирская область;165_195_days;AllVaccines;100201;25971;126172;1571829;624100;2195929
2022.02_01-07-2022;Новосибирская область;165_195_days;CoviVac;1355;183;1538;1571829;624100;2195929
2022.02_01-07-2022;Новосибирская область;165_195_days;EpiVacCorona;4268;2253;6521;1571829;624100;2195929
2022.02_01-07-2022;Новосибирская область;165_195_days;SputnikLite;28124;3972;32096;1571829;624100;2195929
2022.02_01-07-2022;Новосибирская область;165_195_days;SputnikV;66454;19563;86017;1571829;624100;2195929
2022.02_01-07-2022;Новосибирская область;21_45_days;AllVaccines;65242;37423;102665;1571829;624100;2195929
2022.02_01-07-2022;Новосибирская область;21_45_days;CoviVac;596;179;775;1571829;624100;2195929
2022.02_01-07-2022;Новосибирская область;21_45_days;EpiVacCorona;1359;875;2234;1571829;624100;2195929
2022.02_01-07-2022;Новосибирская область;21_45_days;SputnikLite;37025;27389;64414;1571829;624100;2195929
2022.02_01-07-2022;Новосибирская область;21_45_days;SputnikV;26262;8980;35242;1571829;624100;2195929
2022.02_01-07-2022;Новосибирская область;45_75_days;AllVaccines;202533;81627;284160;1571829;624100;2195929
2022.02_01-07-2022;Новосибирская область;45_75_days;CoviVac;474;110;584;1571829;624100;2195929
2022.02_01-07-2022;Новосибирская область;45_75_days;EpiVacCorona;4803;1856;6659;1571829;624100;2195929
2022.02_01-07-2022;Новосибирская область;45_75_days;SputnikLite;43067;35186;78253;1571829;624100;2195929
2022.02_01-07-2022;Новосибирская область;45_75_days;SputnikV;154189;44475;198664;1571829;624100;2195929
2022.02_01-07-2022;Новосибирская область;75_90_days;AllVaccines;92822;38352;131174;1571829;624100;2195929
2022.02_01-07-2022;Новосибирская область;75_90_days;CoviVac;269;36;305;1571829;624100;2195929
2022.02_01-07-2022;Новосибирская область;75_90_days;EpiVacCorona;3122;1009;4131;1571829;624100;2195929
2022.02_01-07-2022;Новосибирская область;75_90_days;SputnikLite;20351;15936;36287;1571829;624100;2195929
2022.02_01-07-2022;Новосибирская область;75_90_days;SputnikV;69080;21371;90451;1571829;624100;2195929
2022.02_01-07-2022;Новосибирская область;90_105_days;AllVaccines;55003;17906;72909;1571829;624100;2195929
2022.02_01-07-2022;Новосибирская область;90_105_days;CoviVac;817;97;914;1571829;624100;2195929
2022.02_01-07-2022;Новосибирская область;90_105_days;EpiVacCorona;1720;520;2240;1571829;624100;2195929
2022.02_01-07-2022;Новосибирская область;90_105_days;SputnikLite;8297;4272;12569;1571829;624100;2195929
2022.02_01-07-2022;Новосибирская область;90_105_days;SputnikV;44169;13017;57186;1571829;624100;2195929
2022.02_01-07-2022;Омская область;105_165_days;AllVaccines;91649;35177;126826;1058291;431046;1489337
2022.02_01-07-2022;Омская область;105_165_days;CoviVac;1136;317;1453;1058291;431046;1489337
2022.02_01-07-2022;Омская область;105_165_days;EpiVacCorona;1094;593;1687;1058291;431046;1489337
2022.02_01-07-2022;Омская область;105_165_days;SputnikLite;40884;20456;61340;1058291;431046;1489337
2022.02_01-07-2022;Омская область;105_165_days;SputnikV;48535;13811;62346;1058291;431046;1489337
2022.02_01-07-2022;Омская область;165_195_days;AllVaccines;143703;21969;165672;1058291;431046;1489337
2022.02_01-07-2022;Омская область;165_195_days;CoviVac;1819;257;2076;1058291;431046;1489337
2022.02_01-07-2022;Омская область;165_195_days;EpiVacCorona;2715;669;3384;1058291;431046;1489337
2022.02_01-07-2022;Омская область;165_195_days;SputnikLite;24134;2857;26991;1058291;431046;1489337
2022.02_01-07-2022;Омская область;165_195_days;SputnikV;115035;18186;133221;1058291;431046;1489337
2022.02_01-07-2022;Омская область;21_45_days;AllVaccines;40447;19395;59842;1058291;431046;1489337
2022.02_01-07-2022;Омская область;21_45_days;CoviVac;404;100;504;1058291;431046;1489337
2022.02_01-07-2022;Омская область;21_45_days;EpiVacCorona;1409;558;1967;1058291;431046;1489337
2022.02_01-07-2022;Омская область;21_45_days;SputnikLite;20041;11352;31393;1058291;431046;1489337
2022.02_01-07-2022;Омская область;21_45_days;SputnikV;18593;7385;25978;1058291;431046;1489337
2022.02_01-07-2022;Омская область;45_75_days;AllVaccines;117391;49101;166492;1058291;431046;1489337
2022.02_01-07-2022;Омская область;45_75_days;CoviVac;688;159;847;1058291;431046;1489337
2022.02_01-07-2022;Омская область;45_75_days;EpiVacCorona;3159;1156;4315;1058291;431046;1489337
2022.02_01-07-2022;Омская область;45_75_days;SputnikLite;24117;15429;39546;1058291;431046;1489337
2022.02_01-07-2022;Омская область;45_75_days;SputnikV;89427;32357;121784;1058291;431046;1489337
2022.02_01-07-2022;Омская область;75_90_days;AllVaccines;68161;25697;93858;1058291;431046;1489337
2022.02_01-07-2022;Омская область;75_90_days;CoviVac;378;74;452;1058291;431046;1489337
2022.02_01-07-2022;Омская область;75_90_days;EpiVacCorona;2204;625;2829;1058291;431046;1489337
2022.02_01-07-2022;Омская область;75_90_days;SputnikLite;8909;6839;15748;1058291;431046;1489337
2022.02_01-07-2022;Омская область;75_90_days;SputnikV;56670;18159;74829;1058291;431046;1489337
2022.02_01-07-2022;Омская область;90_105_days;AllVaccines;32892;16743;49635;1058291;431046;1489337
2022.02_01-07-2022;Омская область;90_105_days;CoviVac;599;152;751;1058291;431046;1489337
2022.02_01-07-2022;Омская область;90_105_days;EpiVacCorona;1015;394;1409;1058291;431046;1489337
2022.02_01-07-2022;Омская область;90_105_days;SputnikLite;12000;6654;18654;1058291;431046;1489337
2022.02_01-07-2022;Омская область;90_105_days;SputnikV;19278;9543;28821;1058291;431046;1489337
2022.02_01-07-2022;Оренбургская область;105_165_days;AllVaccines;92361;46380;138741;1068899;440686;1509585
2022.02_01-07-2022;Оренбургская область;105_165_days;CoviVac;1308;213;1521;1068899;440686;1509585
2022.02_01-07-2022;Оренбургская область;105_165_days;EpiVacCorona;936;322;1258;1068899;440686;1509585
2022.02_01-07-2022;Оренбургская область;105_165_days;SputnikLite;27198;27822;55020;1068899;440686;1509585
2022.02_01-07-2022;Оренбургская область;105_165_days;SputnikV;62919;18023;80942;1068899;440686;1509585
2022.02_01-07-2022;Оренбургская область;165_195_days;AllVaccines;105591;22131;127722;1068899;440686;1509585
2022.02_01-07-2022;Оренбургская область;165_195_days;CoviVac;560;67;627;1068899;440686;1509585
2022.02_01-07-2022;Оренбургская область;165_195_days;EpiVacCorona;1502;430;1932;1068899;440686;1509585
2022.02_01-07-2022;Оренбургская область;165_195_days;SputnikLite;5304;2762;8066;1068899;440686;1509585
2022.02_01-07-2022;Оренбургская область;165_195_days;SputnikV;98225;18872;117097;1068899;440686;1509585
2022.02_01-07-2022;Оренбургская область;21_45_days;AllVaccines;48502;19675;68177;1068899;440686;1509585
2022.02_01-07-2022;Оренбургская область;21_45_days;CoviVac;447;57;504;1068899;440686;1509585
2022.02_01-07-2022;Оренбургская область;21_45_days;EpiVacCorona;2224;848;3072;1068899;440686;1509585
2022.02_01-07-2022;Оренбургская область;21_45_days;SputnikLite;33968;14645;48613;1068899;440686;1509585
2022.02_01-07-2022;Оренбургская область;21_45_days;SputnikV;11863;4125;15988;1068899;440686;1509585
2022.02_01-07-2022;Оренбургская область;45_75_days;AllVaccines;78259;42456;120715;1068899;440686;1509585
2022.02_01-07-2022;Оренбургская область;45_75_days;CoviVac;949;144;1093;1068899;440686;1509585
2022.02_01-07-2022;Оренбургская область;45_75_days;EpiVacCorona;5172;2457;7629;1068899;440686;1509585
2022.02_01-07-2022;Оренбургская область;45_75_days;SputnikLite;25916;19288;45204;1068899;440686;1509585
2022.02_01-07-2022;Оренбургская область;45_75_days;SputnikV;46222;20567;66789;1068899;440686;1509585
2022.02_01-07-2022;Оренбургская область;75_90_days;AllVaccines;69718;31127;100845;1068899;440686;1509585
2022.02_01-07-2022;Оренбургская область;75_90_days;CoviVac;291;50;341;1068899;440686;1509585
2022.02_01-07-2022;Оренбургская область;75_90_days;EpiVacCorona;2692;961;3653;1068899;440686;1509585
2022.02_01-07-2022;Оренбургская область;75_90_days;SputnikLite;15942;15123;31065;1068899;440686;1509585
2022.02_01-07-2022;Оренбургская область;75_90_days;SputnikV;50793;14993;65786;1068899;440686;1509585
2022.02_01-07-2022;Оренбургская область;90_105_days;AllVaccines;57143;27214;84357;1068899;440686;1509585
2022.02_01-07-2022;Оренбургская область;90_105_days;CoviVac;1009;167;1176;1068899;440686;1509585
2022.02_01-07-2022;Оренбургская область;90_105_days;EpiVacCorona;1996;669;2665;1068899;440686;1509585
2022.02_01-07-2022;Оренбургская область;90_105_days;SputnikLite;11490;12938;24428;1068899;440686;1509585
2022.02_01-07-2022;Оренбургская область;90_105_days;SputnikV;42648;13440;56088;1068899;440686;1509585
2022.02_01-07-2022;Орловская область;105_165_days;AllVaccines;47499;23754;71253;398663;193123;591786
2022.02_01-07-2022;Орловская область;105_165_days;CoviVac;9;4;13;398663;193123;591786
2022.02_01-07-2022;Орловская область;105_165_days;EpiVacCorona;694;253;947;398663;193123;591786
2022.02_01-07-2022;Орловская область;105_165_days;SputnikLite;31986;16653;48639;398663;193123;591786
2022.02_01-07-2022;Орловская область;105_165_days;SputnikV;14810;6844;21654;398663;193123;591786
2022.02_01-07-2022;Орловская область;165_195_days;AllVaccines;50443;10898;61341;398663;193123;591786
2022.02_01-07-2022;Орловская область;165_195_days;CoviVac;15;7;22;398663;193123;591786
2022.02_01-07-2022;Орловская область;165_195_days;EpiVacCorona;6783;1466;8249;398663;193123;591786
2022.02_01-07-2022;Орловская область;165_195_days;SputnikLite;11223;2100;13323;398663;193123;591786
2022.02_01-07-2022;Орловская область;165_195_days;SputnikV;32422;7325;39747;398663;193123;591786
2022.02_01-07-2022;Орловская область;21_45_days;AllVaccines;13328;8097;21425;398663;193123;591786
2022.02_01-07-2022;Орловская область;21_45_days;CoviVac;287;76;363;398663;193123;591786
2022.02_01-07-2022;Орловская область;21_45_days;EpiVacCorona;460;223;683;398663;193123;591786
2022.02_01-07-2022;Орловская область;21_45_days;SputnikLite;8113;5685;13798;398663;193123;591786
2022.02_01-07-2022;Орловская область;21_45_days;SputnikV;4468;2113;6581;398663;193123;591786
2022.02_01-07-2022;Орловская область;45_75_days;AllVaccines;46611;21001;67612;398663;193123;591786
2022.02_01-07-2022;Орловская область;45_75_days;CoviVac;1745;486;2231;398663;193123;591786
2022.02_01-07-2022;Орловская область;45_75_days;EpiVacCorona;733;328;1061;398663;193123;591786
2022.02_01-07-2022;Орловская область;45_75_days;SputnikLite;8054;7267;15321;398663;193123;591786
2022.02_01-07-2022;Орловская область;45_75_days;SputnikV;36079;12920;48999;398663;193123;591786
2022.02_01-07-2022;Орловская область;75_90_days;AllVaccines;31598;13942;45540;398663;193123;591786
2022.02_01-07-2022;Орловская область;75_90_days;CoviVac;262;52;314;398663;193123;591786
2022.02_01-07-2022;Орловская область;75_90_days;EpiVacCorona;183;96;279;398663;193123;591786
2022.02_01-07-2022;Орловская область;75_90_days;SputnikLite;7125;7062;14187;398663;193123;591786
2022.02_01-07-2022;Орловская область;75_90_days;SputnikV;24028;6732;30760;398663;193123;591786
2022.02_01-07-2022;Орловская область;90_105_days;AllVaccines;12924;6800;19724;398663;193123;591786
2022.02_01-07-2022;Орловская область;90_105_days;CoviVac;641;139;780;398663;193123;591786
2022.02_01-07-2022;Орловская область;90_105_days;EpiVacCorona;237;137;374;398663;193123;591786
2022.02_01-07-2022;Орловская область;90_105_days;SputnikLite;5217;3308;8525;398663;193123;591786
2022.02_01-07-2022;Орловская область;90_105_days;SputnikV;6829;3216;10045;398663;193123;591786
2022.02_01-07-2022;Пензенская область;105_165_days;AllVaccines;90864;55424;146288;710438;350687;1061125
2022.02_01-07-2022;Пензенская область;105_165_days;CoviVac;429;50;479;710438;350687;1061125
2022.02_01-07-2022;Пензенская область;105_165_days;EpiVacCorona;1081;722;1803;710438;350687;1061125
2022.02_01-07-2022;Пензенская область;105_165_days;SputnikLite;52885;17562;70447;710438;350687;1061125
2022.02_01-07-2022;Пензенская область;105_165_days;SputnikV;36469;37090;73559;710438;350687;1061125
2022.02_01-07-2022;Пензенская область;165_195_days;AllVaccines;85868;21078;106946;710438;350687;1061125
2022.02_01-07-2022;Пензенская область;165_195_days;CoviVac;719;77;796;710438;350687;1061125
2022.02_01-07-2022;Пензенская область;165_195_days;EpiVacCorona;2257;801;3058;710438;350687;1061125
2022.02_01-07-2022;Пензенская область;165_195_days;SputnikLite;35179;6558;41737;710438;350687;1061125
2022.02_01-07-2022;Пензенская область;165_195_days;SputnikV;47713;13642;61355;710438;350687;1061125
2022.02_01-07-2022;Пензенская область;21_45_days;AllVaccines;27175;26056;53231;710438;350687;1061125
2022.02_01-07-2022;Пензенская область;21_45_days;CoviVac;194;111;305;710438;350687;1061125
2022.02_01-07-2022;Пензенская область;21_45_days;EpiVacCorona;903;3040;3943;710438;350687;1061125
2022.02_01-07-2022;Пензенская область;21_45_days;SputnikLite;17916;10161;28077;710438;350687;1061125
2022.02_01-07-2022;Пензенская область;21_45_days;SputnikV;8162;12744;20906;710438;350687;1061125
2022.02_01-07-2022;Пензенская область;45_75_days;AllVaccines;59220;42204;101424;710438;350687;1061125
2022.02_01-07-2022;Пензенская область;45_75_days;CoviVac;825;262;1087;710438;350687;1061125
2022.02_01-07-2022;Пензенская область;45_75_days;EpiVacCorona;1078;1226;2304;710438;350687;1061125
2022.02_01-07-2022;Пензенская область;45_75_days;SputnikLite;15759;10478;26237;710438;350687;1061125
2022.02_01-07-2022;Пензенская область;45_75_days;SputnikV;41558;30238;71796;710438;350687;1061125
2022.02_01-07-2022;Пензенская область;75_90_days;AllVaccines;73812;29707;103519;710438;350687;1061125
2022.02_01-07-2022;Пензенская область;75_90_days;CoviVac;712;106;818;710438;350687;1061125
2022.02_01-07-2022;Пензенская область;75_90_days;EpiVacCorona;386;84;470;710438;350687;1061125
2022.02_01-07-2022;Пензенская область;75_90_days;SputnikLite;8529;5144;13673;710438;350687;1061125
2022.02_01-07-2022;Пензенская область;75_90_days;SputnikV;64185;24373;88558;710438;350687;1061125
2022.02_01-07-2022;Пензенская область;90_105_days;AllVaccines;53279;17557;70836;710438;350687;1061125
2022.02_01-07-2022;Пензенская область;90_105_days;CoviVac;795;104;899;710438;350687;1061125
2022.02_01-07-2022;Пензенская область;90_105_days;EpiVacCorona;1953;462;2415;710438;350687;1061125
2022.02_01-07-2022;Пензенская область;90_105_days;SputnikLite;795;477;1272;710438;350687;1061125
2022.02_01-07-2022;Пензенская область;90_105_days;SputnikV;49736;16514;66250;710438;350687;1061125
2022.02_01-07-2022;Пермский край;105_165_days;AllVaccines;163701;59527;223228;1423011;574038;1997049
2022.02_01-07-2022;Пермский край;105_165_days;CoviVac;2669;531;3200;1423011;574038;1997049
2022.02_01-07-2022;Пермский край;105_165_days;EpiVacCorona;2494;896;3390;1423011;574038;1997049
2022.02_01-07-2022;Пермский край;105_165_days;SputnikLite;69795;33755;103550;1423011;574038;1997049
2022.02_01-07-2022;Пермский край;105_165_days;SputnikV;88743;24345;113088;1423011;574038;1997049
2022.02_01-07-2022;Пермский край;165_195_days;AllVaccines;163660;30732;194392;1423011;574038;1997049
2022.02_01-07-2022;Пермский край;165_195_days;CoviVac;2433;290;2723;1423011;574038;1997049
2022.02_01-07-2022;Пермский край;165_195_days;EpiVacCorona;3592;882;4474;1423011;574038;1997049
2022.02_01-07-2022;Пермский край;165_195_days;SputnikLite;34646;5190;39836;1423011;574038;1997049
2022.02_01-07-2022;Пермский край;165_195_days;SputnikV;122989;24370;147359;1423011;574038;1997049
2022.02_01-07-2022;Пермский край;21_45_days;AllVaccines;45251;25515;70766;1423011;574038;1997049
2022.02_01-07-2022;Пермский край;21_45_days;CoviVac;669;129;798;1423011;574038;1997049
2022.02_01-07-2022;Пермский край;21_45_days;EpiVacCorona;800;310;1110;1423011;574038;1997049
2022.02_01-07-2022;Пермский край;21_45_days;SputnikLite;26036;18865;44901;1423011;574038;1997049
2022.02_01-07-2022;Пермский край;21_45_days;SputnikV;17746;6211;23957;1423011;574038;1997049
2022.02_01-07-2022;Пермский край;45_75_days;AllVaccines;132493;63525;196018;1423011;574038;1997049
2022.02_01-07-2022;Пермский край;45_75_days;CoviVac;1250;273;1523;1423011;574038;1997049
2022.02_01-07-2022;Пермский край;45_75_days;EpiVacCorona;1681;614;2295;1423011;574038;1997049
2022.02_01-07-2022;Пермский край;45_75_days;SputnikLite;29290;27222;56512;1423011;574038;1997049
2022.02_01-07-2022;Пермский край;45_75_days;SputnikV;100272;35416;135688;1423011;574038;1997049
2022.02_01-07-2022;Пермский край;75_90_days;AllVaccines;97339;42147;139486;1423011;574038;1997049
2022.02_01-07-2022;Пермский край;75_90_days;CoviVac;377;73;450;1423011;574038;1997049
2022.02_01-07-2022;Пермский край;75_90_days;EpiVacCorona;1051;305;1356;1423011;574038;1997049
2022.02_01-07-2022;Пермский край;75_90_days;SputnikLite;16758;17213;33971;1423011;574038;1997049
2022.02_01-07-2022;Пермский край;75_90_days;SputnikV;79153;24556;103709;1423011;574038;1997049
2022.02_01-07-2022;Пермский край;90_105_days;AllVaccines;37353;16668;54021;1423011;574038;1997049
2022.02_01-07-2022;Пермский край;90_105_days;CoviVac;924;189;1113;1423011;574038;1997049
2022.02_01-07-2022;Пермский край;90_105_days;EpiVacCorona;1130;452;1582;1423011;574038;1997049
2022.02_01-07-2022;Пермский край;90_105_days;SputnikLite;5070;3247;8317;1423011;574038;1997049
2022.02_01-07-2022;Пермский край;90_105_days;SputnikV;30229;12780;43009;1423011;574038;1997049
2022.02_01-07-2022;Приморский край;105_165_days;AllVaccines;73624;30053;103677;1086430;416518;1502948
2022.02_01-07-2022;Приморский край;105_165_days;CoviVac;1453;173;1626;1086430;416518;1502948
2022.02_01-07-2022;Приморский край;105_165_days;EpiVacCorona;1728;784;2512;1086430;416518;1502948
2022.02_01-07-2022;Приморский край;105_165_days;SputnikLite;33463;18289;51752;1086430;416518;1502948
2022.02_01-07-2022;Приморский край;105_165_days;SputnikV;36980;10807;47787;1086430;416518;1502948
2022.02_01-07-2022;Приморский край;165_195_days;AllVaccines;64567;14173;78740;1086430;416518;1502948
2022.02_01-07-2022;Приморский край;165_195_days;CoviVac;848;67;915;1086430;416518;1502948
2022.02_01-07-2022;Приморский край;165_195_days;EpiVacCorona;1280;468;1748;1086430;416518;1502948
2022.02_01-07-2022;Приморский край;165_195_days;SputnikLite;8178;1209;9387;1086430;416518;1502948
2022.02_01-07-2022;Приморский край;165_195_days;SputnikV;54261;12429;66690;1086430;416518;1502948
2022.02_01-07-2022;Приморский край;21_45_days;AllVaccines;36581;19979;56560;1086430;416518;1502948
2022.02_01-07-2022;Приморский край;21_45_days;CoviVac;248;29;277;1086430;416518;1502948
2022.02_01-07-2022;Приморский край;21_45_days;EpiVacCorona;926;513;1439;1086430;416518;1502948
2022.02_01-07-2022;Приморский край;21_45_days;SputnikLite;17782;13947;31729;1086430;416518;1502948
2022.02_01-07-2022;Приморский край;21_45_days;SputnikV;17625;5490;23115;1086430;416518;1502948
2022.02_01-07-2022;Приморский край;45_75_days;AllVaccines;159003;48240;207243;1086430;416518;1502948
2022.02_01-07-2022;Приморский край;45_75_days;CoviVac;1068;87;1155;1086430;416518;1502948
2022.02_01-07-2022;Приморский край;45_75_days;EpiVacCorona;1828;955;2783;1086430;416518;1502948
2022.02_01-07-2022;Приморский край;45_75_days;SputnikLite;23793;18518;42311;1086430;416518;1502948
2022.02_01-07-2022;Приморский край;45_75_days;SputnikV;132314;28680;160994;1086430;416518;1502948
2022.02_01-07-2022;Приморский край;75_90_days;AllVaccines;95611;22285;117896;1086430;416518;1502948
2022.02_01-07-2022;Приморский край;75_90_days;CoviVac;1857;178;2035;1086430;416518;1502948
2022.02_01-07-2022;Приморский край;75_90_days;EpiVacCorona;1028;284;1312;1086430;416518;1502948
2022.02_01-07-2022;Приморский край;75_90_days;SputnikLite;9841;7646;17487;1086430;416518;1502948
2022.02_01-07-2022;Приморский край;75_90_days;SputnikV;82885;14177;97062;1086430;416518;1502948
2022.02_01-07-2022;Приморский край;90_105_days;AllVaccines;60053;15141;75194;1086430;416518;1502948
2022.02_01-07-2022;Приморский край;90_105_days;CoviVac;1281;111;1392;1086430;416518;1502948
2022.02_01-07-2022;Приморский край;90_105_days;EpiVacCorona;1154;331;1485;1086430;416518;1502948
2022.02_01-07-2022;Приморский край;90_105_days;SputnikLite;15773;5943;21716;1086430;416518;1502948
2022.02_01-07-2022;Приморский край;90_105_days;SputnikV;41845;8756;50601;1086430;416518;1502948
2022.02_01-07-2022;Псковская область;105_165_days;AllVaccines;29684;16532;46216;337881;166663;504544
2022.02_01-07-2022;Псковская область;105_165_days;CoviVac;31;7;38;337881;166663;504544
2022.02_01-07-2022;Псковская область;105_165_days;EpiVacCorona;1020;389;1409;337881;166663;504544
2022.02_01-07-2022;Псковская область;105_165_days;SputnikLite;11353;10408;21761;337881;166663;504544
2022.02_01-07-2022;Псковская область;105_165_days;SputnikV;17280;5728;23008;337881;166663;504544
2022.02_01-07-2022;Псковская область;165_195_days;AllVaccines;41016;9297;50313;337881;166663;504544
2022.02_01-07-2022;Псковская область;165_195_days;CoviVac;223;17;240;337881;166663;504544
2022.02_01-07-2022;Псковская область;165_195_days;EpiVacCorona;6400;1532;7932;337881;166663;504544
2022.02_01-07-2022;Псковская область;165_195_days;SputnikLite;2888;908;3796;337881;166663;504544
2022.02_01-07-2022;Псковская область;165_195_days;SputnikV;31505;6840;38345;337881;166663;504544
2022.02_01-07-2022;Псковская область;21_45_days;AllVaccines;9535;5478;15013;337881;166663;504544
2022.02_01-07-2022;Псковская область;21_45_days;CoviVac;265;24;289;337881;166663;504544
2022.02_01-07-2022;Псковская область;21_45_days;EpiVacCorona;376;257;633;337881;166663;504544
2022.02_01-07-2022;Псковская область;21_45_days;SputnikLite;4182;3519;7701;337881;166663;504544
2022.02_01-07-2022;Псковская область;21_45_days;SputnikV;4712;1678;6390;337881;166663;504544
2022.02_01-07-2022;Псковская область;45_75_days;AllVaccines;24458;14155;38613;337881;166663;504544
2022.02_01-07-2022;Псковская область;45_75_days;CoviVac;451;67;518;337881;166663;504544
2022.02_01-07-2022;Псковская область;45_75_days;EpiVacCorona;884;426;1310;337881;166663;504544
2022.02_01-07-2022;Псковская область;45_75_days;SputnikLite;6796;6515;13311;337881;166663;504544
2022.02_01-07-2022;Псковская область;45_75_days;SputnikV;16327;7147;23474;337881;166663;504544
2022.02_01-07-2022;Псковская область;75_90_days;AllVaccines;13376;8367;21743;337881;166663;504544
2022.02_01-07-2022;Псковская область;75_90_days;CoviVac;313;63;376;337881;166663;504544
2022.02_01-07-2022;Псковская область;75_90_days;EpiVacCorona;549;232;781;337881;166663;504544
2022.02_01-07-2022;Псковская область;75_90_days;SputnikLite;4004;4454;8458;337881;166663;504544
2022.02_01-07-2022;Псковская область;75_90_days;SputnikV;8510;3618;12128;337881;166663;504544
2022.02_01-07-2022;Псковская область;90_105_days;AllVaccines;11004;7747;18751;337881;166663;504544
2022.02_01-07-2022;Псковская область;90_105_days;CoviVac;371;72;443;337881;166663;504544
2022.02_01-07-2022;Псковская область;90_105_days;EpiVacCorona;435;201;636;337881;166663;504544
2022.02_01-07-2022;Псковская область;90_105_days;SputnikLite;3863;4499;8362;337881;166663;504544
2022.02_01-07-2022;Псковская область;90_105_days;SputnikV;6335;2975;9310;337881;166663;504544
2022.02_01-07-2022;РФ;105_165_days;AllVaccines;7683142;3357352;11040494;82332898;33454776;115787674
2022.02_01-07-2022;РФ;105_165_days;CoviVac;105072;21716;126788;82332898;33454776;115787674
2022.02_01-07-2022;РФ;105_165_days;EpiVacCorona;88249;42438;130687;82332898;33454776;115787674
2022.02_01-07-2022;РФ;105_165_days;SputnikLite;3757702;1933174;5690876;82332898;33454776;115787674
2022.02_01-07-2022;РФ;105_165_days;SputnikV;3732119;1360024;5092143;82332898;33454776;115787674
2022.02_01-07-2022;РФ;165_195_days;AllVaccines;8783490;1732784;10516274;82332898;33454776;115787674
2022.02_01-07-2022;РФ;165_195_days;CoviVac;99191;13665;112856;82332898;33454776;115787674
2022.02_01-07-2022;РФ;165_195_days;EpiVacCorona;175101;52505;227606;82332898;33454776;115787674
2022.02_01-07-2022;РФ;165_195_days;SputnikLite;1686908;286847;1973755;82332898;33454776;115787674
2022.02_01-07-2022;РФ;165_195_days;SputnikV;6822290;1379767;8202057;82332898;33454776;115787674
2022.02_01-07-2022;РФ;21_45_days;AllVaccines;2857484;1380864;4238348;82332898;33454776;115787674
2022.02_01-07-2022;РФ;21_45_days;CoviVac;24808;6048;30856;82332898;33454776;115787674
2022.02_01-07-2022;РФ;21_45_days;EpiVacCorona;88463;48556;137019;82332898;33454776;115787674
2022.02_01-07-2022;РФ;21_45_days;SputnikLite;1694480;905043;2599523;82332898;33454776;115787674
2022.02_01-07-2022;РФ;21_45_days;SputnikV;1049733;421217;1470950;82332898;33454776;115787674
2022.02_01-07-2022;РФ;45_75_days;AllVaccines;7056162;3215325;10271487;82332898;33454776;115787674
2022.02_01-07-2022;РФ;45_75_days;CoviVac;91422;19854;111276;82332898;33454776;115787674
2022.02_01-07-2022;РФ;45_75_days;EpiVacCorona;201443;94907;296350;82332898;33454776;115787674
2022.02_01-07-2022;РФ;45_75_days;SputnikLite;1820820;1226564;3047384;82332898;33454776;115787674
2022.02_01-07-2022;РФ;45_75_days;SputnikV;4942477;1874000;6816477;82332898;33454776;115787674
2022.02_01-07-2022;РФ;75_90_days;AllVaccines;4821736;2064655;6886391;82332898;33454776;115787674
2022.02_01-07-2022;РФ;75_90_days;CoviVac;55376;11341;66717;82332898;33454776;115787674
2022.02_01-07-2022;РФ;75_90_days;EpiVacCorona;127748;50415;178163;82332898;33454776;115787674
2022.02_01-07-2022;РФ;75_90_days;SputnikLite;1164487;826579;1991066;82332898;33454776;115787674
2022.02_01-07-2022;РФ;75_90_days;SputnikV;3474125;1176320;4650445;82332898;33454776;115787674
2022.02_01-07-2022;РФ;90_105_days;AllVaccines;3344252;1420904;4765156;82332898;33454776;115787674
2022.02_01-07-2022;РФ;90_105_days;CoviVac;54899;12340;67239;82332898;33454776;115787674
2022.02_01-07-2022;РФ;90_105_days;EpiVacCorona;91291;38530;129821;82332898;33454776;115787674
2022.02_01-07-2022;РФ;90_105_days;SputnikLite;923081;538354;1461435;82332898;33454776;115787674
2022.02_01-07-2022;РФ;90_105_days;SputnikV;2274981;831680;3106661;82332898;33454776;115787674
2022.02_01-07-2022;Республика Адыгея;105_165_days;AllVaccines;25570;9826;35396;256368;104563;360931
2022.02_01-07-2022;Республика Адыгея;105_165_days;CoviVac;42;9;51;256368;104563;360931
2022.02_01-07-2022;Республика Адыгея;105_165_days;EpiVacCorona;138;85;223;256368;104563;360931
2022.02_01-07-2022;Республика Адыгея;105_165_days;SputnikLite;16685;6433;23118;256368;104563;360931
2022.02_01-07-2022;Республика Адыгея;105_165_days;SputnikV;8705;3299;12004;256368;104563;360931
2022.02_01-07-2022;Республика Адыгея;165_195_days;AllVaccines;27075;5713;32788;256368;104563;360931
2022.02_01-07-2022;Республика Адыгея;165_195_days;CoviVac;15;3;18;256368;104563;360931
2022.02_01-07-2022;Республика Адыгея;165_195_days;EpiVacCorona;362;146;508;256368;104563;360931
2022.02_01-07-2022;Республика Адыгея;165_195_days;SputnikLite;3254;941;4195;256368;104563;360931
2022.02_01-07-2022;Республика Адыгея;165_195_days;SputnikV;23444;4623;28067;256368;104563;360931
2022.02_01-07-2022;Республика Адыгея;21_45_days;AllVaccines;7686;3793;11479;256368;104563;360931
2022.02_01-07-2022;Республика Адыгея;21_45_days;CoviVac;46;9;55;256368;104563;360931
2022.02_01-07-2022;Республика Адыгея;21_45_days;EpiVacCorona;311;105;416;256368;104563;360931
2022.02_01-07-2022;Республика Адыгея;21_45_days;SputnikLite;5503;2959;8462;256368;104563;360931
2022.02_01-07-2022;Республика Адыгея;21_45_days;SputnikV;1826;720;2546;256368;104563;360931
2022.02_01-07-2022;Республика Адыгея;45_75_days;AllVaccines;13735;7231;20966;256368;104563;360931
2022.02_01-07-2022;Республика Адыгея;45_75_days;CoviVac;144;42;186;256368;104563;360931
2022.02_01-07-2022;Республика Адыгея;45_75_days;EpiVacCorona;418;277;695;256368;104563;360931
2022.02_01-07-2022;Республика Адыгея;45_75_days;SputnikLite;5427;3456;8883;256368;104563;360931
2022.02_01-07-2022;Республика Адыгея;45_75_days;SputnikV;7746;3456;11202;256368;104563;360931
2022.02_01-07-2022;Республика Адыгея;75_90_days;AllVaccines;10448;4456;14904;256368;104563;360931
2022.02_01-07-2022;Республика Адыгея;75_90_days;CoviVac;131;47;178;256368;104563;360931
2022.02_01-07-2022;Республика Адыгея;75_90_days;EpiVacCorona;298;122;420;256368;104563;360931
2022.02_01-07-2022;Республика Адыгея;75_90_days;SputnikLite;3763;2203;5966;256368;104563;360931
2022.02_01-07-2022;Республика Адыгея;75_90_days;SputnikV;6256;2084;8340;256368;104563;360931
2022.02_01-07-2022;Республика Адыгея;90_105_days;AllVaccines;9267;4241;13508;256368;104563;360931
2022.02_01-07-2022;Республика Адыгея;90_105_days;CoviVac;234;48;282;256368;104563;360931
2022.02_01-07-2022;Республика Адыгея;90_105_days;EpiVacCorona;210;105;315;256368;104563;360931
2022.02_01-07-2022;Республика Адыгея;90_105_days;SputnikLite;4066;2227;6293;256368;104563;360931
2022.02_01-07-2022;Республика Адыгея;90_105_days;SputnikV;4757;1861;6618;256368;104563;360931
2022.02_01-07-2022;Республика Алтай;105_165_days;AllVaccines;9796;4522;14318;117210;36468;153678
2022.02_01-07-2022;Республика Алтай;105_165_days;CoviVac;32;16;48;117210;36468;153678
2022.02_01-07-2022;Республика Алтай;105_165_days;EpiVacCorona;40;30;70;117210;36468;153678
2022.02_01-07-2022;Республика Алтай;105_165_days;SputnikLite;5311;3482;8793;117210;36468;153678
2022.02_01-07-2022;Республика Алтай;105_165_days;SputnikV;4413;994;5407;117210;36468;153678
2022.02_01-07-2022;Республика Алтай;165_195_days;AllVaccines;11854;1968;13822;117210;36468;153678
2022.02_01-07-2022;Республика Алтай;165_195_days;CoviVac;456;69;525;117210;36468;153678
2022.02_01-07-2022;Республика Алтай;165_195_days;EpiVacCorona;60;24;84;117210;36468;153678
2022.02_01-07-2022;Республика Алтай;165_195_days;SputnikLite;2701;614;3315;117210;36468;153678
2022.02_01-07-2022;Республика Алтай;165_195_days;SputnikV;8637;1261;9898;117210;36468;153678
2022.02_01-07-2022;Республика Алтай;21_45_days;AllVaccines;6857;2225;9082;117210;36468;153678
2022.02_01-07-2022;Республика Алтай;21_45_days;CoviVac;70;19;89;117210;36468;153678
2022.02_01-07-2022;Республика Алтай;21_45_days;EpiVacCorona;193;65;258;117210;36468;153678
2022.02_01-07-2022;Республика Алтай;21_45_days;SputnikLite;5128;1687;6815;117210;36468;153678
2022.02_01-07-2022;Республика Алтай;21_45_days;SputnikV;1466;454;1920;117210;36468;153678
2022.02_01-07-2022;Республика Алтай;45_75_days;AllVaccines;10758;3893;14651;117210;36468;153678
2022.02_01-07-2022;Республика Алтай;45_75_days;CoviVac;185;33;218;117210;36468;153678
2022.02_01-07-2022;Республика Алтай;45_75_days;EpiVacCorona;265;89;354;117210;36468;153678
2022.02_01-07-2022;Республика Алтай;45_75_days;SputnikLite;6228;2418;8646;117210;36468;153678
2022.02_01-07-2022;Республика Алтай;45_75_days;SputnikV;4080;1353;5433;117210;36468;153678
2022.02_01-07-2022;Республика Алтай;75_90_days;AllVaccines;4974;2128;7102;117210;36468;153678
2022.02_01-07-2022;Республика Алтай;75_90_days;CoviVac;3;2;5;117210;36468;153678
2022.02_01-07-2022;Республика Алтай;75_90_days;EpiVacCorona;83;28;111;117210;36468;153678
2022.02_01-07-2022;Республика Алтай;75_90_days;SputnikLite;3296;1433;4729;117210;36468;153678
2022.02_01-07-2022;Республика Алтай;75_90_days;SputnikV;1592;665;2257;117210;36468;153678
2022.02_01-07-2022;Республика Алтай;90_105_days;AllVaccines;5149;2628;7777;117210;36468;153678
2022.02_01-07-2022;Республика Алтай;90_105_days;CoviVac;1;4;5;117210;36468;153678
2022.02_01-07-2022;Республика Алтай;90_105_days;EpiVacCorona;70;22;92;117210;36468;153678
2022.02_01-07-2022;Республика Алтай;90_105_days;SputnikLite;4077;2034;6111;117210;36468;153678
2022.02_01-07-2022;Республика Алтай;90_105_days;SputnikV;1001;568;1569;117210;36468;153678
2022.02_01-07-2022;Республика Башкортостан;105_165_days;AllVaccines;228620;84257;312877;2235962;869874;3105836
2022.02_01-07-2022;Республика Башкортостан;105_165_days;CoviVac;3206;848;4054;2235962;869874;3105836
2022.02_01-07-2022;Республика Башкортостан;105_165_days;EpiVacCorona;3119;1542;4661;2235962;869874;3105836
2022.02_01-07-2022;Республика Башкортостан;105_165_days;SputnikLite;77967;31980;109947;2235962;869874;3105836
2022.02_01-07-2022;Республика Башкортостан;105_165_days;SputnikV;144328;49887;194215;2235962;869874;3105836
2022.02_01-07-2022;Республика Башкортостан;165_195_days;AllVaccines;245703;48324;294027;2235962;869874;3105836
2022.02_01-07-2022;Республика Башкортостан;165_195_days;CoviVac;3428;501;3929;2235962;869874;3105836
2022.02_01-07-2022;Республика Башкортостан;165_195_days;EpiVacCorona;3379;1138;4517;2235962;869874;3105836
2022.02_01-07-2022;Республика Башкортостан;165_195_days;SputnikLite;40297;8060;48357;2235962;869874;3105836
2022.02_01-07-2022;Республика Башкортостан;165_195_days;SputnikV;198599;38625;237224;2235962;869874;3105836
2022.02_01-07-2022;Республика Башкортостан;21_45_days;AllVaccines;89724;34116;123840;2235962;869874;3105836
2022.02_01-07-2022;Республика Башкортостан;21_45_days;CoviVac;1613;285;1898;2235962;869874;3105836
2022.02_01-07-2022;Республика Башкортостан;21_45_days;EpiVacCorona;4937;2720;7657;2235962;869874;3105836
2022.02_01-07-2022;Республика Башкортостан;21_45_days;SputnikLite;46849;19121;65970;2235962;869874;3105836
2022.02_01-07-2022;Республика Башкортостан;21_45_days;SputnikV;36325;11990;48315;2235962;869874;3105836
2022.02_01-07-2022;Республика Башкортостан;45_75_days;AllVaccines;208358;80834;289192;2235962;869874;3105836
2022.02_01-07-2022;Республика Башкортостан;45_75_days;CoviVac;7002;1846;8848;2235962;869874;3105836
2022.02_01-07-2022;Республика Башкортостан;45_75_days;EpiVacCorona;5076;2568;7644;2235962;869874;3105836
2022.02_01-07-2022;Республика Башкортостан;45_75_days;SputnikLite;50324;24862;75186;2235962;869874;3105836
2022.02_01-07-2022;Республика Башкортостан;45_75_days;SputnikV;145956;51558;197514;2235962;869874;3105836
2022.02_01-07-2022;Республика Башкортостан;75_90_days;AllVaccines;139238;58848;198086;2235962;869874;3105836
2022.02_01-07-2022;Республика Башкортостан;75_90_days;CoviVac;243;69;312;2235962;869874;3105836
2022.02_01-07-2022;Республика Башкортостан;75_90_days;EpiVacCorona;3439;1645;5084;2235962;869874;3105836
2022.02_01-07-2022;Республика Башкортостан;75_90_days;SputnikLite;28466;19085;47551;2235962;869874;3105836
2022.02_01-07-2022;Республика Башкортостан;75_90_days;SputnikV;107090;38049;145139;2235962;869874;3105836
2022.02_01-07-2022;Республика Башкортостан;90_105_days;AllVaccines;163820;48759;212579;2235962;869874;3105836
2022.02_01-07-2022;Республика Башкортостан;90_105_days;CoviVac;541;123;664;2235962;869874;3105836
2022.02_01-07-2022;Республика Башкортостан;90_105_days;EpiVacCorona;4477;2138;6615;2235962;869874;3105836
2022.02_01-07-2022;Республика Башкортостан;90_105_days;SputnikLite;4683;2110;6793;2235962;869874;3105836
2022.02_01-07-2022;Республика Башкортостан;90_105_days;SputnikV;154119;44388;198507;2235962;869874;3105836
2022.02_01-07-2022;Республика Бурятия;105_165_days;AllVaccines;57437;18677;76114;542372;176777;719149
2022.02_01-07-2022;Республика Бурятия;105_165_days;CoviVac;113;35;148;542372;176777;719149
2022.02_01-07-2022;Республика Бурятия;105_165_days;EpiVacCorona;405;132;537;542372;176777;719149
2022.02_01-07-2022;Республика Бурятия;105_165_days;SputnikLite;31222;12078;43300;542372;176777;719149
2022.02_01-07-2022;Республика Бурятия;105_165_days;SputnikV;25697;6432;32129;542372;176777;719149
2022.02_01-07-2022;Республика Бурятия;165_195_days;AllVaccines;59282;12847;72129;542372;176777;719149
2022.02_01-07-2022;Республика Бурятия;165_195_days;CoviVac;321;89;410;542372;176777;719149
2022.02_01-07-2022;Республика Бурятия;165_195_days;EpiVacCorona;832;256;1088;542372;176777;719149
2022.02_01-07-2022;Республика Бурятия;165_195_days;SputnikLite;16405;3183;19588;542372;176777;719149
2022.02_01-07-2022;Республика Бурятия;165_195_days;SputnikV;41724;9319;51043;542372;176777;719149
2022.02_01-07-2022;Республика Бурятия;21_45_days;AllVaccines;24771;9759;34530;542372;176777;719149
2022.02_01-07-2022;Республика Бурятия;21_45_days;CoviVac;171;47;218;542372;176777;719149
2022.02_01-07-2022;Республика Бурятия;21_45_days;EpiVacCorona;614;385;999;542372;176777;719149
2022.02_01-07-2022;Республика Бурятия;21_45_days;SputnikLite;14766;6285;21051;542372;176777;719149
2022.02_01-07-2022;Республика Бурятия;21_45_days;SputnikV;9220;3042;12262;542372;176777;719149
2022.02_01-07-2022;Республика Бурятия;45_75_days;AllVaccines;51089;21371;72460;542372;176777;719149
2022.02_01-07-2022;Республика Бурятия;45_75_days;CoviVac;753;230;983;542372;176777;719149
2022.02_01-07-2022;Республика Бурятия;45_75_days;EpiVacCorona;494;325;819;542372;176777;719149
2022.02_01-07-2022;Республика Бурятия;45_75_days;SputnikLite;16530;9363;25893;542372;176777;719149
2022.02_01-07-2022;Республика Бурятия;45_75_days;SputnikV;33312;11453;44765;542372;176777;719149
2022.02_01-07-2022;Республика Бурятия;75_90_days;AllVaccines;32889;12348;45237;542372;176777;719149
2022.02_01-07-2022;Республика Бурятия;75_90_days;CoviVac;503;118;621;542372;176777;719149
2022.02_01-07-2022;Республика Бурятия;75_90_days;EpiVacCorona;466;275;741;542372;176777;719149
2022.02_01-07-2022;Республика Бурятия;75_90_days;SputnikLite;8653;5384;14037;542372;176777;719149
2022.02_01-07-2022;Республика Бурятия;75_90_days;SputnikV;23267;6571;29838;542372;176777;719149
2022.02_01-07-2022;Республика Бурятия;90_105_days;AllVaccines;15001;6529;21530;542372;176777;719149
2022.02_01-07-2022;Республика Бурятия;90_105_days;CoviVac;195;35;230;542372;176777;719149
2022.02_01-07-2022;Республика Бурятия;90_105_days;EpiVacCorona;458;213;671;542372;176777;719149
2022.02_01-07-2022;Республика Бурятия;90_105_days;SputnikLite;5724;2593;8317;542372;176777;719149
2022.02_01-07-2022;Республика Бурятия;90_105_days;SputnikV;8624;3688;12312;542372;176777;719149
2022.02_01-07-2022;Республика Дагестан;105_165_days;AllVaccines;114344;29668;144012;1856109;394621;2250730
2022.02_01-07-2022;Республика Дагестан;105_165_days;CoviVac;831;231;1062;1856109;394621;2250730
2022.02_01-07-2022;Республика Дагестан;105_165_days;EpiVacCorona;824;270;1094;1856109;394621;2250730
2022.02_01-07-2022;Республика Дагестан;105_165_days;SputnikLite;43760;9289;53049;1856109;394621;2250730
2022.02_01-07-2022;Республика Дагестан;105_165_days;SputnikV;68929;19878;88807;1856109;394621;2250730
2022.02_01-07-2022;Республика Дагестан;165_195_days;AllVaccines;126661;18195;144856;1856109;394621;2250730
2022.02_01-07-2022;Республика Дагестан;165_195_days;CoviVac;721;173;894;1856109;394621;2250730
2022.02_01-07-2022;Республика Дагестан;165_195_days;EpiVacCorona;5570;905;6475;1856109;394621;2250730
2022.02_01-07-2022;Республика Дагестан;165_195_days;SputnikLite;34536;4600;39136;1856109;394621;2250730
2022.02_01-07-2022;Республика Дагестан;165_195_days;SputnikV;85834;12517;98351;1856109;394621;2250730
2022.02_01-07-2022;Республика Дагестан;21_45_days;AllVaccines;62213;14685;76898;1856109;394621;2250730
2022.02_01-07-2022;Республика Дагестан;21_45_days;CoviVac;577;116;693;1856109;394621;2250730
2022.02_01-07-2022;Республика Дагестан;21_45_days;EpiVacCorona;9069;1773;10842;1856109;394621;2250730
2022.02_01-07-2022;Республика Дагестан;21_45_days;SputnikLite;15895;4337;20232;1856109;394621;2250730
2022.02_01-07-2022;Республика Дагестан;21_45_days;SputnikV;36672;8459;45131;1856109;394621;2250730
2022.02_01-07-2022;Республика Дагестан;45_75_days;AllVaccines;91496;15876;107372;1856109;394621;2250730
2022.02_01-07-2022;Республика Дагестан;45_75_days;CoviVac;1174;204;1378;1856109;394621;2250730
2022.02_01-07-2022;Республика Дагестан;45_75_days;EpiVacCorona;7137;1147;8284;1856109;394621;2250730
2022.02_01-07-2022;Республика Дагестан;45_75_days;SputnikLite;25102;4733;29835;1856109;394621;2250730
2022.02_01-07-2022;Республика Дагестан;45_75_days;SputnikV;58083;9792;67875;1856109;394621;2250730
2022.02_01-07-2022;Республика Дагестан;75_90_days;AllVaccines;71772;9605;81377;1856109;394621;2250730
2022.02_01-07-2022;Республика Дагестан;75_90_days;CoviVac;475;64;539;1856109;394621;2250730
2022.02_01-07-2022;Республика Дагестан;75_90_days;EpiVacCorona;4755;562;5317;1856109;394621;2250730
2022.02_01-07-2022;Республика Дагестан;75_90_days;SputnikLite;7340;1531;8871;1856109;394621;2250730
2022.02_01-07-2022;Республика Дагестан;75_90_days;SputnikV;59202;7448;66650;1856109;394621;2250730
2022.02_01-07-2022;Республика Дагестан;90_105_days;AllVaccines;32945;7016;39961;1856109;394621;2250730
2022.02_01-07-2022;Республика Дагестан;90_105_days;CoviVac;335;87;422;1856109;394621;2250730
2022.02_01-07-2022;Республика Дагестан;90_105_days;EpiVacCorona;1492;227;1719;1856109;394621;2250730
2022.02_01-07-2022;Республика Дагестан;90_105_days;SputnikLite;11913;1788;13701;1856109;394621;2250730
2022.02_01-07-2022;Республика Дагестан;90_105_days;SputnikV;19205;4914;24119;1856109;394621;2250730
2022.02_01-07-2022;Республика Ингушетия;105_165_days;AllVaccines;24018;3906;27924;295583;61477;357060
2022.02_01-07-2022;Республика Ингушетия;105_165_days;CoviVac;28;5;33;295583;61477;357060
2022.02_01-07-2022;Республика Ингушетия;105_165_days;EpiVacCorona;135;7;142;295583;61477;357060
2022.02_01-07-2022;Республика Ингушетия;105_165_days;SputnikLite;7862;1361;9223;295583;61477;357060
2022.02_01-07-2022;Республика Ингушетия;105_165_days;SputnikV;15993;2533;18526;295583;61477;357060
2022.02_01-07-2022;Республика Ингушетия;165_195_days;AllVaccines;34713;4928;39641;295583;61477;357060
2022.02_01-07-2022;Республика Ингушетия;165_195_days;CoviVac;569;79;648;295583;61477;357060
2022.02_01-07-2022;Республика Ингушетия;165_195_days;EpiVacCorona;543;74;617;295583;61477;357060
2022.02_01-07-2022;Республика Ингушетия;165_195_days;SputnikLite;6037;833;6870;295583;61477;357060
2022.02_01-07-2022;Республика Ингушетия;165_195_days;SputnikV;27564;3942;31506;295583;61477;357060
2022.02_01-07-2022;Республика Ингушетия;21_45_days;AllVaccines;18708;3282;21990;295583;61477;357060
2022.02_01-07-2022;Республика Ингушетия;21_45_days;CoviVac;42;29;71;295583;61477;357060
2022.02_01-07-2022;Республика Ингушетия;21_45_days;EpiVacCorona;2;0;2;295583;61477;357060
2022.02_01-07-2022;Республика Ингушетия;21_45_days;SputnikLite;11574;1760;13334;295583;61477;357060
2022.02_01-07-2022;Республика Ингушетия;21_45_days;SputnikV;7090;1493;8583;295583;61477;357060
2022.02_01-07-2022;Республика Ингушетия;45_75_days;AllVaccines;44149;9850;53999;295583;61477;357060
2022.02_01-07-2022;Республика Ингушетия;45_75_days;CoviVac;340;159;499;295583;61477;357060
2022.02_01-07-2022;Республика Ингушетия;45_75_days;EpiVacCorona;588;148;736;295583;61477;357060
2022.02_01-07-2022;Республика Ингушетия;45_75_days;SputnikLite;22813;4787;27600;295583;61477;357060
2022.02_01-07-2022;Республика Ингушетия;45_75_days;SputnikV;20408;4756;25164;295583;61477;357060
2022.02_01-07-2022;Республика Ингушетия;75_90_days;AllVaccines;9373;2035;11408;295583;61477;357060
2022.02_01-07-2022;Республика Ингушетия;75_90_days;CoviVac;8;7;15;295583;61477;357060
2022.02_01-07-2022;Республика Ингушетия;75_90_days;SputnikLite;5049;1341;6390;295583;61477;357060
2022.02_01-07-2022;Республика Ингушетия;75_90_days;SputnikV;4316;687;5003;295583;61477;357060
2022.02_01-07-2022;Республика Ингушетия;90_105_days;AllVaccines;6874;1613;8487;295583;61477;357060
2022.02_01-07-2022;Республика Ингушетия;90_105_days;CoviVac;1;0;1;295583;61477;357060
2022.02_01-07-2022;Республика Ингушетия;90_105_days;SputnikLite;3383;930;4313;295583;61477;357060
2022.02_01-07-2022;Республика Ингушетия;90_105_days;SputnikV;3490;683;4173;295583;61477;357060
2022.02_01-07-2022;Республика Калмыкия;105_165_days;AllVaccines;13683;8625;22308;150440;54890;205330
2022.02_01-07-2022;Республика Калмыкия;105_165_days;CoviVac;167;42;209;150440;54890;205330
2022.02_01-07-2022;Республика Калмыкия;105_165_days;EpiVacCorona;16;11;27;150440;54890;205330
2022.02_01-07-2022;Республика Калмыкия;105_165_days;SputnikLite;11515;7507;19022;150440;54890;205330
2022.02_01-07-2022;Республика Калмыкия;105_165_days;SputnikV;1985;1065;3050;150440;54890;205330
2022.02_01-07-2022;Республика Калмыкия;165_195_days;AllVaccines;10785;2727;13512;150440;54890;205330
2022.02_01-07-2022;Республика Калмыкия;165_195_days;CoviVac;261;38;299;150440;54890;205330
2022.02_01-07-2022;Республика Калмыкия;165_195_days;EpiVacCorona;27;6;33;150440;54890;205330
2022.02_01-07-2022;Республика Калмыкия;165_195_days;SputnikLite;3616;861;4477;150440;54890;205330
2022.02_01-07-2022;Республика Калмыкия;165_195_days;SputnikV;6881;1822;8703;150440;54890;205330
2022.02_01-07-2022;Республика Калмыкия;21_45_days;AllVaccines;5282;2263;7545;150440;54890;205330
2022.02_01-07-2022;Республика Калмыкия;21_45_days;CoviVac;49;12;61;150440;54890;205330
2022.02_01-07-2022;Республика Калмыкия;21_45_days;EpiVacCorona;268;143;411;150440;54890;205330
2022.02_01-07-2022;Республика Калмыкия;21_45_days;SputnikLite;4454;1929;6383;150440;54890;205330
2022.02_01-07-2022;Республика Калмыкия;21_45_days;SputnikV;511;179;690;150440;54890;205330
2022.02_01-07-2022;Республика Калмыкия;45_75_days;AllVaccines;10250;4255;14505;150440;54890;205330
2022.02_01-07-2022;Республика Калмыкия;45_75_days;CoviVac;293;68;361;150440;54890;205330
2022.02_01-07-2022;Республика Калмыкия;45_75_days;EpiVacCorona;128;87;215;150440;54890;205330
2022.02_01-07-2022;Республика Калмыкия;45_75_days;SputnikLite;7333;3189;10522;150440;54890;205330
2022.02_01-07-2022;Республика Калмыкия;45_75_days;SputnikV;2496;911;3407;150440;54890;205330
2022.02_01-07-2022;Республика Калмыкия;75_90_days;AllVaccines;8508;3467;11975;150440;54890;205330
2022.02_01-07-2022;Республика Калмыкия;75_90_days;CoviVac;293;57;350;150440;54890;205330
2022.02_01-07-2022;Республика Калмыкия;75_90_days;EpiVacCorona;55;20;75;150440;54890;205330
2022.02_01-07-2022;Республика Калмыкия;75_90_days;SputnikLite;6245;2627;8872;150440;54890;205330
2022.02_01-07-2022;Республика Калмыкия;75_90_days;SputnikV;1915;763;2678;150440;54890;205330
2022.02_01-07-2022;Республика Калмыкия;90_105_days;AllVaccines;11073;4839;15912;150440;54890;205330
2022.02_01-07-2022;Республика Калмыкия;90_105_days;CoviVac;170;37;207;150440;54890;205330
2022.02_01-07-2022;Республика Калмыкия;90_105_days;EpiVacCorona;11;8;19;150440;54890;205330
2022.02_01-07-2022;Республика Калмыкия;90_105_days;SputnikLite;10044;4231;14275;150440;54890;205330
2022.02_01-07-2022;Республика Калмыкия;90_105_days;SputnikV;848;563;1411;150440;54890;205330
2022.02_01-07-2022;Республика Карелия;105_165_days;AllVaccines;39321;23590;62911;334874;149526;484400
2022.02_01-07-2022;Республика Карелия;105_165_days;CoviVac;44;11;55;334874;149526;484400
2022.02_01-07-2022;Республика Карелия;105_165_days;EpiVacCorona;112;113;225;334874;149526;484400
2022.02_01-07-2022;Республика Карелия;105_165_days;SputnikLite;28561;16539;45100;334874;149526;484400
2022.02_01-07-2022;Республика Карелия;105_165_days;SputnikV;10604;6927;17531;334874;149526;484400
2022.02_01-07-2022;Республика Карелия;165_195_days;AllVaccines;42994;8756;51750;334874;149526;484400
2022.02_01-07-2022;Республика Карелия;165_195_days;CoviVac;206;23;229;334874;149526;484400
2022.02_01-07-2022;Республика Карелия;165_195_days;EpiVacCorona;399;112;511;334874;149526;484400
2022.02_01-07-2022;Республика Карелия;165_195_days;SputnikLite;15115;2760;17875;334874;149526;484400
2022.02_01-07-2022;Республика Карелия;165_195_days;SputnikV;27274;5861;33135;334874;149526;484400
2022.02_01-07-2022;Республика Карелия;21_45_days;AllVaccines;10783;6138;16921;334874;149526;484400
2022.02_01-07-2022;Республика Карелия;21_45_days;CoviVac;240;66;306;334874;149526;484400
2022.02_01-07-2022;Республика Карелия;21_45_days;EpiVacCorona;340;220;560;334874;149526;484400
2022.02_01-07-2022;Республика Карелия;21_45_days;SputnikLite;6853;4181;11034;334874;149526;484400
2022.02_01-07-2022;Республика Карелия;21_45_days;SputnikV;3350;1671;5021;334874;149526;484400
2022.02_01-07-2022;Республика Карелия;45_75_days;AllVaccines;24228;14822;39050;334874;149526;484400
2022.02_01-07-2022;Республика Карелия;45_75_days;CoviVac;572;122;694;334874;149526;484400
2022.02_01-07-2022;Республика Карелия;45_75_days;EpiVacCorona;1006;539;1545;334874;149526;484400
2022.02_01-07-2022;Республика Карелия;45_75_days;SputnikLite;8335;6626;14961;334874;149526;484400
2022.02_01-07-2022;Республика Карелия;45_75_days;SputnikV;14315;7535;21850;334874;149526;484400
2022.02_01-07-2022;Республика Карелия;75_90_days;AllVaccines;13276;10193;23469;334874;149526;484400
2022.02_01-07-2022;Республика Карелия;75_90_days;CoviVac;295;79;374;334874;149526;484400
2022.02_01-07-2022;Республика Карелия;75_90_days;EpiVacCorona;330;206;536;334874;149526;484400
2022.02_01-07-2022;Республика Карелия;75_90_days;SputnikLite;6516;5746;12262;334874;149526;484400
2022.02_01-07-2022;Республика Карелия;75_90_days;SputnikV;6135;4162;10297;334874;149526;484400
2022.02_01-07-2022;Республика Карелия;90_105_days;AllVaccines;11499;10726;22225;334874;149526;484400
2022.02_01-07-2022;Республика Карелия;90_105_days;CoviVac;433;103;536;334874;149526;484400
2022.02_01-07-2022;Республика Карелия;90_105_days;EpiVacCorona;152;140;292;334874;149526;484400
2022.02_01-07-2022;Республика Карелия;90_105_days;SputnikLite;6577;7168;13745;334874;149526;484400
2022.02_01-07-2022;Республика Карелия;90_105_days;SputnikV;4337;3315;7652;334874;149526;484400
2022.02_01-07-2022;Республика Коми;105_165_days;AllVaccines;40566;14507;55073;465210;166370;631580
2022.02_01-07-2022;Республика Коми;105_165_days;CoviVac;83;11;94;465210;166370;631580
2022.02_01-07-2022;Республика Коми;105_165_days;EpiVacCorona;3;4;7;465210;166370;631580
2022.02_01-07-2022;Республика Коми;105_165_days;SputnikLite;23578;9006;32584;465210;166370;631580
2022.02_01-07-2022;Республика Коми;105_165_days;SputnikV;16902;5486;22388;465210;166370;631580
2022.02_01-07-2022;Республика Коми;165_195_days;AllVaccines;60082;9255;69337;465210;166370;631580
2022.02_01-07-2022;Республика Коми;165_195_days;CoviVac;462;46;508;465210;166370;631580
2022.02_01-07-2022;Республика Коми;165_195_days;EpiVacCorona;47;14;61;465210;166370;631580
2022.02_01-07-2022;Республика Коми;165_195_days;SputnikLite;17528;1651;19179;465210;166370;631580
2022.02_01-07-2022;Республика Коми;165_195_days;SputnikV;42045;7544;49589;465210;166370;631580
2022.02_01-07-2022;Республика Коми;21_45_days;AllVaccines;15092;7182;22274;465210;166370;631580
2022.02_01-07-2022;Республика Коми;21_45_days;CoviVac;198;53;251;465210;166370;631580
2022.02_01-07-2022;Республика Коми;21_45_days;EpiVacCorona;452;191;643;465210;166370;631580
2022.02_01-07-2022;Республика Коми;21_45_days;SputnikLite;10137;4754;14891;465210;166370;631580
2022.02_01-07-2022;Республика Коми;21_45_days;SputnikV;4305;2184;6489;465210;166370;631580
2022.02_01-07-2022;Республика Коми;45_75_days;AllVaccines;29360;14555;43915;465210;166370;631580
2022.02_01-07-2022;Республика Коми;45_75_days;CoviVac;399;99;498;465210;166370;631580
2022.02_01-07-2022;Республика Коми;45_75_days;EpiVacCorona;948;416;1364;465210;166370;631580
2022.02_01-07-2022;Республика Коми;45_75_days;SputnikLite;11300;6590;17890;465210;166370;631580
2022.02_01-07-2022;Республика Коми;45_75_days;SputnikV;16713;7450;24163;465210;166370;631580
2022.02_01-07-2022;Республика Коми;75_90_days;AllVaccines;18554;9933;28487;465210;166370;631580
2022.02_01-07-2022;Республика Коми;75_90_days;CoviVac;212;46;258;465210;166370;631580
2022.02_01-07-2022;Республика Коми;75_90_days;EpiVacCorona;326;127;453;465210;166370;631580
2022.02_01-07-2022;Республика Коми;75_90_days;SputnikLite;10608;6141;16749;465210;166370;631580
2022.02_01-07-2022;Республика Коми;75_90_days;SputnikV;7408;3619;11027;465210;166370;631580
2022.02_01-07-2022;Республика Коми;90_105_days;AllVaccines;14739;7836;22575;465210;166370;631580
2022.02_01-07-2022;Республика Коми;90_105_days;CoviVac;245;52;297;465210;166370;631580
2022.02_01-07-2022;Республика Коми;90_105_days;EpiVacCorona;107;35;142;465210;166370;631580
2022.02_01-07-2022;Республика Коми;90_105_days;SputnikLite;10510;5225;15735;465210;166370;631580
2022.02_01-07-2022;Республика Коми;90_105_days;SputnikV;3877;2524;6401;465210;166370;631580
2022.02_01-07-2022;Республика Крым;105_165_days;AllVaccines;83736;36191;119927;1036087;480146;1516233
2022.02_01-07-2022;Республика Крым;105_165_days;CoviVac;1286;357;1643;1036087;480146;1516233
2022.02_01-07-2022;Республика Крым;105_165_days;EpiVacCorona;1024;519;1543;1036087;480146;1516233
2022.02_01-07-2022;Республика Крым;105_165_days;SputnikLite;24399;22265;46664;1036087;480146;1516233
2022.02_01-07-2022;Республика Крым;105_165_days;SputnikV;57027;13050;70077;1036087;480146;1516233
2022.02_01-07-2022;Республика Крым;165_195_days;AllVaccines;61143;15750;76893;1036087;480146;1516233
2022.02_01-07-2022;Республика Крым;165_195_days;CoviVac;605;129;734;1036087;480146;1516233
2022.02_01-07-2022;Республика Крым;165_195_days;EpiVacCorona;1279;621;1900;1036087;480146;1516233
2022.02_01-07-2022;Республика Крым;165_195_days;SputnikLite;2160;1592;3752;1036087;480146;1516233
2022.02_01-07-2022;Республика Крым;165_195_days;SputnikV;57099;13408;70507;1036087;480146;1516233
2022.02_01-07-2022;Республика Крым;21_45_days;AllVaccines;44548;25658;70206;1036087;480146;1516233
2022.02_01-07-2022;Республика Крым;21_45_days;CoviVac;203;61;264;1036087;480146;1516233
2022.02_01-07-2022;Республика Крым;21_45_days;EpiVacCorona;1421;835;2256;1036087;480146;1516233
2022.02_01-07-2022;Республика Крым;21_45_days;SputnikLite;27150;19914;47064;1036087;480146;1516233
2022.02_01-07-2022;Республика Крым;21_45_days;SputnikV;15774;4848;20622;1036087;480146;1516233
2022.02_01-07-2022;Республика Крым;45_75_days;AllVaccines;126415;62217;188632;1036087;480146;1516233
2022.02_01-07-2022;Республика Крым;45_75_days;CoviVac;1010;346;1356;1036087;480146;1516233
2022.02_01-07-2022;Республика Крым;45_75_days;EpiVacCorona;2667;1325;3992;1036087;480146;1516233
2022.02_01-07-2022;Республика Крым;45_75_days;SputnikLite;32314;32700;65014;1036087;480146;1516233
2022.02_01-07-2022;Республика Крым;45_75_days;SputnikV;90424;27846;118270;1036087;480146;1516233
2022.02_01-07-2022;Республика Крым;75_90_days;AllVaccines;140772;42764;183536;1036087;480146;1516233
2022.02_01-07-2022;Республика Крым;75_90_days;CoviVac;841;206;1047;1036087;480146;1516233
2022.02_01-07-2022;Республика Крым;75_90_days;EpiVacCorona;2674;925;3599;1036087;480146;1516233
2022.02_01-07-2022;Республика Крым;75_90_days;SputnikLite;16161;18872;35033;1036087;480146;1516233
2022.02_01-07-2022;Республика Крым;75_90_days;SputnikV;121096;22761;143857;1036087;480146;1516233
2022.02_01-07-2022;Республика Крым;90_105_days;AllVaccines;73484;13324;86808;1036087;480146;1516233
2022.02_01-07-2022;Республика Крым;90_105_days;CoviVac;1206;243;1449;1036087;480146;1516233
2022.02_01-07-2022;Республика Крым;90_105_days;EpiVacCorona;2927;820;3747;1036087;480146;1516233
2022.02_01-07-2022;Республика Крым;90_105_days;SputnikLite;2732;2135;4867;1036087;480146;1516233
2022.02_01-07-2022;Республика Крым;90_105_days;SputnikV;66619;10126;76745;1036087;480146;1516233
2022.02_01-07-2022;Республика Марий Эл;105_165_days;AllVaccines;52287;15930;68217;370626;156749;527375
2022.02_01-07-2022;Республика Марий Эл;105_165_days;CoviVac;40;10;50;370626;156749;527375
2022.02_01-07-2022;Республика Марий Эл;105_165_days;EpiVacCorona;174;77;251;370626;156749;527375
2022.02_01-07-2022;Республика Марий Эл;105_165_days;SputnikLite;41614;10851;52465;370626;156749;527375
2022.02_01-07-2022;Республика Марий Эл;105_165_days;SputnikV;10459;4992;15451;370626;156749;527375
2022.02_01-07-2022;Республика Марий Эл;165_195_days;AllVaccines;50533;7727;58260;370626;156749;527375
2022.02_01-07-2022;Республика Марий Эл;165_195_days;CoviVac;261;43;304;370626;156749;527375
2022.02_01-07-2022;Республика Марий Эл;165_195_days;EpiVacCorona;421;222;643;370626;156749;527375
2022.02_01-07-2022;Республика Марий Эл;165_195_days;SputnikLite;23300;1753;25053;370626;156749;527375
2022.02_01-07-2022;Республика Марий Эл;165_195_days;SputnikV;26551;5709;32260;370626;156749;527375
2022.02_01-07-2022;Республика Марий Эл;21_45_days;AllVaccines;11913;6584;18497;370626;156749;527375
2022.02_01-07-2022;Республика Марий Эл;21_45_days;CoviVac;82;45;127;370626;156749;527375
2022.02_01-07-2022;Республика Марий Эл;21_45_days;EpiVacCorona;350;210;560;370626;156749;527375
2022.02_01-07-2022;Республика Марий Эл;21_45_days;SputnikLite;8051;4806;12857;370626;156749;527375
2022.02_01-07-2022;Республика Марий Эл;21_45_days;SputnikV;3430;1523;4953;370626;156749;527375
2022.02_01-07-2022;Республика Марий Эл;45_75_days;AllVaccines;41121;15682;56803;370626;156749;527375
2022.02_01-07-2022;Республика Марий Эл;45_75_days;CoviVac;471;139;610;370626;156749;527375
2022.02_01-07-2022;Республика Марий Эл;45_75_days;EpiVacCorona;1652;681;2333;370626;156749;527375
2022.02_01-07-2022;Республика Марий Эл;45_75_days;SputnikLite;14585;6046;20631;370626;156749;527375
2022.02_01-07-2022;Республика Марий Эл;45_75_days;SputnikV;24413;8816;33229;370626;156749;527375
2022.02_01-07-2022;Республика Марий Эл;75_90_days;AllVaccines;27687;10186;37873;370626;156749;527375
2022.02_01-07-2022;Республика Марий Эл;75_90_days;CoviVac;186;50;236;370626;156749;527375
2022.02_01-07-2022;Республика Марий Эл;75_90_days;EpiVacCorona;2250;540;2790;370626;156749;527375
2022.02_01-07-2022;Республика Марий Эл;75_90_days;SputnikLite;10018;4435;14453;370626;156749;527375
2022.02_01-07-2022;Республика Марий Эл;75_90_days;SputnikV;15233;5161;20394;370626;156749;527375
2022.02_01-07-2022;Республика Марий Эл;90_105_days;AllVaccines;15550;7784;23334;370626;156749;527375
2022.02_01-07-2022;Республика Марий Эл;90_105_days;CoviVac;239;72;311;370626;156749;527375
2022.02_01-07-2022;Республика Марий Эл;90_105_days;EpiVacCorona;1130;371;1501;370626;156749;527375
2022.02_01-07-2022;Республика Марий Эл;90_105_days;SputnikLite;4809;3550;8359;370626;156749;527375
2022.02_01-07-2022;Республика Марий Эл;90_105_days;SputnikV;9372;3791;13163;370626;156749;527375
2022.02_01-07-2022;Республика Мордовия;105_165_days;AllVaccines;52025;35978;88003;448319;198808;647127
2022.02_01-07-2022;Республика Мордовия;105_165_days;CoviVac;42;3;45;448319;198808;647127
2022.02_01-07-2022;Республика Мордовия;105_165_days;EpiVacCorona;232;121;353;448319;198808;647127
2022.02_01-07-2022;Республика Мордовия;105_165_days;SputnikLite;32554;20180;52734;448319;198808;647127
2022.02_01-07-2022;Республика Мордовия;105_165_days;SputnikV;19197;15674;34871;448319;198808;647127
2022.02_01-07-2022;Республика Мордовия;165_195_days;AllVaccines;57265;12496;69761;448319;198808;647127
2022.02_01-07-2022;Республика Мордовия;165_195_days;CoviVac;154;23;177;448319;198808;647127
2022.02_01-07-2022;Республика Мордовия;165_195_days;EpiVacCorona;479;122;601;448319;198808;647127
2022.02_01-07-2022;Республика Мордовия;165_195_days;SputnikLite;12598;3649;16247;448319;198808;647127
2022.02_01-07-2022;Республика Мордовия;165_195_days;SputnikV;44034;8702;52736;448319;198808;647127
2022.02_01-07-2022;Республика Мордовия;21_45_days;AllVaccines;23371;10745;34116;448319;198808;647127
2022.02_01-07-2022;Республика Мордовия;21_45_days;CoviVac;176;48;224;448319;198808;647127
2022.02_01-07-2022;Республика Мордовия;21_45_days;EpiVacCorona;975;576;1551;448319;198808;647127
2022.02_01-07-2022;Республика Мордовия;21_45_days;SputnikLite;17727;7354;25081;448319;198808;647127
2022.02_01-07-2022;Республика Мордовия;21_45_days;SputnikV;4493;2767;7260;448319;198808;647127
2022.02_01-07-2022;Республика Мордовия;45_75_days;AllVaccines;39637;20803;60440;448319;198808;647127
2022.02_01-07-2022;Республика Мордовия;45_75_days;CoviVac;739;219;958;448319;198808;647127
2022.02_01-07-2022;Республика Мордовия;45_75_days;EpiVacCorona;1380;597;1977;448319;198808;647127
2022.02_01-07-2022;Республика Мордовия;45_75_days;SputnikLite;14569;9058;23627;448319;198808;647127
2022.02_01-07-2022;Республика Мордовия;45_75_days;SputnikV;22949;10929;33878;448319;198808;647127
2022.02_01-07-2022;Республика Мордовия;75_90_days;AllVaccines;31673;18506;50179;448319;198808;647127
2022.02_01-07-2022;Республика Мордовия;75_90_days;CoviVac;582;140;722;448319;198808;647127
2022.02_01-07-2022;Республика Мордовия;75_90_days;EpiVacCorona;795;279;1074;448319;198808;647127
2022.02_01-07-2022;Республика Мордовия;75_90_days;SputnikLite;12003;8907;20910;448319;198808;647127
2022.02_01-07-2022;Республика Мордовия;75_90_days;SputnikV;18293;9180;27473;448319;198808;647127
2022.02_01-07-2022;Республика Мордовия;90_105_days;AllVaccines;20664;9992;30656;448319;198808;647127
2022.02_01-07-2022;Республика Мордовия;90_105_days;CoviVac;355;108;463;448319;198808;647127
2022.02_01-07-2022;Республика Мордовия;90_105_days;EpiVacCorona;712;217;929;448319;198808;647127
2022.02_01-07-2022;Республика Мордовия;90_105_days;SputnikLite;4804;3799;8603;448319;198808;647127
2022.02_01-07-2022;Республика Мордовия;90_105_days;SputnikV;14793;5868;20661;448319;198808;647127
2022.02_01-07-2022;Республика Саха (Якутия);105_165_days;AllVaccines;58109;13879;71988;568643;148395;717038
2022.02_01-07-2022;Республика Саха (Якутия);105_165_days;CoviVac;28;8;36;568643;148395;717038
2022.02_01-07-2022;Республика Саха (Якутия);105_165_days;EpiVacCorona;1907;405;2312;568643;148395;717038
2022.02_01-07-2022;Республика Саха (Якутия);105_165_days;SputnikLite;43084;10184;53268;568643;148395;717038
2022.02_01-07-2022;Республика Саха (Якутия);105_165_days;SputnikV;13090;3282;16372;568643;148395;717038
2022.02_01-07-2022;Республика Саха (Якутия);165_195_days;AllVaccines;61719;6180;67899;568643;148395;717038
2022.02_01-07-2022;Республика Саха (Якутия);165_195_days;CoviVac;15;1;16;568643;148395;717038
2022.02_01-07-2022;Республика Саха (Якутия);165_195_days;EpiVacCorona;13279;2114;15393;568643;148395;717038
2022.02_01-07-2022;Республика Саха (Якутия);165_195_days;SputnikLite;32955;2172;35127;568643;148395;717038
2022.02_01-07-2022;Республика Саха (Якутия);165_195_days;SputnikV;15470;1893;17363;568643;148395;717038
2022.02_01-07-2022;Республика Саха (Якутия);21_45_days;AllVaccines;24286;6288;30574;568643;148395;717038
2022.02_01-07-2022;Республика Саха (Якутия);21_45_days;CoviVac;205;22;227;568643;148395;717038
2022.02_01-07-2022;Республика Саха (Якутия);21_45_days;EpiVacCorona;266;90;356;568643;148395;717038
2022.02_01-07-2022;Республика Саха (Якутия);21_45_days;SputnikLite;16539;4098;20637;568643;148395;717038
2022.02_01-07-2022;Республика Саха (Якутия);21_45_days;SputnikV;7276;2078;9354;568643;148395;717038
2022.02_01-07-2022;Республика Саха (Якутия);45_75_days;AllVaccines;42263;12387;54650;568643;148395;717038
2022.02_01-07-2022;Республика Саха (Якутия);45_75_days;CoviVac;889;116;1005;568643;148395;717038
2022.02_01-07-2022;Республика Саха (Якутия);45_75_days;EpiVacCorona;389;172;561;568643;148395;717038
2022.02_01-07-2022;Республика Саха (Якутия);45_75_days;SputnikLite;18101;5815;23916;568643;148395;717038
2022.02_01-07-2022;Республика Саха (Якутия);45_75_days;SputnikV;22884;6284;29168;568643;148395;717038
2022.02_01-07-2022;Республика Саха (Якутия);75_90_days;AllVaccines;24936;7426;32362;568643;148395;717038
2022.02_01-07-2022;Республика Саха (Якутия);75_90_days;CoviVac;742;118;860;568643;148395;717038
2022.02_01-07-2022;Республика Саха (Якутия);75_90_days;EpiVacCorona;179;87;266;568643;148395;717038
2022.02_01-07-2022;Республика Саха (Якутия);75_90_days;SputnikLite;11633;3908;15541;568643;148395;717038
2022.02_01-07-2022;Республика Саха (Якутия);75_90_days;SputnikV;12382;3313;15695;568643;148395;717038
2022.02_01-07-2022;Республика Саха (Якутия);90_105_days;AllVaccines;23484;6900;30384;568643;148395;717038
2022.02_01-07-2022;Республика Саха (Якутия);90_105_days;CoviVac;196;61;257;568643;148395;717038
2022.02_01-07-2022;Республика Саха (Якутия);90_105_days;EpiVacCorona;219;100;319;568643;148395;717038
2022.02_01-07-2022;Республика Саха (Якутия);90_105_days;SputnikLite;18268;5361;23629;568643;148395;717038
2022.02_01-07-2022;Республика Саха (Якутия);90_105_days;SputnikV;4801;1378;6179;568643;148395;717038
2022.02_01-07-2022;Республика Северная Осетия - Алания;105_165_days;AllVaccines;24168;6027;30195;385443;144230;529673
2022.02_01-07-2022;Республика Северная Осетия - Алания;105_165_days;CoviVac;20;2;22;385443;144230;529673
2022.02_01-07-2022;Республика Северная Осетия - Алания;105_165_days;EpiVacCorona;287;61;348;385443;144230;529673
2022.02_01-07-2022;Республика Северная Осетия - Алания;105_165_days;SputnikLite;11796;3049;14845;385443;144230;529673
2022.02_01-07-2022;Республика Северная Осетия - Алания;105_165_days;SputnikV;12065;2915;14980;385443;144230;529673
2022.02_01-07-2022;Республика Северная Осетия - Алания;165_195_days;AllVaccines;27270;4667;31937;385443;144230;529673
2022.02_01-07-2022;Республика Северная Осетия - Алания;165_195_days;CoviVac;5;6;11;385443;144230;529673
2022.02_01-07-2022;Республика Северная Осетия - Алания;165_195_days;EpiVacCorona;313;38;351;385443;144230;529673
2022.02_01-07-2022;Республика Северная Осетия - Алания;165_195_days;SputnikLite;3942;647;4589;385443;144230;529673
2022.02_01-07-2022;Республика Северная Осетия - Алания;165_195_days;SputnikV;23010;3976;26986;385443;144230;529673
2022.02_01-07-2022;Республика Северная Осетия - Алания;21_45_days;AllVaccines;8770;2779;11549;385443;144230;529673
2022.02_01-07-2022;Республика Северная Осетия - Алания;21_45_days;CoviVac;47;19;66;385443;144230;529673
2022.02_01-07-2022;Республика Северная Осетия - Алания;21_45_days;EpiVacCorona;1544;478;2022;385443;144230;529673
2022.02_01-07-2022;Республика Северная Осетия - Алания;21_45_days;SputnikLite;4254;1454;5708;385443;144230;529673
2022.02_01-07-2022;Республика Северная Осетия - Алания;21_45_days;SputnikV;2925;828;3753;385443;144230;529673
2022.02_01-07-2022;Республика Северная Осетия - Алания;45_75_days;AllVaccines;24160;4789;28949;385443;144230;529673
2022.02_01-07-2022;Республика Северная Осетия - Алания;45_75_days;CoviVac;222;80;302;385443;144230;529673
2022.02_01-07-2022;Республика Северная Осетия - Алания;45_75_days;EpiVacCorona;798;153;951;385443;144230;529673
2022.02_01-07-2022;Республика Северная Осетия - Алания;45_75_days;SputnikLite;9150;2048;11198;385443;144230;529673
2022.02_01-07-2022;Республика Северная Осетия - Алания;45_75_days;SputnikV;13990;2508;16498;385443;144230;529673
2022.02_01-07-2022;Республика Северная Осетия - Алания;75_90_days;AllVaccines;16576;3140;19716;385443;144230;529673
2022.02_01-07-2022;Республика Северная Осетия - Алания;75_90_days;CoviVac;337;65;402;385443;144230;529673
2022.02_01-07-2022;Республика Северная Осетия - Алания;75_90_days;EpiVacCorona;363;38;401;385443;144230;529673
2022.02_01-07-2022;Республика Северная Осетия - Алания;75_90_days;SputnikLite;6876;1613;8489;385443;144230;529673
2022.02_01-07-2022;Республика Северная Осетия - Алания;75_90_days;SputnikV;9000;1424;10424;385443;144230;529673
2022.02_01-07-2022;Республика Северная Осетия - Алания;90_105_days;AllVaccines;15934;3421;19355;385443;144230;529673
2022.02_01-07-2022;Республика Северная Осетия - Алания;90_105_days;CoviVac;168;67;235;385443;144230;529673
2022.02_01-07-2022;Республика Северная Осетия - Алания;90_105_days;EpiVacCorona;222;23;245;385443;144230;529673
2022.02_01-07-2022;Республика Северная Осетия - Алания;90_105_days;SputnikLite;9516;1943;11459;385443;144230;529673
2022.02_01-07-2022;Республика Северная Осетия - Алания;90_105_days;SputnikV;6028;1388;7416;385443;144230;529673
2022.02_01-07-2022;Республика Татарстан;105_165_days;AllVaccines;244270;73515;317785;2180132;866477;3046609
2022.02_01-07-2022;Республика Татарстан;105_165_days;CoviVac;5162;924;6086;2180132;866477;3046609
2022.02_01-07-2022;Республика Татарстан;105_165_days;EpiVacCorona;4630;2208;6838;2180132;866477;3046609
2022.02_01-07-2022;Республика Татарстан;105_165_days;SputnikLite;82799;27838;110637;2180132;866477;3046609
2022.02_01-07-2022;Республика Татарстан;105_165_days;SputnikV;151679;42545;194224;2180132;866477;3046609
2022.02_01-07-2022;Республика Татарстан;165_195_days;AllVaccines;193803;32223;226026;2180132;866477;3046609
2022.02_01-07-2022;Республика Татарстан;165_195_days;CoviVac;4791;639;5430;2180132;866477;3046609
2022.02_01-07-2022;Республика Татарстан;165_195_days;EpiVacCorona;4862;1538;6400;2180132;866477;3046609
2022.02_01-07-2022;Республика Татарстан;165_195_days;SputnikLite;23268;2950;26218;2180132;866477;3046609
2022.02_01-07-2022;Республика Татарстан;165_195_days;SputnikV;160882;27096;187978;2180132;866477;3046609
2022.02_01-07-2022;Республика Татарстан;21_45_days;AllVaccines;56674;33463;90137;2180132;866477;3046609
2022.02_01-07-2022;Республика Татарстан;21_45_days;CoviVac;233;75;308;2180132;866477;3046609
2022.02_01-07-2022;Республика Татарстан;21_45_days;EpiVacCorona;869;733;1602;2180132;866477;3046609
2022.02_01-07-2022;Республика Татарстан;21_45_days;SputnikLite;28165;19292;47457;2180132;866477;3046609
2022.02_01-07-2022;Республика Татарстан;21_45_days;SputnikV;27407;13363;40770;2180132;866477;3046609
2022.02_01-07-2022;Республика Татарстан;45_75_days;AllVaccines;214759;98162;312921;2180132;866477;3046609
2022.02_01-07-2022;Республика Татарстан;45_75_days;CoviVac;781;304;1085;2180132;866477;3046609
2022.02_01-07-2022;Республика Татарстан;45_75_days;EpiVacCorona;3878;2933;6811;2180132;866477;3046609
2022.02_01-07-2022;Республика Татарстан;45_75_days;SputnikLite;33520;26178;59698;2180132;866477;3046609
2022.02_01-07-2022;Республика Татарстан;45_75_days;SputnikV;176580;68747;245327;2180132;866477;3046609
2022.02_01-07-2022;Республика Татарстан;75_90_days;AllVaccines;224286;70711;294997;2180132;866477;3046609
2022.02_01-07-2022;Республика Татарстан;75_90_days;CoviVac;1104;278;1382;2180132;866477;3046609
2022.02_01-07-2022;Республика Татарстан;75_90_days;EpiVacCorona;3494;1870;5364;2180132;866477;3046609
2022.02_01-07-2022;Республика Татарстан;75_90_days;SputnikLite;25772;17538;43310;2180132;866477;3046609
2022.02_01-07-2022;Республика Татарстан;75_90_days;SputnikV;193916;51025;244941;2180132;866477;3046609
2022.02_01-07-2022;Республика Татарстан;90_105_days;AllVaccines;285133;71051;356184;2180132;866477;3046609
2022.02_01-07-2022;Республика Татарстан;90_105_days;CoviVac;838;136;974;2180132;866477;3046609
2022.02_01-07-2022;Республика Татарстан;90_105_days;EpiVacCorona;6024;2295;8319;2180132;866477;3046609
2022.02_01-07-2022;Республика Татарстан;90_105_days;SputnikLite;25726;10905;36631;2180132;866477;3046609
2022.02_01-07-2022;Республика Татарстан;90_105_days;SputnikV;252545;57715;310260;2180132;866477;3046609
2022.02_01-07-2022;Республика Тыва;105_165_days;AllVaccines;23319;5542;28861;176122;31028;207150
2022.02_01-07-2022;Республика Тыва;105_165_days;CoviVac;39;3;42;176122;31028;207150
2022.02_01-07-2022;Республика Тыва;105_165_days;EpiVacCorona;48;10;58;176122;31028;207150
2022.02_01-07-2022;Республика Тыва;105_165_days;SputnikLite;19786;4714;24500;176122;31028;207150
2022.02_01-07-2022;Республика Тыва;105_165_days;SputnikV;3446;815;4261;176122;31028;207150
2022.02_01-07-2022;Республика Тыва;165_195_days;AllVaccines;20875;1851;22726;176122;31028;207150
2022.02_01-07-2022;Республика Тыва;165_195_days;CoviVac;172;9;181;176122;31028;207150
2022.02_01-07-2022;Республика Тыва;165_195_days;EpiVacCorona;50;8;58;176122;31028;207150
2022.02_01-07-2022;Республика Тыва;165_195_days;SputnikLite;10396;583;10979;176122;31028;207150
2022.02_01-07-2022;Республика Тыва;165_195_days;SputnikV;10257;1251;11508;176122;31028;207150
2022.02_01-07-2022;Республика Тыва;21_45_days;AllVaccines;10250;2110;12360;176122;31028;207150
2022.02_01-07-2022;Республика Тыва;21_45_days;CoviVac;2;0;2;176122;31028;207150
2022.02_01-07-2022;Республика Тыва;21_45_days;EpiVacCorona;58;5;63;176122;31028;207150
2022.02_01-07-2022;Республика Тыва;21_45_days;SputnikLite;8222;1784;10006;176122;31028;207150
2022.02_01-07-2022;Республика Тыва;21_45_days;SputnikV;1968;321;2289;176122;31028;207150
2022.02_01-07-2022;Республика Тыва;45_75_days;AllVaccines;11266;2117;13383;176122;31028;207150
2022.02_01-07-2022;Республика Тыва;45_75_days;CoviVac;1;0;1;176122;31028;207150
2022.02_01-07-2022;Республика Тыва;45_75_days;EpiVacCorona;120;13;133;176122;31028;207150
2022.02_01-07-2022;Республика Тыва;45_75_days;SputnikLite;6015;1397;7412;176122;31028;207150
2022.02_01-07-2022;Республика Тыва;45_75_days;SputnikV;5130;707;5837;176122;31028;207150
2022.02_01-07-2022;Республика Тыва;75_90_days;AllVaccines;8186;1876;10062;176122;31028;207150
2022.02_01-07-2022;Республика Тыва;75_90_days;CoviVac;10;0;10;176122;31028;207150
2022.02_01-07-2022;Республика Тыва;75_90_days;EpiVacCorona;66;12;78;176122;31028;207150
2022.02_01-07-2022;Республика Тыва;75_90_days;SputnikLite;5198;1431;6629;176122;31028;207150
2022.02_01-07-2022;Республика Тыва;75_90_days;SputnikV;2912;433;3345;176122;31028;207150
2022.02_01-07-2022;Республика Тыва;90_105_days;AllVaccines;10609;2087;12696;176122;31028;207150
2022.02_01-07-2022;Республика Тыва;90_105_days;CoviVac;14;2;16;176122;31028;207150
2022.02_01-07-2022;Республика Тыва;90_105_days;EpiVacCorona;24;10;34;176122;31028;207150
2022.02_01-07-2022;Республика Тыва;90_105_days;SputnikLite;8845;1668;10513;176122;31028;207150
2022.02_01-07-2022;Республика Тыва;90_105_days;SputnikV;1726;407;2133;176122;31028;207150
2022.02_01-07-2022;Республика Хакасия;105_165_days;AllVaccines;24158;10531;34689;291439;112190;403629
2022.02_01-07-2022;Республика Хакасия;105_165_days;CoviVac;418;171;589;291439;112190;403629
2022.02_01-07-2022;Республика Хакасия;105_165_days;EpiVacCorona;171;69;240;291439;112190;403629
2022.02_01-07-2022;Республика Хакасия;105_165_days;SputnikLite;13380;6613;19993;291439;112190;403629
2022.02_01-07-2022;Республика Хакасия;105_165_days;SputnikV;10189;3678;13867;291439;112190;403629
2022.02_01-07-2022;Республика Хакасия;165_195_days;AllVaccines;38851;7076;45927;291439;112190;403629
2022.02_01-07-2022;Республика Хакасия;165_195_days;CoviVac;322;71;393;291439;112190;403629
2022.02_01-07-2022;Республика Хакасия;165_195_days;EpiVacCorona;407;96;503;291439;112190;403629
2022.02_01-07-2022;Республика Хакасия;165_195_days;SputnikLite;5025;785;5810;291439;112190;403629
2022.02_01-07-2022;Республика Хакасия;165_195_days;SputnikV;33097;6124;39221;291439;112190;403629
2022.02_01-07-2022;Республика Хакасия;21_45_days;AllVaccines;10841;4757;15598;291439;112190;403629
2022.02_01-07-2022;Республика Хакасия;21_45_days;CoviVac;169;46;215;291439;112190;403629
2022.02_01-07-2022;Республика Хакасия;21_45_days;EpiVacCorona;335;121;456;291439;112190;403629
2022.02_01-07-2022;Республика Хакасия;21_45_days;SputnikLite;7489;3490;10979;291439;112190;403629
2022.02_01-07-2022;Республика Хакасия;21_45_days;SputnikV;2848;1100;3948;291439;112190;403629
2022.02_01-07-2022;Республика Хакасия;45_75_days;AllVaccines;18346;8765;27111;291439;112190;403629
2022.02_01-07-2022;Республика Хакасия;45_75_days;CoviVac;285;74;359;291439;112190;403629
2022.02_01-07-2022;Республика Хакасия;45_75_days;EpiVacCorona;472;206;678;291439;112190;403629
2022.02_01-07-2022;Республика Хакасия;45_75_days;SputnikLite;6939;3888;10827;291439;112190;403629
2022.02_01-07-2022;Республика Хакасия;45_75_days;SputnikV;10650;4597;15247;291439;112190;403629
2022.02_01-07-2022;Республика Хакасия;75_90_days;AllVaccines;11679;6590;18269;291439;112190;403629
2022.02_01-07-2022;Республика Хакасия;75_90_days;CoviVac;244;59;303;291439;112190;403629
2022.02_01-07-2022;Республика Хакасия;75_90_days;EpiVacCorona;270;148;418;291439;112190;403629
2022.02_01-07-2022;Республика Хакасия;75_90_days;SputnikLite;5063;3536;8599;291439;112190;403629
2022.02_01-07-2022;Республика Хакасия;75_90_days;SputnikV;6102;2847;8949;291439;112190;403629
2022.02_01-07-2022;Республика Хакасия;90_105_days;AllVaccines;9026;5596;14622;291439;112190;403629
2022.02_01-07-2022;Республика Хакасия;90_105_days;CoviVac;238;100;338;291439;112190;403629
2022.02_01-07-2022;Республика Хакасия;90_105_days;EpiVacCorona;132;57;189;291439;112190;403629
2022.02_01-07-2022;Республика Хакасия;90_105_days;SputnikLite;5064;3613;8677;291439;112190;403629
2022.02_01-07-2022;Республика Хакасия;90_105_days;SputnikV;3592;1826;5418;291439;112190;403629
2022.02_01-07-2022;Ростовская область;105_165_days;AllVaccines;229631;91188;320819;2367942;1020468;3388410
2022.02_01-07-2022;Ростовская область;105_165_days;CoviVac;2118;726;2844;2367942;1020468;3388410
2022.02_01-07-2022;Ростовская область;105_165_days;EpiVacCorona;3238;1397;4635;2367942;1020468;3388410
2022.02_01-07-2022;Ростовская область;105_165_days;SputnikLite;65639;39431;105070;2367942;1020468;3388410
2022.02_01-07-2022;Ростовская область;105_165_days;SputnikV;158636;49634;208270;2367942;1020468;3388410
2022.02_01-07-2022;Ростовская область;165_195_days;AllVaccines;378115;67090;445205;2367942;1020468;3388410
2022.02_01-07-2022;Ростовская область;165_195_days;CoviVac;3439;644;4083;2367942;1020468;3388410
2022.02_01-07-2022;Ростовская область;165_195_days;EpiVacCorona;5083;1448;6531;2367942;1020468;3388410
2022.02_01-07-2022;Ростовская область;165_195_days;SputnikLite;43403;7914;51317;2367942;1020468;3388410
2022.02_01-07-2022;Ростовская область;165_195_days;SputnikV;326190;57084;383274;2367942;1020468;3388410
2022.02_01-07-2022;Ростовская область;21_45_days;AllVaccines;74007;36387;110394;2367942;1020468;3388410
2022.02_01-07-2022;Ростовская область;21_45_days;CoviVac;360;152;512;2367942;1020468;3388410
2022.02_01-07-2022;Ростовская область;21_45_days;EpiVacCorona;640;387;1027;2367942;1020468;3388410
2022.02_01-07-2022;Ростовская область;21_45_days;SputnikLite;37024;17106;54130;2367942;1020468;3388410
2022.02_01-07-2022;Ростовская область;21_45_days;SputnikV;35983;18742;54725;2367942;1020468;3388410
2022.02_01-07-2022;Ростовская область;45_75_days;AllVaccines;149679;88614;238293;2367942;1020468;3388410
2022.02_01-07-2022;Ростовская область;45_75_days;CoviVac;951;418;1369;2367942;1020468;3388410
2022.02_01-07-2022;Ростовская область;45_75_days;EpiVacCorona;1011;798;1809;2367942;1020468;3388410
2022.02_01-07-2022;Ростовская область;45_75_days;SputnikLite;35172;24548;59720;2367942;1020468;3388410
2022.02_01-07-2022;Ростовская область;45_75_days;SputnikV;112545;62850;175395;2367942;1020468;3388410
2022.02_01-07-2022;Ростовская область;75_90_days;AllVaccines;85173;46530;131703;2367942;1020468;3388410
2022.02_01-07-2022;Ростовская область;75_90_days;CoviVac;929;360;1289;2367942;1020468;3388410
2022.02_01-07-2022;Ростовская область;75_90_days;EpiVacCorona;942;425;1367;2367942;1020468;3388410
2022.02_01-07-2022;Ростовская область;75_90_days;SputnikLite;21646;16851;38497;2367942;1020468;3388410
2022.02_01-07-2022;Ростовская область;75_90_days;SputnikV;61656;28894;90550;2367942;1020468;3388410
2022.02_01-07-2022;Ростовская область;90_105_days;AllVaccines;51567;27176;78743;2367942;1020468;3388410
2022.02_01-07-2022;Ростовская область;90_105_days;CoviVac;961;420;1381;2367942;1020468;3388410
2022.02_01-07-2022;Ростовская область;90_105_days;EpiVacCorona;844;376;1220;2367942;1020468;3388410
2022.02_01-07-2022;Ростовская область;90_105_days;SputnikLite;10848;7638;18486;2367942;1020468;3388410
2022.02_01-07-2022;Ростовская область;90_105_days;SputnikV;38914;18742;57656;2367942;1020468;3388410
2022.02_01-07-2022;Рязанская область;105_165_days;AllVaccines;56732;26898;83630;600731;301318;902049
2022.02_01-07-2022;Рязанская область;105_165_days;CoviVac;614;124;738;600731;301318;902049
2022.02_01-07-2022;Рязанская область;105_165_days;EpiVacCorona;949;291;1240;600731;301318;902049
2022.02_01-07-2022;Рязанская область;105_165_days;SputnikLite;26115;17091;43206;600731;301318;902049
2022.02_01-07-2022;Рязанская область;105_165_days;SputnikV;29054;9392;38446;600731;301318;902049
2022.02_01-07-2022;Рязанская область;165_195_days;AllVaccines;46134;13015;59149;600731;301318;902049
2022.02_01-07-2022;Рязанская область;165_195_days;CoviVac;306;42;348;600731;301318;902049
2022.02_01-07-2022;Рязанская область;165_195_days;EpiVacCorona;1093;424;1517;600731;301318;902049
2022.02_01-07-2022;Рязанская область;165_195_days;SputnikLite;5906;3085;8991;600731;301318;902049
2022.02_01-07-2022;Рязанская область;165_195_days;SputnikV;38829;9464;48293;600731;301318;902049
2022.02_01-07-2022;Рязанская область;21_45_days;AllVaccines;24235;12431;36666;600731;301318;902049
2022.02_01-07-2022;Рязанская область;21_45_days;CoviVac;301;79;380;600731;301318;902049
2022.02_01-07-2022;Рязанская область;21_45_days;EpiVacCorona;718;288;1006;600731;301318;902049
2022.02_01-07-2022;Рязанская область;21_45_days;SputnikLite;13076;8662;21738;600731;301318;902049
2022.02_01-07-2022;Рязанская область;21_45_days;SputnikV;10140;3402;13542;600731;301318;902049
2022.02_01-07-2022;Рязанская область;45_75_days;AllVaccines;59960;33807;93767;600731;301318;902049
2022.02_01-07-2022;Рязанская область;45_75_days;CoviVac;992;319;1311;600731;301318;902049
2022.02_01-07-2022;Рязанская область;45_75_days;EpiVacCorona;1288;601;1889;600731;301318;902049
2022.02_01-07-2022;Рязанская область;45_75_days;SputnikLite;13003;13775;26778;600731;301318;902049
2022.02_01-07-2022;Рязанская область;45_75_days;SputnikV;44677;19112;63789;600731;301318;902049
2022.02_01-07-2022;Рязанская область;75_90_days;AllVaccines;47711;18231;65942;600731;301318;902049
2022.02_01-07-2022;Рязанская область;75_90_days;CoviVac;723;162;885;600731;301318;902049
2022.02_01-07-2022;Рязанская область;75_90_days;EpiVacCorona;1793;450;2243;600731;301318;902049
2022.02_01-07-2022;Рязанская область;75_90_days;SputnikLite;5184;5985;11169;600731;301318;902049
2022.02_01-07-2022;Рязанская область;75_90_days;SputnikV;40011;11634;51645;600731;301318;902049
2022.02_01-07-2022;Рязанская область;90_105_days;AllVaccines;41539;10285;51824;600731;301318;902049
2022.02_01-07-2022;Рязанская область;90_105_days;CoviVac;659;130;789;600731;301318;902049
2022.02_01-07-2022;Рязанская область;90_105_days;EpiVacCorona;2704;659;3363;600731;301318;902049
2022.02_01-07-2022;Рязанская область;90_105_days;SputnikLite;1847;1362;3209;600731;301318;902049
2022.02_01-07-2022;Рязанская область;90_105_days;SputnikV;36329;8134;44463;600731;301318;902049
2022.02_01-07-2022;Самарская область;105_165_days;AllVaccines;197856;79261;277117;1769846;769791;2539637
2022.02_01-07-2022;Самарская область;105_165_days;CoviVac;2662;712;3374;1769846;769791;2539637
2022.02_01-07-2022;Самарская область;105_165_days;EpiVacCorona;1355;1208;2563;1769846;769791;2539637
2022.02_01-07-2022;Самарская область;105_165_days;SputnikLite;102611;48589;151200;1769846;769791;2539637
2022.02_01-07-2022;Самарская область;105_165_days;SputnikV;91228;28752;119980;1769846;769791;2539637
2022.02_01-07-2022;Самарская область;165_195_days;AllVaccines;252962;40573;293535;1769846;769791;2539637
2022.02_01-07-2022;Самарская область;165_195_days;CoviVac;3011;483;3494;1769846;769791;2539637
2022.02_01-07-2022;Самарская область;165_195_days;EpiVacCorona;5977;1309;7286;1769846;769791;2539637
2022.02_01-07-2022;Самарская область;165_195_days;SputnikLite;60998;9914;70912;1769846;769791;2539637
2022.02_01-07-2022;Самарская область;165_195_days;SputnikV;182976;28867;211843;1769846;769791;2539637
2022.02_01-07-2022;Самарская область;21_45_days;AllVaccines;53381;31626;85007;1769846;769791;2539637
2022.02_01-07-2022;Самарская область;21_45_days;CoviVac;382;165;547;1769846;769791;2539637
2022.02_01-07-2022;Самарская область;21_45_days;EpiVacCorona;788;993;1781;1769846;769791;2539637
2022.02_01-07-2022;Самарская область;21_45_days;SputnikLite;31768;20384;52152;1769846;769791;2539637
2022.02_01-07-2022;Самарская область;21_45_days;SputnikV;20443;10084;30527;1769846;769791;2539637
2022.02_01-07-2022;Самарская область;45_75_days;AllVaccines;155283;86909;242192;1769846;769791;2539637
2022.02_01-07-2022;Самарская область;45_75_days;CoviVac;1223;431;1654;1769846;769791;2539637
2022.02_01-07-2022;Самарская область;45_75_days;EpiVacCorona;2694;2032;4726;1769846;769791;2539637
2022.02_01-07-2022;Самарская область;45_75_days;SputnikLite;36324;29827;66151;1769846;769791;2539637
2022.02_01-07-2022;Самарская область;45_75_days;SputnikV;115042;54619;169661;1769846;769791;2539637
2022.02_01-07-2022;Самарская область;75_90_days;AllVaccines;129753;65379;195132;1769846;769791;2539637
2022.02_01-07-2022;Самарская область;75_90_days;CoviVac;689;225;914;1769846;769791;2539637
2022.02_01-07-2022;Самарская область;75_90_days;EpiVacCorona;1266;727;1993;1769846;769791;2539637
2022.02_01-07-2022;Самарская область;75_90_days;SputnikLite;21850;19623;41473;1769846;769791;2539637
2022.02_01-07-2022;Самарская область;75_90_days;SputnikV;105948;44804;150752;1769846;769791;2539637
2022.02_01-07-2022;Самарская область;90_105_days;AllVaccines;69815;35336;105151;1769846;769791;2539637
2022.02_01-07-2022;Самарская область;90_105_days;CoviVac;317;121;438;1769846;769791;2539637
2022.02_01-07-2022;Самарская область;90_105_days;EpiVacCorona;1285;839;2124;1769846;769791;2539637
2022.02_01-07-2022;Самарская область;90_105_days;SputnikLite;8656;5873;14529;1769846;769791;2539637
2022.02_01-07-2022;Самарская область;90_105_days;SputnikV;59557;28503;88060;1769846;769791;2539637
2022.02_01-07-2022;Саратовская область;105_165_days;AllVaccines;115436;54167;169603;1348454;599954;1948408
2022.02_01-07-2022;Саратовская область;105_165_days;CoviVac;2239;479;2718;1348454;599954;1948408
2022.02_01-07-2022;Саратовская область;105_165_days;EpiVacCorona;1332;816;2148;1348454;599954;1948408
2022.02_01-07-2022;Саратовская область;105_165_days;SputnikLite;59865;28680;88545;1348454;599954;1948408
2022.02_01-07-2022;Саратовская область;105_165_days;SputnikV;52000;24192;76192;1348454;599954;1948408
2022.02_01-07-2022;Саратовская область;165_195_days;AllVaccines;109630;25621;135251;1348454;599954;1948408
2022.02_01-07-2022;Саратовская область;165_195_days;CoviVac;1015;128;1143;1348454;599954;1948408
2022.02_01-07-2022;Саратовская область;165_195_days;EpiVacCorona;1557;794;2351;1348454;599954;1948408
2022.02_01-07-2022;Саратовская область;165_195_days;SputnikLite;20665;5593;26258;1348454;599954;1948408
2022.02_01-07-2022;Саратовская область;165_195_days;SputnikV;86393;19106;105499;1348454;599954;1948408
2022.02_01-07-2022;Саратовская область;21_45_days;AllVaccines;41547;21969;63516;1348454;599954;1948408
2022.02_01-07-2022;Саратовская область;21_45_days;CoviVac;517;147;664;1348454;599954;1948408
2022.02_01-07-2022;Саратовская область;21_45_days;EpiVacCorona;1664;888;2552;1348454;599954;1948408
2022.02_01-07-2022;Саратовская область;21_45_days;SputnikLite;25760;14405;40165;1348454;599954;1948408
2022.02_01-07-2022;Саратовская область;21_45_days;SputnikV;13606;6529;20135;1348454;599954;1948408
2022.02_01-07-2022;Саратовская область;45_75_days;AllVaccines;128465;57337;185802;1348454;599954;1948408
2022.02_01-07-2022;Саратовская область;45_75_days;CoviVac;1089;265;1354;1348454;599954;1948408
2022.02_01-07-2022;Саратовская область;45_75_days;EpiVacCorona;6163;2666;8829;1348454;599954;1948408
2022.02_01-07-2022;Саратовская область;45_75_days;SputnikLite;27538;18907;46445;1348454;599954;1948408
2022.02_01-07-2022;Саратовская область;45_75_days;SputnikV;93675;35499;129174;1348454;599954;1948408
2022.02_01-07-2022;Саратовская область;75_90_days;AllVaccines;85596;38337;123933;1348454;599954;1948408
2022.02_01-07-2022;Саратовская область;75_90_days;CoviVac;262;40;302;1348454;599954;1948408
2022.02_01-07-2022;Саратовская область;75_90_days;EpiVacCorona;3575;1207;4782;1348454;599954;1948408
2022.02_01-07-2022;Саратовская область;75_90_days;SputnikLite;19344;13490;32834;1348454;599954;1948408
2022.02_01-07-2022;Саратовская область;75_90_days;SputnikV;62415;23600;86015;1348454;599954;1948408
2022.02_01-07-2022;Саратовская область;90_105_days;AllVaccines;56754;21515;78269;1348454;599954;1948408
2022.02_01-07-2022;Саратовская область;90_105_days;CoviVac;742;104;846;1348454;599954;1948408
2022.02_01-07-2022;Саратовская область;90_105_days;EpiVacCorona;2169;747;2916;1348454;599954;1948408
2022.02_01-07-2022;Саратовская область;90_105_days;SputnikLite;8532;3678;12210;1348454;599954;1948408
2022.02_01-07-2022;Саратовская область;90_105_days;SputnikV;45311;16986;62297;1348454;599954;1948408
2022.02_01-07-2022;Сахалинская область;105_165_days;AllVaccines;16399;8557;24956;276677;101794;378471
2022.02_01-07-2022;Сахалинская область;105_165_days;CoviVac;36;9;45;276677;101794;378471
2022.02_01-07-2022;Сахалинская область;105_165_days;EpiVacCorona;179;58;237;276677;101794;378471
2022.02_01-07-2022;Сахалинская область;105_165_days;SputnikLite;6424;6122;12546;276677;101794;378471
2022.02_01-07-2022;Сахалинская область;105_165_days;SputnikV;9760;2368;12128;276677;101794;378471
2022.02_01-07-2022;Сахалинская область;165_195_days;AllVaccines;26918;4406;31324;276677;101794;378471
2022.02_01-07-2022;Сахалинская область;165_195_days;CoviVac;137;26;163;276677;101794;378471
2022.02_01-07-2022;Сахалинская область;165_195_days;EpiVacCorona;37;7;44;276677;101794;378471
2022.02_01-07-2022;Сахалинская область;165_195_days;SputnikLite;5364;545;5909;276677;101794;378471
2022.02_01-07-2022;Сахалинская область;165_195_days;SputnikV;21380;3828;25208;276677;101794;378471
2022.02_01-07-2022;Сахалинская область;21_45_days;AllVaccines;13852;5233;19085;276677;101794;378471
2022.02_01-07-2022;Сахалинская область;21_45_days;CoviVac;198;50;248;276677;101794;378471
2022.02_01-07-2022;Сахалинская область;21_45_days;EpiVacCorona;316;90;406;276677;101794;378471
2022.02_01-07-2022;Сахалинская область;21_45_days;SputnikLite;10384;4343;14727;276677;101794;378471
2022.02_01-07-2022;Сахалинская область;21_45_days;SputnikV;2954;750;3704;276677;101794;378471
2022.02_01-07-2022;Сахалинская область;45_75_days;AllVaccines;20646;7563;28209;276677;101794;378471
2022.02_01-07-2022;Сахалинская область;45_75_days;CoviVac;450;75;525;276677;101794;378471
2022.02_01-07-2022;Сахалинская область;45_75_days;EpiVacCorona;1888;396;2284;276677;101794;378471
2022.02_01-07-2022;Сахалинская область;45_75_days;SputnikLite;7358;4481;11839;276677;101794;378471
2022.02_01-07-2022;Сахалинская область;45_75_days;SputnikV;10950;2611;13561;276677;101794;378471
2022.02_01-07-2022;Сахалинская область;75_90_days;AllVaccines;12059;5852;17911;276677;101794;378471
2022.02_01-07-2022;Сахалинская область;75_90_days;CoviVac;44;6;50;276677;101794;378471
2022.02_01-07-2022;Сахалинская область;75_90_days;EpiVacCorona;1686;498;2184;276677;101794;378471
2022.02_01-07-2022;Сахалинская область;75_90_days;SputnikLite;5170;3995;9165;276677;101794;378471
2022.02_01-07-2022;Сахалинская область;75_90_days;SputnikV;5159;1353;6512;276677;101794;378471
2022.02_01-07-2022;Сахалинская область;90_105_days;AllVaccines;8678;5818;14496;276677;101794;378471
2022.02_01-07-2022;Сахалинская область;90_105_days;CoviVac;14;2;16;276677;101794;378471
2022.02_01-07-2022;Сахалинская область;90_105_days;EpiVacCorona;398;218;616;276677;101794;378471
2022.02_01-07-2022;Сахалинская область;90_105_days;SputnikLite;5220;4581;9801;276677;101794;378471
2022.02_01-07-2022;Сахалинская область;90_105_days;SputnikV;3046;1017;4063;276677;101794;378471
2022.02_01-07-2022;Свердловская область;105_165_days;AllVaccines;270562;98974;369536;2364046;987486;3351532
2022.02_01-07-2022;Свердловская область;105_165_days;CoviVac;3855;850;4705;2364046;987486;3351532
2022.02_01-07-2022;Свердловская область;105_165_days;EpiVacCorona;2223;963;3186;2364046;987486;3351532
2022.02_01-07-2022;Свердловская область;105_165_days;SputnikLite;161619;54365;215984;2364046;987486;3351532
2022.02_01-07-2022;Свердловская область;105_165_days;SputnikV;102865;42796;145661;2364046;987486;3351532
2022.02_01-07-2022;Свердловская область;165_195_days;AllVaccines;234916;49285;284201;2364046;987486;3351532
2022.02_01-07-2022;Свердловская область;165_195_days;CoviVac;1616;288;1904;2364046;987486;3351532
2022.02_01-07-2022;Свердловская область;165_195_days;EpiVacCorona;7167;2825;9992;2364046;987486;3351532
2022.02_01-07-2022;Свердловская область;165_195_days;SputnikLite;92009;10824;102833;2364046;987486;3351532
2022.02_01-07-2022;Свердловская область;165_195_days;SputnikV;134124;35348;169472;2364046;987486;3351532
2022.02_01-07-2022;Свердловская область;21_45_days;AllVaccines;84758;47501;132259;2364046;987486;3351532
2022.02_01-07-2022;Свердловская область;21_45_days;CoviVac;236;70;306;2364046;987486;3351532
2022.02_01-07-2022;Свердловская область;21_45_days;EpiVacCorona;2747;1821;4568;2364046;987486;3351532
2022.02_01-07-2022;Свердловская область;21_45_days;SputnikLite;46657;28181;74838;2364046;987486;3351532
2022.02_01-07-2022;Свердловская область;21_45_days;SputnikV;35118;17429;52547;2364046;987486;3351532
2022.02_01-07-2022;Свердловская область;45_75_days;AllVaccines;264734;119575;384309;2364046;987486;3351532
2022.02_01-07-2022;Свердловская область;45_75_days;CoviVac;797;213;1010;2364046;987486;3351532
2022.02_01-07-2022;Свердловская область;45_75_days;EpiVacCorona;5210;2810;8020;2364046;987486;3351532
2022.02_01-07-2022;Свердловская область;45_75_days;SputnikLite;61488;40510;101998;2364046;987486;3351532
2022.02_01-07-2022;Свердловская область;45_75_days;SputnikV;197239;76042;273281;2364046;987486;3351532
2022.02_01-07-2022;Свердловская область;75_90_days;AllVaccines;235488;82396;317884;2364046;987486;3351532
2022.02_01-07-2022;Свердловская область;75_90_days;CoviVac;1063;190;1253;2364046;987486;3351532
2022.02_01-07-2022;Свердловская область;75_90_days;EpiVacCorona;4577;1699;6276;2364046;987486;3351532
2022.02_01-07-2022;Свердловская область;75_90_days;SputnikLite;46503;28463;74966;2364046;987486;3351532
2022.02_01-07-2022;Свердловская область;75_90_days;SputnikV;183345;52044;235389;2364046;987486;3351532
2022.02_01-07-2022;Свердловская область;90_105_days;AllVaccines;90847;30606;121453;2364046;987486;3351532
2022.02_01-07-2022;Свердловская область;90_105_days;CoviVac;2381;455;2836;2364046;987486;3351532
2022.02_01-07-2022;Свердловская область;90_105_days;EpiVacCorona;3520;1261;4781;2364046;987486;3351532
2022.02_01-07-2022;Свердловская область;90_105_days;SputnikLite;10661;4690;15351;2364046;987486;3351532
2022.02_01-07-2022;Свердловская область;90_105_days;SputnikV;74285;24200;98485;2364046;987486;3351532
2022.02_01-07-2022;Смоленская область;105_165_days;AllVaccines;45764;21336;67100;521379;238479;759858
2022.02_01-07-2022;Смоленская область;105_165_days;CoviVac;131;17;148;521379;238479;759858
2022.02_01-07-2022;Смоленская область;105_165_days;EpiVacCorona;484;194;678;521379;238479;759858
2022.02_01-07-2022;Смоленская область;105_165_days;SputnikLite;24136;14158;38294;521379;238479;759858
2022.02_01-07-2022;Смоленская область;105_165_days;SputnikV;21013;6967;27980;521379;238479;759858
2022.02_01-07-2022;Смоленская область;165_195_days;AllVaccines;63579;12876;76455;521379;238479;759858
2022.02_01-07-2022;Смоленская область;165_195_days;CoviVac;537;58;595;521379;238479;759858
2022.02_01-07-2022;Смоленская область;165_195_days;EpiVacCorona;861;237;1098;521379;238479;759858
2022.02_01-07-2022;Смоленская область;165_195_days;SputnikLite;7724;1603;9327;521379;238479;759858
2022.02_01-07-2022;Смоленская область;165_195_days;SputnikV;54457;10978;65435;521379;238479;759858
2022.02_01-07-2022;Смоленская область;21_45_days;AllVaccines;14574;9183;23757;521379;238479;759858
2022.02_01-07-2022;Смоленская область;21_45_days;CoviVac;149;33;182;521379;238479;759858
2022.02_01-07-2022;Смоленская область;21_45_days;EpiVacCorona;743;468;1211;521379;238479;759858
2022.02_01-07-2022;Смоленская область;21_45_days;SputnikLite;8407;6117;14524;521379;238479;759858
2022.02_01-07-2022;Смоленская область;21_45_days;SputnikV;5275;2565;7840;521379;238479;759858
2022.02_01-07-2022;Смоленская область;45_75_days;AllVaccines;31826;21042;52868;521379;238479;759858
2022.02_01-07-2022;Смоленская область;45_75_days;CoviVac;317;86;403;521379;238479;759858
2022.02_01-07-2022;Смоленская область;45_75_days;EpiVacCorona;1471;786;2257;521379;238479;759858
2022.02_01-07-2022;Смоленская область;45_75_days;SputnikLite;9940;9133;19073;521379;238479;759858
2022.02_01-07-2022;Смоленская область;45_75_days;SputnikV;20098;11037;31135;521379;238479;759858
2022.02_01-07-2022;Смоленская область;75_90_days;AllVaccines;17218;10393;27611;521379;238479;759858
2022.02_01-07-2022;Смоленская область;75_90_days;CoviVac;95;18;113;521379;238479;759858
2022.02_01-07-2022;Смоленская область;75_90_days;EpiVacCorona;213;123;336;521379;238479;759858
2022.02_01-07-2022;Смоленская область;75_90_days;SputnikLite;5545;5279;10824;521379;238479;759858
2022.02_01-07-2022;Смоленская область;75_90_days;SputnikV;11365;4973;16338;521379;238479;759858
2022.02_01-07-2022;Смоленская область;90_105_days;AllVaccines;18256;9677;27933;521379;238479;759858
2022.02_01-07-2022;Смоленская область;90_105_days;CoviVac;56;15;71;521379;238479;759858
2022.02_01-07-2022;Смоленская область;90_105_days;EpiVacCorona;144;56;200;521379;238479;759858
2022.02_01-07-2022;Смоленская область;90_105_days;SputnikLite;6596;5740;12336;521379;238479;759858
2022.02_01-07-2022;Смоленская область;90_105_days;SputnikV;11460;3866;15326;521379;238479;759858
2022.02_01-07-2022;Ставропольский край;105_165_days;AllVaccines;106127;55484;161611;1590669;616030;2206699
2022.02_01-07-2022;Ставропольский край;105_165_days;CoviVac;950;332;1282;1590669;616030;2206699
2022.02_01-07-2022;Ставропольский край;105_165_days;EpiVacCorona;802;485;1287;1590669;616030;2206699
2022.02_01-07-2022;Ставропольский край;105_165_days;SputnikLite;56538;34385;90923;1590669;616030;2206699
2022.02_01-07-2022;Ставропольский край;105_165_days;SputnikV;47837;20282;68119;1590669;616030;2206699
2022.02_01-07-2022;Ставропольский край;165_195_days;AllVaccines;135094;25680;160774;1590669;616030;2206699
2022.02_01-07-2022;Ставропольский край;165_195_days;CoviVac;1684;317;2001;1590669;616030;2206699
2022.02_01-07-2022;Ставропольский край;165_195_days;EpiVacCorona;2311;784;3095;1590669;616030;2206699
2022.02_01-07-2022;Ставропольский край;165_195_days;SputnikLite;24293;5814;30107;1590669;616030;2206699
2022.02_01-07-2022;Ставропольский край;165_195_days;SputnikV;106806;18765;125571;1590669;616030;2206699
2022.02_01-07-2022;Ставропольский край;21_45_days;AllVaccines;45839;21342;67181;1590669;616030;2206699
2022.02_01-07-2022;Ставропольский край;21_45_days;CoviVac;366;128;494;1590669;616030;2206699
2022.02_01-07-2022;Ставропольский край;21_45_days;EpiVacCorona;2774;1082;3856;1590669;616030;2206699
2022.02_01-07-2022;Ставропольский край;21_45_days;SputnikLite;23461;14606;38067;1590669;616030;2206699
2022.02_01-07-2022;Ставропольский край;21_45_days;SputnikV;19238;5526;24764;1590669;616030;2206699
2022.02_01-07-2022;Ставропольский край;45_75_days;AllVaccines;142391;50423;192814;1590669;616030;2206699
2022.02_01-07-2022;Ставропольский край;45_75_days;CoviVac;835;272;1107;1590669;616030;2206699
2022.02_01-07-2022;Ставропольский край;45_75_days;EpiVacCorona;3745;1607;5352;1590669;616030;2206699
2022.02_01-07-2022;Ставропольский край;45_75_days;SputnikLite;36961;18138;55099;1590669;616030;2206699
2022.02_01-07-2022;Ставропольский край;45_75_days;SputnikV;100850;30406;131256;1590669;616030;2206699
2022.02_01-07-2022;Ставропольский край;75_90_days;AllVaccines;96981;33908;130889;1590669;616030;2206699
2022.02_01-07-2022;Ставропольский край;75_90_days;CoviVac;770;217;987;1590669;616030;2206699
2022.02_01-07-2022;Ставропольский край;75_90_days;EpiVacCorona;2175;902;3077;1590669;616030;2206699
2022.02_01-07-2022;Ставропольский край;75_90_days;SputnikLite;21246;13272;34518;1590669;616030;2206699
2022.02_01-07-2022;Ставропольский край;75_90_days;SputnikV;72790;19517;92307;1590669;616030;2206699
2022.02_01-07-2022;Ставропольский край;90_105_days;AllVaccines;42572;18767;61339;1590669;616030;2206699
2022.02_01-07-2022;Ставропольский край;90_105_days;CoviVac;798;218;1016;1590669;616030;2206699
2022.02_01-07-2022;Ставропольский край;90_105_days;EpiVacCorona;1330;454;1784;1590669;616030;2206699
2022.02_01-07-2022;Ставропольский край;90_105_days;SputnikLite;11413;5904;17317;1590669;616030;2206699
2022.02_01-07-2022;Ставропольский край;90_105_days;SputnikV;29031;12191;41222;1590669;616030;2206699
2022.02_01-07-2022;Тамбовская область;105_165_days;AllVaccines;58387;37259;95646;545785;279936;825721
2022.02_01-07-2022;Тамбовская область;105_165_days;CoviVac;108;15;123;545785;279936;825721
2022.02_01-07-2022;Тамбовская область;105_165_days;EpiVacCorona;148;286;434;545785;279936;825721
2022.02_01-07-2022;Тамбовская область;105_165_days;SputnikLite;42463;21008;63471;545785;279936;825721
2022.02_01-07-2022;Тамбовская область;105_165_days;SputnikV;15668;15950;31618;545785;279936;825721
2022.02_01-07-2022;Тамбовская область;165_195_days;AllVaccines;83831;17192;101023;545785;279936;825721
2022.02_01-07-2022;Тамбовская область;165_195_days;CoviVac;110;14;124;545785;279936;825721
2022.02_01-07-2022;Тамбовская область;165_195_days;EpiVacCorona;983;562;1545;545785;279936;825721
2022.02_01-07-2022;Тамбовская область;165_195_days;SputnikLite;35315;5947;41262;545785;279936;825721
2022.02_01-07-2022;Тамбовская область;165_195_days;SputnikV;47423;10669;58092;545785;279936;825721
2022.02_01-07-2022;Тамбовская область;21_45_days;AllVaccines;19597;10692;30289;545785;279936;825721
2022.02_01-07-2022;Тамбовская область;21_45_days;CoviVac;327;51;378;545785;279936;825721
2022.02_01-07-2022;Тамбовская область;21_45_days;EpiVacCorona;938;607;1545;545785;279936;825721
2022.02_01-07-2022;Тамбовская область;21_45_days;SputnikLite;13330;5449;18779;545785;279936;825721
2022.02_01-07-2022;Тамбовская область;21_45_days;SputnikV;5002;4585;9587;545785;279936;825721
2022.02_01-07-2022;Тамбовская область;45_75_days;AllVaccines;32827;22571;55398;545785;279936;825721
2022.02_01-07-2022;Тамбовская область;45_75_days;CoviVac;881;165;1046;545785;279936;825721
2022.02_01-07-2022;Тамбовская область;45_75_days;EpiVacCorona;965;743;1708;545785;279936;825721
2022.02_01-07-2022;Тамбовская область;45_75_days;SputnikLite;16833;9554;26387;545785;279936;825721
2022.02_01-07-2022;Тамбовская область;45_75_days;SputnikV;14148;12109;26257;545785;279936;825721
2022.02_01-07-2022;Тамбовская область;75_90_days;AllVaccines;22145;14828;36973;545785;279936;825721
2022.02_01-07-2022;Тамбовская область;75_90_days;CoviVac;437;96;533;545785;279936;825721
2022.02_01-07-2022;Тамбовская область;75_90_days;EpiVacCorona;415;239;654;545785;279936;825721
2022.02_01-07-2022;Тамбовская область;75_90_days;SputnikLite;12250;6819;19069;545785;279936;825721
2022.02_01-07-2022;Тамбовская область;75_90_days;SputnikV;9043;7674;16717;545785;279936;825721
2022.02_01-07-2022;Тамбовская область;90_105_days;AllVaccines;19356;15419;34775;545785;279936;825721
2022.02_01-07-2022;Тамбовская область;90_105_days;CoviVac;621;144;765;545785;279936;825721
2022.02_01-07-2022;Тамбовская область;90_105_days;EpiVacCorona;246;131;377;545785;279936;825721
2022.02_01-07-2022;Тамбовская область;90_105_days;SputnikLite;10468;7223;17691;545785;279936;825721
2022.02_01-07-2022;Тамбовская область;90_105_days;SputnikV;8021;7921;15942;545785;279936;825721
2022.02_01-07-2022;Тверская область;105_165_days;AllVaccines;53612;37922;91534;681519;330234;1011753
2022.02_01-07-2022;Тверская область;105_165_days;CoviVac;737;158;895;681519;330234;1011753
2022.02_01-07-2022;Тверская область;105_165_days;EpiVacCorona;901;429;1330;681519;330234;1011753
2022.02_01-07-2022;Тверская область;105_165_days;SputnikLite;26100;24421;50521;681519;330234;1011753
2022.02_01-07-2022;Тверская область;105_165_days;SputnikV;25874;12914;38788;681519;330234;1011753
2022.02_01-07-2022;Тверская область;165_195_days;AllVaccines;73272;20201;93473;681519;330234;1011753
2022.02_01-07-2022;Тверская область;165_195_days;CoviVac;893;136;1029;681519;330234;1011753
2022.02_01-07-2022;Тверская область;165_195_days;EpiVacCorona;1737;615;2352;681519;330234;1011753
2022.02_01-07-2022;Тверская область;165_195_days;SputnikLite;6096;2288;8384;681519;330234;1011753
2022.02_01-07-2022;Тверская область;165_195_days;SputnikV;64546;17162;81708;681519;330234;1011753
2022.02_01-07-2022;Тверская область;21_45_days;AllVaccines;18751;10924;29675;681519;330234;1011753
2022.02_01-07-2022;Тверская область;21_45_days;CoviVac;420;76;496;681519;330234;1011753
2022.02_01-07-2022;Тверская область;21_45_days;EpiVacCorona;824;494;1318;681519;330234;1011753
2022.02_01-07-2022;Тверская область;21_45_days;SputnikLite;13135;8244;21379;681519;330234;1011753
2022.02_01-07-2022;Тверская область;21_45_days;SputnikV;4372;2110;6482;681519;330234;1011753
2022.02_01-07-2022;Тверская область;45_75_days;AllVaccines;37829;25498;63327;681519;330234;1011753
2022.02_01-07-2022;Тверская область;45_75_days;CoviVac;1075;303;1378;681519;330234;1011753
2022.02_01-07-2022;Тверская область;45_75_days;EpiVacCorona;2833;1952;4785;681519;330234;1011753
2022.02_01-07-2022;Тверская область;45_75_days;SputnikLite;10895;10067;20962;681519;330234;1011753
2022.02_01-07-2022;Тверская область;45_75_days;SputnikV;23026;13176;36202;681519;330234;1011753
2022.02_01-07-2022;Тверская область;75_90_days;AllVaccines;30024;17781;47805;681519;330234;1011753
2022.02_01-07-2022;Тверская область;75_90_days;CoviVac;373;94;467;681519;330234;1011753
2022.02_01-07-2022;Тверская область;75_90_days;EpiVacCorona;1900;904;2804;681519;330234;1011753
2022.02_01-07-2022;Тверская область;75_90_days;SputnikLite;7766;8379;16145;681519;330234;1011753
2022.02_01-07-2022;Тверская область;75_90_days;SputnikV;19985;8404;28389;681519;330234;1011753
2022.02_01-07-2022;Тверская область;90_105_days;AllVaccines;22421;14800;37221;681519;330234;1011753
2022.02_01-07-2022;Тверская область;90_105_days;CoviVac;487;130;617;681519;330234;1011753
2022.02_01-07-2022;Тверская область;90_105_days;EpiVacCorona;815;306;1121;681519;330234;1011753
2022.02_01-07-2022;Тверская область;90_105_days;SputnikLite;8886;8087;16973;681519;330234;1011753
2022.02_01-07-2022;Тверская область;90_105_days;SputnikV;12233;6277;18510;681519;330234;1011753
2022.02_01-07-2022;Томская область;105_165_days;AllVaccines;45072;22173;67245;621613;222482;844095
2022.02_01-07-2022;Томская область;105_165_days;CoviVac;198;22;220;621613;222482;844095
2022.02_01-07-2022;Томская область;105_165_days;EpiVacCorona;368;113;481;621613;222482;844095
2022.02_01-07-2022;Томская область;105_165_days;SputnikLite;25759;15801;41560;621613;222482;844095
2022.02_01-07-2022;Томская область;105_165_days;SputnikV;18747;6237;24984;621613;222482;844095
2022.02_01-07-2022;Томская область;165_195_days;AllVaccines;42859;11030;53889;621613;222482;844095
2022.02_01-07-2022;Томская область;165_195_days;CoviVac;361;25;386;621613;222482;844095
2022.02_01-07-2022;Томская область;165_195_days;EpiVacCorona;1099;276;1375;621613;222482;844095
2022.02_01-07-2022;Томская область;165_195_days;SputnikLite;6319;1429;7748;621613;222482;844095
2022.02_01-07-2022;Томская область;165_195_days;SputnikV;35080;9300;44380;621613;222482;844095
2022.02_01-07-2022;Томская область;21_45_days;AllVaccines;22755;10458;33213;621613;222482;844095
2022.02_01-07-2022;Томская область;21_45_days;CoviVac;253;41;294;621613;222482;844095
2022.02_01-07-2022;Томская область;21_45_days;EpiVacCorona;1034;433;1467;621613;222482;844095
2022.02_01-07-2022;Томская область;21_45_days;SputnikLite;13468;7738;21206;621613;222482;844095
2022.02_01-07-2022;Томская область;21_45_days;SputnikV;8000;2246;10246;621613;222482;844095
2022.02_01-07-2022;Томская область;45_75_days;AllVaccines;66744;23540;90284;621613;222482;844095
2022.02_01-07-2022;Томская область;45_75_days;CoviVac;1342;192;1534;621613;222482;844095
2022.02_01-07-2022;Томская область;45_75_days;EpiVacCorona;1043;416;1459;621613;222482;844095
2022.02_01-07-2022;Томская область;45_75_days;SputnikLite;15511;10908;26419;621613;222482;844095
2022.02_01-07-2022;Томская область;45_75_days;SputnikV;48848;12024;60872;621613;222482;844095
2022.02_01-07-2022;Томская область;75_90_days;AllVaccines;43120;12948;56068;621613;222482;844095
2022.02_01-07-2022;Томская область;75_90_days;CoviVac;1313;183;1496;621613;222482;844095
2022.02_01-07-2022;Томская область;75_90_days;EpiVacCorona;724;190;914;621613;222482;844095
2022.02_01-07-2022;Томская область;75_90_days;SputnikLite;11336;6660;17996;621613;222482;844095
2022.02_01-07-2022;Томская область;75_90_days;SputnikV;29747;5915;35662;621613;222482;844095
2022.02_01-07-2022;Томская область;90_105_days;AllVaccines;25971;10183;36154;621613;222482;844095
2022.02_01-07-2022;Томская область;90_105_days;CoviVac;638;63;701;621613;222482;844095
2022.02_01-07-2022;Томская область;90_105_days;EpiVacCorona;246;74;320;621613;222482;844095
2022.02_01-07-2022;Томская область;90_105_days;SputnikLite;11229;6450;17679;621613;222482;844095
2022.02_01-07-2022;Томская область;90_105_days;SputnikV;13858;3596;17454;621613;222482;844095
2022.02_01-07-2022;Тульская область;105_165_days;AllVaccines;56249;33521;89770;804510;401385;1205895
2022.02_01-07-2022;Тульская область;105_165_days;CoviVac;504;179;683;804510;401385;1205895
2022.02_01-07-2022;Тульская область;105_165_days;EpiVacCorona;963;719;1682;804510;401385;1205895
2022.02_01-07-2022;Тульская область;105_165_days;SputnikLite;27803;18545;46348;804510;401385;1205895
2022.02_01-07-2022;Тульская область;105_165_days;SputnikV;26979;14078;41057;804510;401385;1205895
2022.02_01-07-2022;Тульская область;165_195_days;AllVaccines;100661;23401;124062;804510;401385;1205895
2022.02_01-07-2022;Тульская область;165_195_days;CoviVac;435;65;500;804510;401385;1205895
2022.02_01-07-2022;Тульская область;165_195_days;EpiVacCorona;936;432;1368;804510;401385;1205895
2022.02_01-07-2022;Тульская область;165_195_days;SputnikLite;8955;1885;10840;804510;401385;1205895
2022.02_01-07-2022;Тульская область;165_195_days;SputnikV;90335;21019;111354;804510;401385;1205895
2022.02_01-07-2022;Тульская область;21_45_days;AllVaccines;26637;14482;41119;804510;401385;1205895
2022.02_01-07-2022;Тульская область;21_45_days;CoviVac;191;75;266;804510;401385;1205895
2022.02_01-07-2022;Тульская область;21_45_days;EpiVacCorona;656;791;1447;804510;401385;1205895
2022.02_01-07-2022;Тульская область;21_45_days;SputnikLite;19441;9812;29253;804510;401385;1205895
2022.02_01-07-2022;Тульская область;21_45_days;SputnikV;6349;3804;10153;804510;401385;1205895
2022.02_01-07-2022;Тульская область;45_75_days;AllVaccines;56048;32674;88722;804510;401385;1205895
2022.02_01-07-2022;Тульская область;45_75_days;CoviVac;541;217;758;804510;401385;1205895
2022.02_01-07-2022;Тульская область;45_75_days;EpiVacCorona;2317;1577;3894;804510;401385;1205895
2022.02_01-07-2022;Тульская область;45_75_days;SputnikLite;14178;11586;25764;804510;401385;1205895
2022.02_01-07-2022;Тульская область;45_75_days;SputnikV;39012;19294;58306;804510;401385;1205895
2022.02_01-07-2022;Тульская область;75_90_days;AllVaccines;30030;18852;48882;804510;401385;1205895
2022.02_01-07-2022;Тульская область;75_90_days;CoviVac;594;186;780;804510;401385;1205895
2022.02_01-07-2022;Тульская область;75_90_days;EpiVacCorona;1537;1190;2727;804510;401385;1205895
2022.02_01-07-2022;Тульская область;75_90_days;SputnikLite;11611;8117;19728;804510;401385;1205895
2022.02_01-07-2022;Тульская область;75_90_days;SputnikV;16288;9359;25647;804510;401385;1205895
2022.02_01-07-2022;Тульская область;90_105_days;AllVaccines;28812;19530;48342;804510;401385;1205895
2022.02_01-07-2022;Тульская область;90_105_days;CoviVac;647;257;904;804510;401385;1205895
2022.02_01-07-2022;Тульская область;90_105_days;EpiVacCorona;1338;1529;2867;804510;401385;1205895
2022.02_01-07-2022;Тульская область;90_105_days;SputnikLite;16937;9835;26772;804510;401385;1205895
2022.02_01-07-2022;Тульская область;90_105_days;SputnikV;9890;7909;17799;804510;401385;1205895
2022.02_01-07-2022;Тюменская область;105_165_days;AllVaccines;100572;34240;134812;870789;301209;1171998
2022.02_01-07-2022;Тюменская область;105_165_days;CoviVac;201;50;251;870789;301209;1171998
2022.02_01-07-2022;Тюменская область;105_165_days;EpiVacCorona;560;318;878;870789;301209;1171998
2022.02_01-07-2022;Тюменская область;105_165_days;SputnikLite;72418;24907;97325;870789;301209;1171998
2022.02_01-07-2022;Тюменская область;105_165_days;SputnikV;27393;8965;36358;870789;301209;1171998
2022.02_01-07-2022;Тюменская область;165_195_days;AllVaccines;104322;22182;126504;870789;301209;1171998
2022.02_01-07-2022;Тюменская область;165_195_days;CoviVac;345;60;405;870789;301209;1171998
2022.02_01-07-2022;Тюменская область;165_195_days;EpiVacCorona;1255;421;1676;870789;301209;1171998
2022.02_01-07-2022;Тюменская область;165_195_days;SputnikLite;27530;5902;33432;870789;301209;1171998
2022.02_01-07-2022;Тюменская область;165_195_days;SputnikV;75192;15799;90991;870789;301209;1171998
2022.02_01-07-2022;Тюменская область;21_45_days;AllVaccines;45214;20232;65446;870789;301209;1171998
2022.02_01-07-2022;Тюменская область;21_45_days;CoviVac;121;34;155;870789;301209;1171998
2022.02_01-07-2022;Тюменская область;21_45_days;EpiVacCorona;90;67;157;870789;301209;1171998
2022.02_01-07-2022;Тюменская область;21_45_days;SputnikLite;34419;16615;51034;870789;301209;1171998
2022.02_01-07-2022;Тюменская область;21_45_days;SputnikV;10584;3516;14100;870789;301209;1171998
2022.02_01-07-2022;Тюменская область;45_75_days;AllVaccines;106092;42454;148546;870789;301209;1171998
2022.02_01-07-2022;Тюменская область;45_75_days;CoviVac;404;89;493;870789;301209;1171998
2022.02_01-07-2022;Тюменская область;45_75_days;EpiVacCorona;449;174;623;870789;301209;1171998
2022.02_01-07-2022;Тюменская область;45_75_days;SputnikLite;30500;20932;51432;870789;301209;1171998
2022.02_01-07-2022;Тюменская область;45_75_days;SputnikV;74739;21259;95998;870789;301209;1171998
2022.02_01-07-2022;Тюменская область;75_90_days;AllVaccines;68490;26383;94873;870789;301209;1171998
2022.02_01-07-2022;Тюменская область;75_90_days;CoviVac;890;148;1038;870789;301209;1171998
2022.02_01-07-2022;Тюменская область;75_90_days;EpiVacCorona;823;164;987;870789;301209;1171998
2022.02_01-07-2022;Тюменская область;75_90_days;SputnikLite;19139;14470;33609;870789;301209;1171998
2022.02_01-07-2022;Тюменская область;75_90_days;SputnikV;47638;11601;59239;870789;301209;1171998
2022.02_01-07-2022;Тюменская область;90_105_days;AllVaccines;22626;7086;29712;870789;301209;1171998
2022.02_01-07-2022;Тюменская область;90_105_days;CoviVac;303;61;364;870789;301209;1171998
2022.02_01-07-2022;Тюменская область;90_105_days;EpiVacCorona;269;112;381;870789;301209;1171998
2022.02_01-07-2022;Тюменская область;90_105_days;SputnikLite;7989;3045;11034;870789;301209;1171998
2022.02_01-07-2022;Тюменская область;90_105_days;SputnikV;14065;3868;17933;870789;301209;1171998
2022.02_01-07-2022;Удмуртская Республика;105_165_days;AllVaccines;98748;36355;135103;818861;336450;1155311
2022.02_01-07-2022;Удмуртская Республика;105_165_days;CoviVac;110;11;121;818861;336450;1155311
2022.02_01-07-2022;Удмуртская Республика;105_165_days;EpiVacCorona;5251;3483;8734;818861;336450;1155311
2022.02_01-07-2022;Удмуртская Республика;105_165_days;SputnikLite;62964;21054;84018;818861;336450;1155311
2022.02_01-07-2022;Удмуртская Республика;105_165_days;SputnikV;30423;11807;42230;818861;336450;1155311
2022.02_01-07-2022;Удмуртская Республика;165_195_days;AllVaccines;78691;18614;97305;818861;336450;1155311
2022.02_01-07-2022;Удмуртская Республика;165_195_days;CoviVac;502;58;560;818861;336450;1155311
2022.02_01-07-2022;Удмуртская Республика;165_195_days;EpiVacCorona;3259;1819;5078;818861;336450;1155311
2022.02_01-07-2022;Удмуртская Республика;165_195_days;SputnikLite;24638;2596;27234;818861;336450;1155311
2022.02_01-07-2022;Удмуртская Республика;165_195_days;SputnikV;50292;14141;64433;818861;336450;1155311
2022.02_01-07-2022;Удмуртская Республика;21_45_days;AllVaccines;23354;14931;38285;818861;336450;1155311
2022.02_01-07-2022;Удмуртская Республика;21_45_days;CoviVac;363;70;433;818861;336450;1155311
2022.02_01-07-2022;Удмуртская Республика;21_45_days;EpiVacCorona;924;741;1665;818861;336450;1155311
2022.02_01-07-2022;Удмуртская Республика;21_45_days;SputnikLite;13327;10616;23943;818861;336450;1155311
2022.02_01-07-2022;Удмуртская Республика;21_45_days;SputnikV;8740;3504;12244;818861;336450;1155311
2022.02_01-07-2022;Удмуртская Республика;45_75_days;AllVaccines;63971;31148;95119;818861;336450;1155311
2022.02_01-07-2022;Удмуртская Республика;45_75_days;CoviVac;1930;297;2227;818861;336450;1155311
2022.02_01-07-2022;Удмуртская Республика;45_75_days;EpiVacCorona;2697;1515;4212;818861;336450;1155311
2022.02_01-07-2022;Удмуртская Республика;45_75_days;SputnikLite;11265;11860;23125;818861;336450;1155311
2022.02_01-07-2022;Удмуртская Республика;45_75_days;SputnikV;48079;17476;65555;818861;336450;1155311
2022.02_01-07-2022;Удмуртская Республика;75_90_days;AllVaccines;69096;27519;96615;818861;336450;1155311
2022.02_01-07-2022;Удмуртская Республика;75_90_days;CoviVac;730;104;834;818861;336450;1155311
2022.02_01-07-2022;Удмуртская Республика;75_90_days;EpiVacCorona;3089;1316;4405;818861;336450;1155311
2022.02_01-07-2022;Удмуртская Республика;75_90_days;SputnikLite;10304;10247;20551;818861;336450;1155311
2022.02_01-07-2022;Удмуртская Республика;75_90_days;SputnikV;54973;15852;70825;818861;336450;1155311
2022.02_01-07-2022;Удмуртская Республика;90_105_days;AllVaccines;33542;11247;44789;818861;336450;1155311
2022.02_01-07-2022;Удмуртская Республика;90_105_days;CoviVac;784;111;895;818861;336450;1155311
2022.02_01-07-2022;Удмуртская Республика;90_105_days;EpiVacCorona;2514;1282;3796;818861;336450;1155311
2022.02_01-07-2022;Удмуртская Республика;90_105_days;SputnikLite;2922;1706;4628;818861;336450;1155311
2022.02_01-07-2022;Удмуртская Республика;90_105_days;SputnikV;27322;8148;35470;818861;336450;1155311
2022.02_01-07-2022;Ульяновская область;105_165_days;AllVaccines;69661;34412;104073;672149;320065;992214
2022.02_01-07-2022;Ульяновская область;105_165_days;CoviVac;92;22;114;672149;320065;992214
2022.02_01-07-2022;Ульяновская область;105_165_days;EpiVacCorona;849;256;1105;672149;320065;992214
2022.02_01-07-2022;Ульяновская область;105_165_days;SputnikLite;34833;23695;58528;672149;320065;992214
2022.02_01-07-2022;Ульяновская область;105_165_days;SputnikV;33887;10439;44326;672149;320065;992214
2022.02_01-07-2022;Ульяновская область;165_195_days;AllVaccines;66117;14226;80343;672149;320065;992214
2022.02_01-07-2022;Ульяновская область;165_195_days;CoviVac;205;20;225;672149;320065;992214
2022.02_01-07-2022;Ульяновская область;165_195_days;EpiVacCorona;1562;385;1947;672149;320065;992214
2022.02_01-07-2022;Ульяновская область;165_195_days;SputnikLite;14619;3142;17761;672149;320065;992214
2022.02_01-07-2022;Ульяновская область;165_195_days;SputnikV;49731;10679;60410;672149;320065;992214
2022.02_01-07-2022;Ульяновская область;21_45_days;AllVaccines;19862;11152;31014;672149;320065;992214
2022.02_01-07-2022;Ульяновская область;21_45_days;CoviVac;149;38;187;672149;320065;992214
2022.02_01-07-2022;Ульяновская область;21_45_days;EpiVacCorona;548;348;896;672149;320065;992214
2022.02_01-07-2022;Ульяновская область;21_45_days;SputnikLite;12727;8064;20791;672149;320065;992214
2022.02_01-07-2022;Ульяновская область;21_45_days;SputnikV;6438;2702;9140;672149;320065;992214
2022.02_01-07-2022;Ульяновская область;45_75_days;AllVaccines;58183;31574;89757;672149;320065;992214
2022.02_01-07-2022;Ульяновская область;45_75_days;CoviVac;761;174;935;672149;320065;992214
2022.02_01-07-2022;Ульяновская область;45_75_days;EpiVacCorona;1962;989;2951;672149;320065;992214
2022.02_01-07-2022;Ульяновская область;45_75_days;SputnikLite;12572;12035;24607;672149;320065;992214
2022.02_01-07-2022;Ульяновская область;45_75_days;SputnikV;42888;18376;61264;672149;320065;992214
2022.02_01-07-2022;Ульяновская область;75_90_days;AllVaccines;41353;20688;62041;672149;320065;992214
2022.02_01-07-2022;Ульяновская область;75_90_days;CoviVac;963;210;1173;672149;320065;992214
2022.02_01-07-2022;Ульяновская область;75_90_days;EpiVacCorona;970;343;1313;672149;320065;992214
2022.02_01-07-2022;Ульяновская область;75_90_days;SputnikLite;8061;8445;16506;672149;320065;992214
2022.02_01-07-2022;Ульяновская область;75_90_days;SputnikV;31359;11690;43049;672149;320065;992214
2022.02_01-07-2022;Ульяновская область;90_105_days;AllVaccines;25732;12624;38356;672149;320065;992214
2022.02_01-07-2022;Ульяновская область;90_105_days;CoviVac;638;161;799;672149;320065;992214
2022.02_01-07-2022;Ульяновская область;90_105_days;EpiVacCorona;705;252;957;672149;320065;992214
2022.02_01-07-2022;Ульяновская область;90_105_days;SputnikLite;6452;5844;12296;672149;320065;992214
2022.02_01-07-2022;Ульяновская область;90_105_days;SputnikV;17937;6367;24304;672149;320065;992214
2022.02_01-07-2022;Хабаровский край;105_165_days;AllVaccines;47757;21272;69029;757169;265178;1022347
2022.02_01-07-2022;Хабаровский край;105_165_days;CoviVac;54;13;67;757169;265178;1022347
2022.02_01-07-2022;Хабаровский край;105_165_days;EpiVacCorona;7;4;11;757169;265178;1022347
2022.02_01-07-2022;Хабаровский край;105_165_days;SputnikLite;24408;12819;37227;757169;265178;1022347
2022.02_01-07-2022;Хабаровский край;105_165_days;SputnikV;23288;8436;31724;757169;265178;1022347
2022.02_01-07-2022;Хабаровский край;165_195_days;AllVaccines;73435;13491;86926;757169;265178;1022347
2022.02_01-07-2022;Хабаровский край;165_195_days;CoviVac;311;21;332;757169;265178;1022347
2022.02_01-07-2022;Хабаровский край;165_195_days;EpiVacCorona;24;39;63;757169;265178;1022347
2022.02_01-07-2022;Хабаровский край;165_195_days;SputnikLite;16933;2523;19456;757169;265178;1022347
2022.02_01-07-2022;Хабаровский край;165_195_days;SputnikV;56167;10908;67075;757169;265178;1022347
2022.02_01-07-2022;Хабаровский край;21_45_days;AllVaccines;26717;12506;39223;757169;265178;1022347
2022.02_01-07-2022;Хабаровский край;21_45_days;CoviVac;357;55;412;757169;265178;1022347
2022.02_01-07-2022;Хабаровский край;21_45_days;EpiVacCorona;1713;652;2365;757169;265178;1022347
2022.02_01-07-2022;Хабаровский край;21_45_days;SputnikLite;12256;7134;19390;757169;265178;1022347
2022.02_01-07-2022;Хабаровский край;21_45_days;SputnikV;12391;4665;17056;757169;265178;1022347
2022.02_01-07-2022;Хабаровский край;45_75_days;AllVaccines;67828;24163;91991;757169;265178;1022347
2022.02_01-07-2022;Хабаровский край;45_75_days;CoviVac;1269;262;1531;757169;265178;1022347
2022.02_01-07-2022;Хабаровский край;45_75_days;EpiVacCorona;4192;1386;5578;757169;265178;1022347
2022.02_01-07-2022;Хабаровский край;45_75_days;SputnikLite;19097;9081;28178;757169;265178;1022347
2022.02_01-07-2022;Хабаровский край;45_75_days;SputnikV;43270;13434;56704;757169;265178;1022347
2022.02_01-07-2022;Хабаровский край;75_90_days;AllVaccines;30112;10929;41041;757169;265178;1022347
2022.02_01-07-2022;Хабаровский край;75_90_days;CoviVac;930;155;1085;757169;265178;1022347
2022.02_01-07-2022;Хабаровский край;75_90_days;EpiVacCorona;1364;329;1693;757169;265178;1022347
2022.02_01-07-2022;Хабаровский край;75_90_days;SputnikLite;12387;5338;17725;757169;265178;1022347
2022.02_01-07-2022;Хабаровский край;75_90_days;SputnikV;15431;5107;20538;757169;265178;1022347
2022.02_01-07-2022;Хабаровский край;90_105_days;AllVaccines;22334;8701;31035;757169;265178;1022347
2022.02_01-07-2022;Хабаровский край;90_105_days;CoviVac;329;105;434;757169;265178;1022347
2022.02_01-07-2022;Хабаровский край;90_105_days;EpiVacCorona;105;72;177;757169;265178;1022347
2022.02_01-07-2022;Хабаровский край;90_105_days;SputnikLite;15546;5399;20945;757169;265178;1022347
2022.02_01-07-2022;Хабаровский край;90_105_days;SputnikV;6354;3125;9479;757169;265178;1022347
2022.02_01-07-2022;Ханты-Мансийский автономный округ - Югра;105_165_days;AllVaccines;106018;21459;127477;1019471;240107;1259578
2022.02_01-07-2022;Ханты-Мансийский автономный округ - Югра;105_165_days;CoviVac;523;101;624;1019471;240107;1259578
2022.02_01-07-2022;Ханты-Мансийский автономный округ - Югра;105_165_days;EpiVacCorona;780;163;943;1019471;240107;1259578
2022.02_01-07-2022;Ханты-Мансийский автономный округ - Югра;105_165_days;SputnikLite;62106;13999;76105;1019471;240107;1259578
2022.02_01-07-2022;Ханты-Мансийский автономный округ - Югра;105_165_days;SputnikV;42609;7196;49805;1019471;240107;1259578
2022.02_01-07-2022;Ханты-Мансийский автономный округ - Югра;165_195_days;AllVaccines;84468;9786;94254;1019471;240107;1259578
2022.02_01-07-2022;Ханты-Мансийский автономный округ - Югра;165_195_days;CoviVac;401;62;463;1019471;240107;1259578
2022.02_01-07-2022;Ханты-Мансийский автономный округ - Югра;165_195_days;EpiVacCorona;989;204;1193;1019471;240107;1259578
2022.02_01-07-2022;Ханты-Мансийский автономный округ - Югра;165_195_days;SputnikLite;14535;1748;16283;1019471;240107;1259578
2022.02_01-07-2022;Ханты-Мансийский автономный округ - Югра;165_195_days;SputnikV;68543;7772;76315;1019471;240107;1259578
2022.02_01-07-2022;Ханты-Мансийский автономный округ - Югра;21_45_days;AllVaccines;43126;10933;54059;1019471;240107;1259578
2022.02_01-07-2022;Ханты-Мансийский автономный округ - Югра;21_45_days;CoviVac;184;42;226;1019471;240107;1259578
2022.02_01-07-2022;Ханты-Мансийский автономный округ - Югра;21_45_days;EpiVacCorona;533;182;715;1019471;240107;1259578
2022.02_01-07-2022;Ханты-Мансийский автономный округ - Югра;21_45_days;SputnikLite;30107;7999;38106;1019471;240107;1259578
2022.02_01-07-2022;Ханты-Мансийский автономный округ - Югра;21_45_days;SputnikV;12302;2710;15012;1019471;240107;1259578
2022.02_01-07-2022;Ханты-Мансийский автономный округ - Югра;45_75_days;AllVaccines;90282;23243;113525;1019471;240107;1259578
2022.02_01-07-2022;Ханты-Мансийский автономный округ - Югра;45_75_days;CoviVac;402;69;471;1019471;240107;1259578
2022.02_01-07-2022;Ханты-Мансийский автономный округ - Югра;45_75_days;EpiVacCorona;1268;501;1769;1019471;240107;1259578
2022.02_01-07-2022;Ханты-Мансийский автономный округ - Югра;45_75_days;SputnikLite;33800;10236;44036;1019471;240107;1259578
2022.02_01-07-2022;Ханты-Мансийский автономный округ - Югра;45_75_days;SputnikV;54812;12437;67249;1019471;240107;1259578
2022.02_01-07-2022;Ханты-Мансийский автономный округ - Югра;75_90_days;AllVaccines;82028;17469;99497;1019471;240107;1259578
2022.02_01-07-2022;Ханты-Мансийский автономный округ - Югра;75_90_days;CoviVac;390;85;475;1019471;240107;1259578
2022.02_01-07-2022;Ханты-Мансийский автономный округ - Югра;75_90_days;EpiVacCorona;1222;373;1595;1019471;240107;1259578
2022.02_01-07-2022;Ханты-Мансийский автономный округ - Югра;75_90_days;SputnikLite;19837;7193;27030;1019471;240107;1259578
2022.02_01-07-2022;Ханты-Мансийский автономный округ - Югра;75_90_days;SputnikV;60579;9818;70397;1019471;240107;1259578
2022.02_01-07-2022;Ханты-Мансийский автономный округ - Югра;90_105_days;AllVaccines;52616;11015;63631;1019471;240107;1259578
2022.02_01-07-2022;Ханты-Мансийский автономный округ - Югра;90_105_days;CoviVac;800;126;926;1019471;240107;1259578
2022.02_01-07-2022;Ханты-Мансийский автономный округ - Югра;90_105_days;EpiVacCorona;308;69;377;1019471;240107;1259578
2022.02_01-07-2022;Ханты-Мансийский автономный округ - Югра;90_105_days;SputnikLite;10359;4252;14611;1019471;240107;1259578
2022.02_01-07-2022;Ханты-Мансийский автономный округ - Югра;90_105_days;SputnikV;41149;6568;47717;1019471;240107;1259578
2022.02_01-07-2022;Челябинская область;105_165_days;AllVaccines;195033;72878;267911;1901705;795956;2697661
2022.02_01-07-2022;Челябинская область;105_165_days;CoviVac;4183;1136;5319;1901705;795956;2697661
2022.02_01-07-2022;Челябинская область;105_165_days;EpiVacCorona;2387;1269;3656;1901705;795956;2697661
2022.02_01-07-2022;Челябинская область;105_165_days;SputnikLite;108386;39204;147590;1901705;795956;2697661
2022.02_01-07-2022;Челябинская область;105_165_days;SputnikV;80077;31269;111346;1901705;795956;2697661
2022.02_01-07-2022;Челябинская область;165_195_days;AllVaccines;160815;35052;195867;1901705;795956;2697661
2022.02_01-07-2022;Челябинская область;165_195_days;CoviVac;1119;186;1305;1901705;795956;2697661
2022.02_01-07-2022;Челябинская область;165_195_days;EpiVacCorona;4486;1995;6481;1901705;795956;2697661
2022.02_01-07-2022;Челябинская область;165_195_days;SputnikLite;44338;5876;50214;1901705;795956;2697661
2022.02_01-07-2022;Челябинская область;165_195_days;SputnikV;110872;26995;137867;1901705;795956;2697661
2022.02_01-07-2022;Челябинская область;21_45_days;AllVaccines;60475;34236;94711;1901705;795956;2697661
2022.02_01-07-2022;Челябинская область;21_45_days;CoviVac;343;128;471;1901705;795956;2697661
2022.02_01-07-2022;Челябинская область;21_45_days;EpiVacCorona;1490;1128;2618;1901705;795956;2697661
2022.02_01-07-2022;Челябинская область;21_45_days;SputnikLite;40589;24232;64821;1901705;795956;2697661
2022.02_01-07-2022;Челябинская область;21_45_days;SputnikV;18053;8748;26801;1901705;795956;2697661
2022.02_01-07-2022;Челябинская область;45_75_days;AllVaccines;181292;84536;265828;1901705;795956;2697661
2022.02_01-07-2022;Челябинская область;45_75_days;CoviVac;1197;349;1546;1901705;795956;2697661
2022.02_01-07-2022;Челябинская область;45_75_days;EpiVacCorona;5286;2739;8025;1901705;795956;2697661
2022.02_01-07-2022;Челябинская область;45_75_days;SputnikLite;47728;27814;75542;1901705;795956;2697661
2022.02_01-07-2022;Челябинская область;45_75_days;SputnikV;127081;53634;180715;1901705;795956;2697661
2022.02_01-07-2022;Челябинская область;75_90_days;AllVaccines;174737;59842;234579;1901705;795956;2697661
2022.02_01-07-2022;Челябинская область;75_90_days;CoviVac;757;183;940;1901705;795956;2697661
2022.02_01-07-2022;Челябинская область;75_90_days;EpiVacCorona;6946;2495;9441;1901705;795956;2697661
2022.02_01-07-2022;Челябинская область;75_90_days;SputnikLite;21530;13026;34556;1901705;795956;2697661
2022.02_01-07-2022;Челябинская область;75_90_days;SputnikV;145504;44138;189642;1901705;795956;2697661
2022.02_01-07-2022;Челябинская область;90_105_days;AllVaccines;116938;41608;158546;1901705;795956;2697661
2022.02_01-07-2022;Челябинская область;90_105_days;CoviVac;2413;376;2789;1901705;795956;2697661
2022.02_01-07-2022;Челябинская область;90_105_days;EpiVacCorona;3509;1259;4768;1901705;795956;2697661
2022.02_01-07-2022;Челябинская область;90_105_days;SputnikLite;22141;10743;32884;1901705;795956;2697661
2022.02_01-07-2022;Челябинская область;90_105_days;SputnikV;88875;29230;118105;1901705;795956;2697661
2022.02_01-07-2022;Чеченская Республика;105_165_days;AllVaccines;65040;14985;80025;809759;137234;946993
2022.02_01-07-2022;Чеченская Республика;105_165_days;CoviVac;603;155;758;809759;137234;946993
2022.02_01-07-2022;Чеченская Республика;105_165_days;EpiVacCorona;1220;287;1507;809759;137234;946993
2022.02_01-07-2022;Чеченская Республика;105_165_days;SputnikLite;10399;1188;11587;809759;137234;946993
2022.02_01-07-2022;Чеченская Республика;105_165_days;SputnikV;52818;13355;66173;809759;137234;946993
2022.02_01-07-2022;Чеченская Республика;165_195_days;AllVaccines;118997;28093;147090;809759;137234;946993
2022.02_01-07-2022;Чеченская Республика;165_195_days;CoviVac;266;89;355;809759;137234;946993
2022.02_01-07-2022;Чеченская Республика;165_195_days;EpiVacCorona;231;51;282;809759;137234;946993
2022.02_01-07-2022;Чеченская Республика;165_195_days;SputnikLite;54;7;61;809759;137234;946993
2022.02_01-07-2022;Чеченская Республика;165_195_days;SputnikV;118446;27946;146392;809759;137234;946993
2022.02_01-07-2022;Чеченская Республика;21_45_days;AllVaccines;13274;1832;15106;809759;137234;946993
2022.02_01-07-2022;Чеченская Республика;21_45_days;CoviVac;16;8;24;809759;137234;946993
2022.02_01-07-2022;Чеченская Республика;21_45_days;EpiVacCorona;407;70;477;809759;137234;946993
2022.02_01-07-2022;Чеченская Республика;21_45_days;SputnikLite;11593;1575;13168;809759;137234;946993
2022.02_01-07-2022;Чеченская Республика;21_45_days;SputnikV;1258;179;1437;809759;137234;946993
2022.02_01-07-2022;Чеченская Республика;45_75_days;AllVaccines;23779;2879;26658;809759;137234;946993
2022.02_01-07-2022;Чеченская Республика;45_75_days;CoviVac;157;28;185;809759;137234;946993
2022.02_01-07-2022;Чеченская Республика;45_75_days;EpiVacCorona;2114;333;2447;809759;137234;946993
2022.02_01-07-2022;Чеченская Республика;45_75_days;SputnikLite;14104;1359;15463;809759;137234;946993
2022.02_01-07-2022;Чеченская Республика;45_75_days;SputnikV;7404;1159;8563;809759;137234;946993
2022.02_01-07-2022;Чеченская Республика;75_90_days;AllVaccines;8543;1197;9740;809759;137234;946993
2022.02_01-07-2022;Чеченская Республика;75_90_days;CoviVac;191;36;227;809759;137234;946993
2022.02_01-07-2022;Чеченская Республика;75_90_days;EpiVacCorona;963;142;1105;809759;137234;946993
2022.02_01-07-2022;Чеченская Республика;75_90_days;SputnikLite;1465;102;1567;809759;137234;946993
2022.02_01-07-2022;Чеченская Республика;75_90_days;SputnikV;5924;917;6841;809759;137234;946993
2022.02_01-07-2022;Чеченская Республика;90_105_days;AllVaccines;9924;1786;11710;809759;137234;946993
2022.02_01-07-2022;Чеченская Республика;90_105_days;CoviVac;170;31;201;809759;137234;946993
2022.02_01-07-2022;Чеченская Республика;90_105_days;EpiVacCorona;953;164;1117;809759;137234;946993
2022.02_01-07-2022;Чеченская Республика;90_105_days;SputnikLite;1559;96;1655;809759;137234;946993
2022.02_01-07-2022;Чеченская Республика;90_105_days;SputnikV;7242;1495;8737;809759;137234;946993
2022.02_01-07-2022;Чувашская Республика;105_165_days;AllVaccines;68981;23996;92977;674689;275580;950269
2022.02_01-07-2022;Чувашская Республика;105_165_days;CoviVac;484;98;582;674689;275580;950269
2022.02_01-07-2022;Чувашская Республика;105_165_days;EpiVacCorona;501;215;716;674689;275580;950269
2022.02_01-07-2022;Чувашская Республика;105_165_days;SputnikLite;45284;15111;60395;674689;275580;950269
2022.02_01-07-2022;Чувашская Республика;105_165_days;SputnikV;22712;8572;31284;674689;275580;950269
2022.02_01-07-2022;Чувашская Республика;165_195_days;AllVaccines;57599;12126;69725;674689;275580;950269
2022.02_01-07-2022;Чувашская Республика;165_195_days;CoviVac;235;18;253;674689;275580;950269
2022.02_01-07-2022;Чувашская Республика;165_195_days;EpiVacCorona;1537;376;1913;674689;275580;950269
2022.02_01-07-2022;Чувашская Республика;165_195_days;SputnikLite;10865;2496;13361;674689;275580;950269
2022.02_01-07-2022;Чувашская Республика;165_195_days;SputnikV;44962;9236;54198;674689;275580;950269
2022.02_01-07-2022;Чувашская Республика;21_45_days;AllVaccines;24252;11341;35593;674689;275580;950269
2022.02_01-07-2022;Чувашская Республика;21_45_days;CoviVac;365;65;430;674689;275580;950269
2022.02_01-07-2022;Чувашская Республика;21_45_days;EpiVacCorona;603;386;989;674689;275580;950269
2022.02_01-07-2022;Чувашская Республика;21_45_days;SputnikLite;13608;7176;20784;674689;275580;950269
2022.02_01-07-2022;Чувашская Республика;21_45_days;SputnikV;9676;3714;13390;674689;275580;950269
2022.02_01-07-2022;Чувашская Республика;45_75_days;AllVaccines;61492;30983;92475;674689;275580;950269
2022.02_01-07-2022;Чувашская Республика;45_75_days;CoviVac;820;102;922;674689;275580;950269
2022.02_01-07-2022;Чувашская Республика;45_75_days;EpiVacCorona;1645;604;2249;674689;275580;950269
2022.02_01-07-2022;Чувашская Республика;45_75_days;SputnikLite;12279;12344;24623;674689;275580;950269
2022.02_01-07-2022;Чувашская Республика;45_75_days;SputnikV;46748;17933;64681;674689;275580;950269
2022.02_01-07-2022;Чувашская Республика;75_90_days;AllVaccines;46213;21157;67370;674689;275580;950269
2022.02_01-07-2022;Чувашская Республика;75_90_days;CoviVac;346;65;411;674689;275580;950269
2022.02_01-07-2022;Чувашская Республика;75_90_days;EpiVacCorona;1128;261;1389;674689;275580;950269
2022.02_01-07-2022;Чувашская Республика;75_90_days;SputnikLite;8974;8788;17762;674689;275580;950269
2022.02_01-07-2022;Чувашская Республика;75_90_days;SputnikV;35765;12043;47808;674689;275580;950269
2022.02_01-07-2022;Чувашская Республика;90_105_days;AllVaccines;26764;8289;35053;674689;275580;950269
2022.02_01-07-2022;Чувашская Республика;90_105_days;CoviVac;815;112;927;674689;275580;950269
2022.02_01-07-2022;Чувашская Республика;90_105_days;EpiVacCorona;960;251;1211;674689;275580;950269
2022.02_01-07-2022;Чувашская Республика;90_105_days;SputnikLite;1314;1194;2508;674689;275580;950269
2022.02_01-07-2022;Чувашская Республика;90_105_days;SputnikV;23675;6732;30407;674689;275580;950269
2022.02_01-07-2022;Чукотский автономный округ;105_165_days;AllVaccines;6399;1060;7459;30806;6299;37105
2022.02_01-07-2022;Чукотский автономный округ;105_165_days;CoviVac;360;37;397;30806;6299;37105
2022.02_01-07-2022;Чукотский автономный округ;105_165_days;EpiVacCorona;4;1;5;30806;6299;37105
2022.02_01-07-2022;Чукотский автономный округ;105_165_days;SputnikLite;5414;893;6307;30806;6299;37105
2022.02_01-07-2022;Чукотский автономный округ;105_165_days;SputnikV;621;129;750;30806;6299;37105
2022.02_01-07-2022;Чукотский автономный округ;165_195_days;AllVaccines;2265;257;2522;30806;6299;37105
2022.02_01-07-2022;Чукотский автономный округ;165_195_days;CoviVac;467;37;504;30806;6299;37105
2022.02_01-07-2022;Чукотский автономный округ;165_195_days;EpiVacCorona;3;1;4;30806;6299;37105
2022.02_01-07-2022;Чукотский автономный округ;165_195_days;SputnikLite;554;51;605;30806;6299;37105
2022.02_01-07-2022;Чукотский автономный округ;165_195_days;SputnikV;1241;168;1409;30806;6299;37105
2022.02_01-07-2022;Чукотский автономный округ;21_45_days;AllVaccines;1279;184;1463;30806;6299;37105
2022.02_01-07-2022;Чукотский автономный округ;21_45_days;CoviVac;41;7;48;30806;6299;37105
2022.02_01-07-2022;Чукотский автономный округ;21_45_days;EpiVacCorona;75;6;81;30806;6299;37105
2022.02_01-07-2022;Чукотский автономный округ;21_45_days;SputnikLite;1007;140;1147;30806;6299;37105
2022.02_01-07-2022;Чукотский автономный округ;21_45_days;SputnikV;156;31;187;30806;6299;37105
2022.02_01-07-2022;Чукотский автономный округ;45_75_days;AllVaccines;2444;436;2880;30806;6299;37105
2022.02_01-07-2022;Чукотский автономный округ;45_75_days;CoviVac;64;11;75;30806;6299;37105
2022.02_01-07-2022;Чукотский автономный округ;45_75_days;EpiVacCorona;293;44;337;30806;6299;37105
2022.02_01-07-2022;Чукотский автономный округ;45_75_days;SputnikLite;1600;319;1919;30806;6299;37105
2022.02_01-07-2022;Чукотский автономный округ;45_75_days;SputnikV;487;62;549;30806;6299;37105
2022.02_01-07-2022;Чукотский автономный округ;75_90_days;AllVaccines;2177;368;2545;30806;6299;37105
2022.02_01-07-2022;Чукотский автономный округ;75_90_days;CoviVac;214;19;233;30806;6299;37105
2022.02_01-07-2022;Чукотский автономный округ;75_90_days;EpiVacCorona;211;26;237;30806;6299;37105
2022.02_01-07-2022;Чукотский автономный округ;75_90_days;SputnikLite;1436;277;1713;30806;6299;37105
2022.02_01-07-2022;Чукотский автономный округ;75_90_days;SputnikV;316;46;362;30806;6299;37105
2022.02_01-07-2022;Чукотский автономный округ;90_105_days;AllVaccines;2248;374;2622;30806;6299;37105
2022.02_01-07-2022;Чукотский автономный округ;90_105_days;CoviVac;297;13;310;30806;6299;37105
2022.02_01-07-2022;Чукотский автономный округ;90_105_days;EpiVacCorona;62;10;72;30806;6299;37105
2022.02_01-07-2022;Чукотский автономный округ;90_105_days;SputnikLite;1744;331;2075;30806;6299;37105
2022.02_01-07-2022;Чукотский автономный округ;90_105_days;SputnikV;145;20;165;30806;6299;37105
2022.02_01-07-2022;Ямало-Ненецкий автономный округ;105_165_days;AllVaccines;40729;4777;45506;346064;56429;402493
2022.02_01-07-2022;Ямало-Ненецкий автономный округ;105_165_days;CoviVac;79;5;84;346064;56429;402493
2022.02_01-07-2022;Ямало-Ненецкий автономный округ;105_165_days;EpiVacCorona;138;13;151;346064;56429;402493
2022.02_01-07-2022;Ямало-Ненецкий автономный округ;105_165_days;SputnikLite;31929;3831;35760;346064;56429;402493
2022.02_01-07-2022;Ямало-Ненецкий автономный округ;105_165_days;SputnikV;8583;928;9511;346064;56429;402493
2022.02_01-07-2022;Ямало-Ненецкий автономный округ;165_195_days;AllVaccines;31219;2109;33328;346064;56429;402493
2022.02_01-07-2022;Ямало-Ненецкий автономный округ;165_195_days;CoviVac;421;34;455;346064;56429;402493
2022.02_01-07-2022;Ямало-Ненецкий автономный округ;165_195_days;EpiVacCorona;69;10;79;346064;56429;402493
2022.02_01-07-2022;Ямало-Ненецкий автономный округ;165_195_days;SputnikLite;11786;734;12520;346064;56429;402493
2022.02_01-07-2022;Ямало-Ненецкий автономный округ;165_195_days;SputnikV;18943;1331;20274;346064;56429;402493
2022.02_01-07-2022;Ямало-Ненецкий автономный округ;21_45_days;AllVaccines;14501;1851;16352;346064;56429;402493
2022.02_01-07-2022;Ямало-Ненецкий автономный округ;21_45_days;CoviVac;91;23;114;346064;56429;402493
2022.02_01-07-2022;Ямало-Ненецкий автономный округ;21_45_days;EpiVacCorona;106;10;116;346064;56429;402493
2022.02_01-07-2022;Ямало-Ненецкий автономный округ;21_45_days;SputnikLite;10950;1452;12402;346064;56429;402493
2022.02_01-07-2022;Ямало-Ненецкий автономный округ;21_45_days;SputnikV;3354;366;3720;346064;56429;402493
2022.02_01-07-2022;Ямало-Ненецкий автономный округ;45_75_days;AllVaccines;25221;3370;28591;346064;56429;402493
2022.02_01-07-2022;Ямало-Ненецкий автономный округ;45_75_days;CoviVac;311;54;365;346064;56429;402493
2022.02_01-07-2022;Ямало-Ненецкий автономный округ;45_75_days;EpiVacCorona;118;23;141;346064;56429;402493
2022.02_01-07-2022;Ямало-Ненецкий автономный округ;45_75_days;SputnikLite;10883;1848;12731;346064;56429;402493
2022.02_01-07-2022;Ямало-Ненецкий автономный округ;45_75_days;SputnikV;13909;1445;15354;346064;56429;402493
2022.02_01-07-2022;Ямало-Ненецкий автономный округ;75_90_days;AllVaccines;20656;2414;23070;346064;56429;402493
2022.02_01-07-2022;Ямало-Ненецкий автономный округ;75_90_days;CoviVac;186;20;206;346064;56429;402493
2022.02_01-07-2022;Ямало-Ненецкий автономный округ;75_90_days;EpiVacCorona;94;8;102;346064;56429;402493
2022.02_01-07-2022;Ямало-Ненецкий автономный округ;75_90_days;SputnikLite;7536;1383;8919;346064;56429;402493
2022.02_01-07-2022;Ямало-Ненецкий автономный округ;75_90_days;SputnikV;12840;1003;13843;346064;56429;402493
2022.02_01-07-2022;Ямало-Ненецкий автономный округ;90_105_days;AllVaccines;22564;2756;25320;346064;56429;402493
2022.02_01-07-2022;Ямало-Ненецкий автономный округ;90_105_days;CoviVac;361;31;392;346064;56429;402493
2022.02_01-07-2022;Ямало-Ненецкий автономный округ;90_105_days;EpiVacCorona;127;11;138;346064;56429;402493
2022.02_01-07-2022;Ямало-Ненецкий автономный округ;90_105_days;SputnikLite;11021;1918;12939;346064;56429;402493
2022.02_01-07-2022;Ямало-Ненецкий автономный округ;90_105_days;SputnikV;11055;796;11851;346064;56429;402493
2022.02_01-07-2022;Ярославская область;105_165_days;AllVaccines;62259;30577;92836;682586;317712;1000298
2022.02_01-07-2022;Ярославская область;105_165_days;CoviVac;150;20;170;682586;317712;1000298
2022.02_01-07-2022;Ярославская область;105_165_days;EpiVacCorona;666;265;931;682586;317712;1000298
2022.02_01-07-2022;Ярославская область;105_165_days;SputnikLite;35904;18019;53923;682586;317712;1000298
2022.02_01-07-2022;Ярославская область;105_165_days;SputnikV;25539;12273;37812;682586;317712;1000298
2022.02_01-07-2022;Ярославская область;165_195_days;AllVaccines;86093;16794;102887;682586;317712;1000298
2022.02_01-07-2022;Ярославская область;165_195_days;CoviVac;801;95;896;682586;317712;1000298
2022.02_01-07-2022;Ярославская область;165_195_days;EpiVacCorona;3023;698;3721;682586;317712;1000298
2022.02_01-07-2022;Ярославская область;165_195_days;SputnikLite;28389;3822;32211;682586;317712;1000298
2022.02_01-07-2022;Ярославская область;165_195_days;SputnikV;53880;12179;66059;682586;317712;1000298
2022.02_01-07-2022;Ярославская область;21_45_days;AllVaccines;20956;12256;33212;682586;317712;1000298
2022.02_01-07-2022;Ярославская область;21_45_days;CoviVac;327;94;421;682586;317712;1000298
2022.02_01-07-2022;Ярославская область;21_45_days;EpiVacCorona;402;198;600;682586;317712;1000298
2022.02_01-07-2022;Ярославская область;21_45_days;SputnikLite;13251;8444;21695;682586;317712;1000298
2022.02_01-07-2022;Ярославская область;21_45_days;SputnikV;6976;3520;10496;682586;317712;1000298
2022.02_01-07-2022;Ярославская область;45_75_days;AllVaccines;45588;24974;70562;682586;317712;1000298
2022.02_01-07-2022;Ярославская область;45_75_days;CoviVac;873;176;1049;682586;317712;1000298
2022.02_01-07-2022;Ярославская область;45_75_days;EpiVacCorona;1203;594;1797;682586;317712;1000298
2022.02_01-07-2022;Ярославская область;45_75_days;SputnikLite;16785;11292;28077;682586;317712;1000298
2022.02_01-07-2022;Ярославская область;45_75_days;SputnikV;26727;12912;39639;682586;317712;1000298
2022.02_01-07-2022;Ярославская область;75_90_days;AllVaccines;29124;15479;44603;682586;317712;1000298
2022.02_01-07-2022;Ярославская область;75_90_days;CoviVac;380;34;414;682586;317712;1000298
2022.02_01-07-2022;Ярославская область;75_90_days;EpiVacCorona;377;145;522;682586;317712;1000298
2022.02_01-07-2022;Ярославская область;75_90_days;SputnikLite;14938;8498;23436;682586;317712;1000298
2022.02_01-07-2022;Ярославская область;75_90_days;SputnikV;13429;6802;20231;682586;317712;1000298
2022.02_01-07-2022;Ярославская область;90_105_days;AllVaccines;24561;14562;39123;682586;317712;1000298
2022.02_01-07-2022;Ярославская область;90_105_days;CoviVac;167;11;178;682586;317712;1000298
2022.02_01-07-2022;Ярославская область;90_105_days;EpiVacCorona;212;110;322;682586;317712;1000298
2022.02_01-07-2022;Ярославская область;90_105_days;SputnikLite;15507;8408;23915;682586;317712;1000298
2022.02_01-07-2022;Ярославская область;90_105_days;SputnikV;8675;6033;14708;682586;317712;1000298
2022.02_01-07-2022;г. Москва;105_165_days;AllVaccines;441568;313244;754812;7299088;3167729;10466817
2022.02_01-07-2022;г. Москва;105_165_days;CoviVac;12657;1992;14649;7299088;3167729;10466817
2022.02_01-07-2022;г. Москва;105_165_days;EpiVacCorona;2710;1887;4597;7299088;3167729;10466817
2022.02_01-07-2022;г. Москва;105_165_days;SputnikLite;178716;178430;357146;7299088;3167729;10466817
2022.02_01-07-2022;г. Москва;105_165_days;SputnikV;247485;130935;378420;7299088;3167729;10466817
2022.02_01-07-2022;г. Москва;165_195_days;AllVaccines;668286;141556;809842;7299088;3167729;10466817
2022.02_01-07-2022;г. Москва;165_195_days;CoviVac;18150;1655;19805;7299088;3167729;10466817
2022.02_01-07-2022;г. Москва;165_195_days;EpiVacCorona;3170;900;4070;7299088;3167729;10466817
2022.02_01-07-2022;г. Москва;165_195_days;SputnikLite;63951;14937;78888;7299088;3167729;10466817
2022.02_01-07-2022;г. Москва;165_195_days;SputnikV;583015;124064;707079;7299088;3167729;10466817
2022.02_01-07-2022;г. Москва;21_45_days;AllVaccines;219660;92453;312113;7299088;3167729;10466817
2022.02_01-07-2022;г. Москва;21_45_days;CoviVac;2581;337;2918;7299088;3167729;10466817
2022.02_01-07-2022;г. Москва;21_45_days;EpiVacCorona;148;76;224;7299088;3167729;10466817
2022.02_01-07-2022;г. Москва;21_45_days;SputnikLite;155291;65752;221043;7299088;3167729;10466817
2022.02_01-07-2022;г. Москва;21_45_days;SputnikV;61640;26288;87928;7299088;3167729;10466817
2022.02_01-07-2022;г. Москва;45_75_days;AllVaccines;346985;201591;548576;7299088;3167729;10466817
2022.02_01-07-2022;г. Москва;45_75_days;CoviVac;17322;1808;19130;7299088;3167729;10466817
2022.02_01-07-2022;г. Москва;45_75_days;EpiVacCorona;1100;676;1776;7299088;3167729;10466817
2022.02_01-07-2022;г. Москва;45_75_days;SputnikLite;98854;82400;181254;7299088;3167729;10466817
2022.02_01-07-2022;г. Москва;45_75_days;SputnikV;229709;116707;346416;7299088;3167729;10466817
2022.02_01-07-2022;г. Москва;75_90_days;AllVaccines;226720;149974;376694;7299088;3167729;10466817
2022.02_01-07-2022;г. Москва;75_90_days;CoviVac;8961;1475;10436;7299088;3167729;10466817
2022.02_01-07-2022;г. Москва;75_90_days;EpiVacCorona;565;410;975;7299088;3167729;10466817
2022.02_01-07-2022;г. Москва;75_90_days;SputnikLite;73038;55526;128564;7299088;3167729;10466817
2022.02_01-07-2022;г. Москва;75_90_days;SputnikV;144156;92563;236719;7299088;3167729;10466817
2022.02_01-07-2022;г. Москва;90_105_days;AllVaccines;178600;142290;320890;7299088;3167729;10466817
2022.02_01-07-2022;г. Москва;90_105_days;CoviVac;5920;1474;7394;7299088;3167729;10466817
2022.02_01-07-2022;г. Москва;90_105_days;EpiVacCorona;797;594;1391;7299088;3167729;10466817
2022.02_01-07-2022;г. Москва;90_105_days;SputnikLite;77096;63578;140674;7299088;3167729;10466817
2022.02_01-07-2022;г. Москва;90_105_days;SputnikV;94787;76644;171431;7299088;3167729;10466817
2022.02_01-07-2022;г. Санкт-Петербург;105_165_days;AllVaccines;377560;137423;514983;3114778;1306302;4421080
2022.02_01-07-2022;г. Санкт-Петербург;105_165_days;CoviVac;12070;691;12761;3114778;1306302;4421080
2022.02_01-07-2022;г. Санкт-Петербург;105_165_days;EpiVacCorona;721;365;1086;3114778;1306302;4421080
2022.02_01-07-2022;г. Санкт-Петербург;105_165_days;SputnikLite;219691;76007;295698;3114778;1306302;4421080
2022.02_01-07-2022;г. Санкт-Петербург;105_165_days;SputnikV;145078;60360;205438;3114778;1306302;4421080
2022.02_01-07-2022;г. Санкт-Петербург;165_195_days;AllVaccines;369258;67725;436983;3114778;1306302;4421080
2022.02_01-07-2022;г. Санкт-Петербург;165_195_days;CoviVac;4997;218;5215;3114778;1306302;4421080
2022.02_01-07-2022;г. Санкт-Петербург;165_195_days;EpiVacCorona;1173;477;1650;3114778;1306302;4421080
2022.02_01-07-2022;г. Санкт-Петербург;165_195_days;SputnikLite;129582;11420;141002;3114778;1306302;4421080
2022.02_01-07-2022;г. Санкт-Петербург;165_195_days;SputnikV;233506;55610;289116;3114778;1306302;4421080
2022.02_01-07-2022;г. Санкт-Петербург;21_45_days;AllVaccines;139803;56265;196068;3114778;1306302;4421080
2022.02_01-07-2022;г. Санкт-Петербург;21_45_days;CoviVac;634;61;695;3114778;1306302;4421080
2022.02_01-07-2022;г. Санкт-Петербург;21_45_days;EpiVacCorona;1204;537;1741;3114778;1306302;4421080
2022.02_01-07-2022;г. Санкт-Петербург;21_45_days;SputnikLite;72040;34129;106169;3114778;1306302;4421080
2022.02_01-07-2022;г. Санкт-Петербург;21_45_days;SputnikV;65925;21538;87463;3114778;1306302;4421080
2022.02_01-07-2022;г. Санкт-Петербург;45_75_days;AllVaccines;371728;133797;505525;3114778;1306302;4421080
2022.02_01-07-2022;г. Санкт-Петербург;45_75_days;CoviVac;2495;194;2689;3114778;1306302;4421080
2022.02_01-07-2022;г. Санкт-Петербург;45_75_days;EpiVacCorona;4420;1986;6406;3114778;1306302;4421080
2022.02_01-07-2022;г. Санкт-Петербург;45_75_days;SputnikLite;112377;58489;170866;3114778;1306302;4421080
2022.02_01-07-2022;г. Санкт-Петербург;45_75_days;SputnikV;252436;73128;325564;3114778;1306302;4421080
2022.02_01-07-2022;г. Санкт-Петербург;75_90_days;AllVaccines;205175;73082;278257;3114778;1306302;4421080
2022.02_01-07-2022;г. Санкт-Петербург;75_90_days;CoviVac;1159;106;1265;3114778;1306302;4421080
2022.02_01-07-2022;г. Санкт-Петербург;75_90_days;EpiVacCorona;1934;822;2756;3114778;1306302;4421080
2022.02_01-07-2022;г. Санкт-Петербург;75_90_days;SputnikLite;69072;31658;100730;3114778;1306302;4421080
2022.02_01-07-2022;г. Санкт-Петербург;75_90_days;SputnikV;133010;40496;173506;3114778;1306302;4421080
2022.02_01-07-2022;г. Санкт-Петербург;90_105_days;AllVaccines;138178;57180;195358;3114778;1306302;4421080
2022.02_01-07-2022;г. Санкт-Петербург;90_105_days;CoviVac;2374;172;2546;3114778;1306302;4421080
2022.02_01-07-2022;г. Санкт-Петербург;90_105_days;EpiVacCorona;1138;562;1700;3114778;1306302;4421080
2022.02_01-07-2022;г. Санкт-Петербург;90_105_days;SputnikLite;68357;29168;97525;3114778;1306302;4421080
2022.02_01-07-2022;г. Санкт-Петербург;90_105_days;SputnikV;66309;27278;93587;3114778;1306302;4421080
2022.02_01-07-2022;г. Севастополь;105_165_days;AllVaccines;26685;11530;38215;293051;116400;409451
2022.02_01-07-2022;г. Севастополь;105_165_days;CoviVac;121;28;149;293051;116400;409451
2022.02_01-07-2022;г. Севастополь;105_165_days;EpiVacCorona;376;181;557;293051;116400;409451
2022.02_01-07-2022;г. Севастополь;105_165_days;SputnikLite;13449;8165;21614;293051;116400;409451
2022.02_01-07-2022;г. Севастополь;105_165_days;SputnikV;12739;3156;15895;293051;116400;409451
2022.02_01-07-2022;г. Севастополь;165_195_days;AllVaccines;14157;3987;18144;293051;116400;409451
2022.02_01-07-2022;г. Севастополь;165_195_days;CoviVac;203;56;259;293051;116400;409451
2022.02_01-07-2022;г. Севастополь;165_195_days;EpiVacCorona;337;200;537;293051;116400;409451
2022.02_01-07-2022;г. Севастополь;165_195_days;SputnikLite;613;407;1020;293051;116400;409451
2022.02_01-07-2022;г. Севастополь;165_195_days;SputnikV;13004;3324;16328;293051;116400;409451
2022.02_01-07-2022;г. Севастополь;21_45_days;AllVaccines;10824;5817;16641;293051;116400;409451
2022.02_01-07-2022;г. Севастополь;21_45_days;CoviVac;71;35;106;293051;116400;409451
2022.02_01-07-2022;г. Севастополь;21_45_days;EpiVacCorona;102;72;174;293051;116400;409451
2022.02_01-07-2022;г. Севастополь;21_45_days;SputnikLite;7045;4849;11894;293051;116400;409451
2022.02_01-07-2022;г. Севастополь;21_45_days;SputnikV;3606;861;4467;293051;116400;409451
2022.02_01-07-2022;г. Севастополь;45_75_days;AllVaccines;23516;10084;33600;293051;116400;409451
2022.02_01-07-2022;г. Севастополь;45_75_days;CoviVac;135;50;185;293051;116400;409451
2022.02_01-07-2022;г. Севастополь;45_75_days;EpiVacCorona;325;170;495;293051;116400;409451
2022.02_01-07-2022;г. Севастополь;45_75_days;SputnikLite;6166;5471;11637;293051;116400;409451
2022.02_01-07-2022;г. Севастополь;45_75_days;SputnikV;16890;4393;21283;293051;116400;409451
2022.02_01-07-2022;г. Севастополь;75_90_days;AllVaccines;25334;10843;36177;293051;116400;409451
2022.02_01-07-2022;г. Севастополь;75_90_days;CoviVac;161;41;202;293051;116400;409451
2022.02_01-07-2022;г. Севастополь;75_90_days;EpiVacCorona;328;124;452;293051;116400;409451
2022.02_01-07-2022;г. Севастополь;75_90_days;SputnikLite;6532;6503;13035;293051;116400;409451
2022.02_01-07-2022;г. Севастополь;75_90_days;SputnikV;18313;4175;22488;293051;116400;409451
2022.02_01-07-2022;г. Севастополь;90_105_days;AllVaccines;19275;4962;24237;293051;116400;409451
2022.02_01-07-2022;г. Севастополь;90_105_days;CoviVac;340;92;432;293051;116400;409451
2022.02_01-07-2022;г. Севастополь;90_105_days;EpiVacCorona;627;188;815;293051;116400;409451
2022.02_01-07-2022;г. Севастополь;90_105_days;SputnikLite;3058;2126;5184;293051;116400;409451
2022.02_01-07-2022;г. Севастополь;90_105_days;SputnikV;15250;2556;17806;293051;116400;409451
2022.03_13-10-2022;Алтайский край;105_165_days;AllVaccines;199857;121320;321177;1240936;570412;1811348
2022.03_13-10-2022;Алтайский край;105_165_days;CoviVac;3403;693;4096;1240936;570412;1811348
2022.03_13-10-2022;Алтайский край;105_165_days;EpiVacCorona;12956;6195;19151;1240936;570412;1811348
2022.03_13-10-2022;Алтайский край;105_165_days;SputnikLite;63527;46570;110097;1240936;570412;1811348
2022.03_13-10-2022;Алтайский край;105_165_days;SputnikV;119971;67862;187833;1240936;570412;1811348
2022.03_13-10-2022;Алтайский край;165_195_days;AllVaccines;44244;28203;72447;1240936;570412;1811348
2022.03_13-10-2022;Алтайский край;165_195_days;CoviVac;258;73;331;1240936;570412;1811348
2022.03_13-10-2022;Алтайский край;165_195_days;EpiVacCorona;385;197;582;1240936;570412;1811348
2022.03_13-10-2022;Алтайский край;165_195_days;SputnikLite;30424;19797;50221;1240936;570412;1811348
2022.03_13-10-2022;Алтайский край;165_195_days;SputnikV;13177;8136;21313;1240936;570412;1811348
2022.03_13-10-2022;Алтайский край;21_45_days;AllVaccines;12038;6780;18818;1240936;570412;1811348
2022.03_13-10-2022;Алтайский край;21_45_days;CoviVac;397;189;586;1240936;570412;1811348
2022.03_13-10-2022;Алтайский край;21_45_days;EpiVacCorona;1253;724;1977;1240936;570412;1811348
2022.03_13-10-2022;Алтайский край;21_45_days;SputnikLite;2471;1168;3639;1240936;570412;1811348
2022.03_13-10-2022;Алтайский край;21_45_days;SputnikV;7917;4699;12616;1240936;570412;1811348
2022.03_13-10-2022;Алтайский край;45_75_days;AllVaccines;54811;30167;84978;1240936;570412;1811348
2022.03_13-10-2022;Алтайский край;45_75_days;CoviVac;470;160;630;1240936;570412;1811348
2022.03_13-10-2022;Алтайский край;45_75_days;EpiVacCorona;2126;1359;3485;1240936;570412;1811348
2022.03_13-10-2022;Алтайский край;45_75_days;SputnikLite;31105;13735;44840;1240936;570412;1811348
2022.03_13-10-2022;Алтайский край;45_75_days;SputnikV;21110;14913;36023;1240936;570412;1811348
2022.03_13-10-2022;Алтайский край;75_90_days;AllVaccines;32951;16044;48995;1240936;570412;1811348
2022.03_13-10-2022;Алтайский край;75_90_days;CoviVac;189;63;252;1240936;570412;1811348
2022.03_13-10-2022;Алтайский край;75_90_days;EpiVacCorona;693;397;1090;1240936;570412;1811348
2022.03_13-10-2022;Алтайский край;75_90_days;SputnikLite;26564;12654;39218;1240936;570412;1811348
2022.03_13-10-2022;Алтайский край;75_90_days;SputnikV;5505;2930;8435;1240936;570412;1811348
2022.03_13-10-2022;Алтайский край;90_105_days;AllVaccines;19588;13220;32808;1240936;570412;1811348
2022.03_13-10-2022;Алтайский край;90_105_days;CoviVac;199;88;287;1240936;570412;1811348
2022.03_13-10-2022;Алтайский край;90_105_days;EpiVacCorona;1138;644;1782;1240936;570412;1811348
2022.03_13-10-2022;Алтайский край;90_105_days;SputnikLite;9147;6603;15750;1240936;570412;1811348
2022.03_13-10-2022;Алтайский край;90_105_days;SputnikV;9104;5885;14989;1240936;570412;1811348
2022.03_13-10-2022;Амурская область;105_165_days;AllVaccines;91988;33962;125950;444961;159780;604741
2022.03_13-10-2022;Амурская область;105_165_days;CoviVac;1643;462;2105;444961;159780;604741
2022.03_13-10-2022;Амурская область;105_165_days;EpiVacCorona;6915;2727;9642;444961;159780;604741
2022.03_13-10-2022;Амурская область;105_165_days;SputnikLite;26867;14421;41288;444961;159780;604741
2022.03_13-10-2022;Амурская область;105_165_days;SputnikV;56563;16352;72915;444961;159780;604741
2022.03_13-10-2022;Амурская область;165_195_days;AllVaccines;20546;8934;29480;444961;159780;604741
2022.03_13-10-2022;Амурская область;165_195_days;CoviVac;270;95;365;444961;159780;604741
2022.03_13-10-2022;Амурская область;165_195_days;EpiVacCorona;151;65;216;444961;159780;604741
2022.03_13-10-2022;Амурская область;165_195_days;SputnikLite;13163;6665;19828;444961;159780;604741
2022.03_13-10-2022;Амурская область;165_195_days;SputnikV;6962;2109;9071;444961;159780;604741
2022.03_13-10-2022;Амурская область;21_45_days;AllVaccines;8916;2442;11358;444961;159780;604741
2022.03_13-10-2022;Амурская область;21_45_days;CoviVac;85;12;97;444961;159780;604741
2022.03_13-10-2022;Амурская область;21_45_days;EpiVacCorona;501;229;730;444961;159780;604741
2022.03_13-10-2022;Амурская область;21_45_days;SputnikLite;4915;1182;6097;444961;159780;604741
2022.03_13-10-2022;Амурская область;21_45_days;SputnikV;3415;1019;4434;444961;159780;604741
2022.03_13-10-2022;Амурская область;45_75_days;AllVaccines;23207;7035;30242;444961;159780;604741
2022.03_13-10-2022;Амурская область;45_75_days;CoviVac;313;60;373;444961;159780;604741
2022.03_13-10-2022;Амурская область;45_75_days;EpiVacCorona;1314;505;1819;444961;159780;604741
2022.03_13-10-2022;Амурская область;45_75_days;SputnikLite;12546;3569;16115;444961;159780;604741
2022.03_13-10-2022;Амурская область;45_75_days;SputnikV;9034;2901;11935;444961;159780;604741
2022.03_13-10-2022;Амурская область;75_90_days;AllVaccines;12742;4069;16811;444961;159780;604741
2022.03_13-10-2022;Амурская область;75_90_days;CoviVac;111;16;127;444961;159780;604741
2022.03_13-10-2022;Амурская область;75_90_days;EpiVacCorona;595;163;758;444961;159780;604741
2022.03_13-10-2022;Амурская область;75_90_days;SputnikLite;9159;3340;12499;444961;159780;604741
2022.03_13-10-2022;Амурская область;75_90_days;SputnikV;2877;550;3427;444961;159780;604741
2022.03_13-10-2022;Амурская область;90_105_days;AllVaccines;9467;3087;12554;444961;159780;604741
2022.03_13-10-2022;Амурская область;90_105_days;CoviVac;100;27;127;444961;159780;604741
2022.03_13-10-2022;Амурская область;90_105_days;EpiVacCorona;768;249;1017;444961;159780;604741
2022.03_13-10-2022;Амурская область;90_105_days;SputnikLite;3924;1672;5596;444961;159780;604741
2022.03_13-10-2022;Амурская область;90_105_days;SputnikV;4675;1139;5814;444961;159780;604741
2022.03_13-10-2022;Архангельская область;105_165_days;AllVaccines;102318;60795;163113;595439;264499;859938
2022.03_13-10-2022;Архангельская область;105_165_days;CoviVac;1830;298;2128;595439;264499;859938
2022.03_13-10-2022;Архангельская область;105_165_days;EpiVacCorona;6235;2819;9054;595439;264499;859938
2022.03_13-10-2022;Архангельская область;105_165_days;SputnikLite;34324;25684;60008;595439;264499;859938
2022.03_13-10-2022;Архангельская область;105_165_days;SputnikV;59929;31994;91923;595439;264499;859938
2022.03_13-10-2022;Архангельская область;165_195_days;AllVaccines;40495;17135;57630;595439;264499;859938
2022.03_13-10-2022;Архангельская область;165_195_days;CoviVac;252;61;313;595439;264499;859938
2022.03_13-10-2022;Архангельская область;165_195_days;EpiVacCorona;196;56;252;595439;264499;859938
2022.03_13-10-2022;Архангельская область;165_195_days;SputnikLite;31689;13072;44761;595439;264499;859938
2022.03_13-10-2022;Архангельская область;165_195_days;SputnikV;8358;3946;12304;595439;264499;859938
2022.03_13-10-2022;Архангельская область;21_45_days;AllVaccines;7524;4953;12477;595439;264499;859938
2022.03_13-10-2022;Архангельская область;21_45_days;CoviVac;149;29;178;595439;264499;859938
2022.03_13-10-2022;Архангельская область;21_45_days;EpiVacCorona;460;509;969;595439;264499;859938
2022.03_13-10-2022;Архангельская область;21_45_days;SputnikLite;996;693;1689;595439;264499;859938
2022.03_13-10-2022;Архангельская область;21_45_days;SputnikV;5919;3722;9641;595439;264499;859938
2022.03_13-10-2022;Архангельская область;45_75_days;AllVaccines;14233;8114;22347;595439;264499;859938
2022.03_13-10-2022;Архангельская область;45_75_days;CoviVac;242;41;283;595439;264499;859938
2022.03_13-10-2022;Архангельская область;45_75_days;EpiVacCorona;588;420;1008;595439;264499;859938
2022.03_13-10-2022;Архангельская область;45_75_days;SputnikLite;5262;2698;7960;595439;264499;859938
2022.03_13-10-2022;Архангельская область;45_75_days;SputnikV;8141;4955;13096;595439;264499;859938
2022.03_13-10-2022;Архангельская область;75_90_days;AllVaccines;10330;6515;16845;595439;264499;859938
2022.03_13-10-2022;Архангельская область;75_90_days;CoviVac;82;11;93;595439;264499;859938
2022.03_13-10-2022;Архангельская область;75_90_days;EpiVacCorona;208;130;338;595439;264499;859938
2022.03_13-10-2022;Архангельская область;75_90_days;SputnikLite;7877;5589;13466;595439;264499;859938
2022.03_13-10-2022;Архангельская область;75_90_days;SputnikV;2163;785;2948;595439;264499;859938
2022.03_13-10-2022;Архангельская область;90_105_days;AllVaccines;7581;5109;12690;595439;264499;859938
2022.03_13-10-2022;Архангельская область;90_105_days;CoviVac;88;10;98;595439;264499;859938
2022.03_13-10-2022;Архангельская область;90_105_days;EpiVacCorona;301;149;450;595439;264499;859938
2022.03_13-10-2022;Архангельская область;90_105_days;SputnikLite;3437;3019;6456;595439;264499;859938
2022.03_13-10-2022;Архангельская область;90_105_days;SputnikV;3755;1931;5686;595439;264499;859938
2022.03_13-10-2022;Астраханская область;105_165_days;AllVaccines;92666;34096;126762;550968;219749;770717
2022.03_13-10-2022;Астраханская область;105_165_days;CoviVac;1270;477;1747;550968;219749;770717
2022.03_13-10-2022;Астраханская область;105_165_days;EpiVacCorona;4918;1750;6668;550968;219749;770717
2022.03_13-10-2022;Астраханская область;105_165_days;SputnikLite;30768;14950;45718;550968;219749;770717
2022.03_13-10-2022;Астраханская область;105_165_days;SputnikV;55710;16919;72629;550968;219749;770717
2022.03_13-10-2022;Астраханская область;165_195_days;AllVaccines;27146;10042;37188;550968;219749;770717
2022.03_13-10-2022;Астраханская область;165_195_days;CoviVac;201;96;297;550968;219749;770717
2022.03_13-10-2022;Астраханская область;165_195_days;EpiVacCorona;321;159;480;550968;219749;770717
2022.03_13-10-2022;Астраханская область;165_195_days;SputnikLite;17842;7386;25228;550968;219749;770717
2022.03_13-10-2022;Астраханская область;165_195_days;SputnikV;8782;2401;11183;550968;219749;770717
2022.03_13-10-2022;Астраханская область;21_45_days;AllVaccines;9568;3563;13131;550968;219749;770717
2022.03_13-10-2022;Астраханская область;21_45_days;CoviVac;91;23;114;550968;219749;770717
2022.03_13-10-2022;Астраханская область;21_45_days;EpiVacCorona;180;49;229;550968;219749;770717
2022.03_13-10-2022;Астраханская область;21_45_days;SputnikLite;4388;1750;6138;550968;219749;770717
2022.03_13-10-2022;Астраханская область;21_45_days;SputnikV;4909;1741;6650;550968;219749;770717
2022.03_13-10-2022;Астраханская область;45_75_days;AllVaccines;20633;7937;28570;550968;219749;770717
2022.03_13-10-2022;Астраханская область;45_75_days;CoviVac;254;157;411;550968;219749;770717
2022.03_13-10-2022;Астраханская область;45_75_days;EpiVacCorona;488;198;686;550968;219749;770717
2022.03_13-10-2022;Астраханская область;45_75_days;SputnikLite;10907;3403;14310;550968;219749;770717
2022.03_13-10-2022;Астраханская область;45_75_days;SputnikV;8984;4179;13163;550968;219749;770717
2022.03_13-10-2022;Астраханская область;75_90_days;AllVaccines;11331;3949;15280;550968;219749;770717
2022.03_13-10-2022;Астраханская область;75_90_days;CoviVac;94;23;117;550968;219749;770717
2022.03_13-10-2022;Астраханская область;75_90_days;EpiVacCorona;98;26;124;550968;219749;770717
2022.03_13-10-2022;Астраханская область;75_90_days;SputnikLite;8339;3146;11485;550968;219749;770717
2022.03_13-10-2022;Астраханская область;75_90_days;SputnikV;2800;754;3554;550968;219749;770717
2022.03_13-10-2022;Астраханская область;90_105_days;AllVaccines;9759;3799;13558;550968;219749;770717
2022.03_13-10-2022;Астраханская область;90_105_days;CoviVac;124;42;166;550968;219749;770717
2022.03_13-10-2022;Астраханская область;90_105_days;EpiVacCorona;260;75;335;550968;219749;770717
2022.03_13-10-2022;Астраханская область;90_105_days;SputnikLite;4767;2191;6958;550968;219749;770717
2022.03_13-10-2022;Астраханская область;90_105_days;SputnikV;4608;1491;6099;550968;219749;770717
2022.03_13-10-2022;Белгородская область;105_165_days;AllVaccines;194687;91456;286143;867731;383871;1251602
2022.03_13-10-2022;Белгородская область;105_165_days;CoviVac;1597;593;2190;867731;383871;1251602
2022.03_13-10-2022;Белгородская область;105_165_days;EpiVacCorona;2330;1076;3406;867731;383871;1251602
2022.03_13-10-2022;Белгородская область;105_165_days;SputnikLite;82112;48899;131011;867731;383871;1251602
2022.03_13-10-2022;Белгородская область;105_165_days;SputnikV;108648;40888;149536;867731;383871;1251602
2022.03_13-10-2022;Белгородская область;165_195_days;AllVaccines;51483;34788;86271;867731;383871;1251602
2022.03_13-10-2022;Белгородская область;165_195_days;CoviVac;424;161;585;867731;383871;1251602
2022.03_13-10-2022;Белгородская область;165_195_days;EpiVacCorona;298;146;444;867731;383871;1251602
2022.03_13-10-2022;Белгородская область;165_195_days;SputnikLite;38192;27983;66175;867731;383871;1251602
2022.03_13-10-2022;Белгородская область;165_195_days;SputnikV;12569;6498;19067;867731;383871;1251602
2022.03_13-10-2022;Белгородская область;21_45_days;AllVaccines;8389;3860;12249;867731;383871;1251602
2022.03_13-10-2022;Белгородская область;21_45_days;CoviVac;193;63;256;867731;383871;1251602
2022.03_13-10-2022;Белгородская область;21_45_days;EpiVacCorona;342;179;521;867731;383871;1251602
2022.03_13-10-2022;Белгородская область;21_45_days;SputnikLite;4452;2195;6647;867731;383871;1251602
2022.03_13-10-2022;Белгородская область;21_45_days;SputnikV;3402;1423;4825;867731;383871;1251602
2022.03_13-10-2022;Белгородская область;45_75_days;AllVaccines;37237;13442;50679;867731;383871;1251602
2022.03_13-10-2022;Белгородская область;45_75_days;CoviVac;327;102;429;867731;383871;1251602
2022.03_13-10-2022;Белгородская область;45_75_days;EpiVacCorona;445;181;626;867731;383871;1251602
2022.03_13-10-2022;Белгородская область;45_75_days;SputnikLite;25447;9216;34663;867731;383871;1251602
2022.03_13-10-2022;Белгородская область;45_75_days;SputnikV;11018;3943;14961;867731;383871;1251602
2022.03_13-10-2022;Белгородская область;75_90_days;AllVaccines;34238;12850;47088;867731;383871;1251602
2022.03_13-10-2022;Белгородская область;75_90_days;CoviVac;110;45;155;867731;383871;1251602
2022.03_13-10-2022;Белгородская область;75_90_days;EpiVacCorona;170;73;243;867731;383871;1251602
2022.03_13-10-2022;Белгородская область;75_90_days;SputnikLite;30352;11486;41838;867731;383871;1251602
2022.03_13-10-2022;Белгородская область;75_90_days;SputnikV;3606;1246;4852;867731;383871;1251602
2022.03_13-10-2022;Белгородская область;90_105_days;AllVaccines;19018;8980;27998;867731;383871;1251602
2022.03_13-10-2022;Белгородская область;90_105_days;CoviVac;143;54;197;867731;383871;1251602
2022.03_13-10-2022;Белгородская область;90_105_days;EpiVacCorona;246;157;403;867731;383871;1251602
2022.03_13-10-2022;Белгородская область;90_105_days;SputnikLite;11525;6248;17773;867731;383871;1251602
2022.03_13-10-2022;Белгородская область;90_105_days;SputnikV;7104;2521;9625;867731;383871;1251602
2022.03_13-10-2022;Брянская область;105_165_days;AllVaccines;101939;62365;164304;659625;298625;958250
2022.03_13-10-2022;Брянская область;105_165_days;CoviVac;2416;672;3088;659625;298625;958250
2022.03_13-10-2022;Брянская область;105_165_days;EpiVacCorona;8303;3894;12197;659625;298625;958250
2022.03_13-10-2022;Брянская область;105_165_days;SputnikLite;28281;23119;51400;659625;298625;958250
2022.03_13-10-2022;Брянская область;105_165_days;SputnikV;62939;34680;97619;659625;298625;958250
2022.03_13-10-2022;Брянская область;165_195_days;AllVaccines;36162;18172;54334;659625;298625;958250
2022.03_13-10-2022;Брянская область;165_195_days;CoviVac;176;45;221;659625;298625;958250
2022.03_13-10-2022;Брянская область;165_195_days;EpiVacCorona;201;120;321;659625;298625;958250
2022.03_13-10-2022;Брянская область;165_195_days;SputnikLite;20674;13400;34074;659625;298625;958250
2022.03_13-10-2022;Брянская область;165_195_days;SputnikV;15111;4607;19718;659625;298625;958250
2022.03_13-10-2022;Брянская область;21_45_days;AllVaccines;5362;3103;8465;659625;298625;958250
2022.03_13-10-2022;Брянская область;21_45_days;CoviVac;112;32;144;659625;298625;958250
2022.03_13-10-2022;Брянская область;21_45_days;EpiVacCorona;162;89;251;659625;298625;958250
2022.03_13-10-2022;Брянская область;21_45_days;SputnikLite;1780;1208;2988;659625;298625;958250
2022.03_13-10-2022;Брянская область;21_45_days;SputnikV;3308;1774;5082;659625;298625;958250
2022.03_13-10-2022;Брянская область;45_75_days;AllVaccines;18067;10123;28190;659625;298625;958250
2022.03_13-10-2022;Брянская область;45_75_days;CoviVac;345;97;442;659625;298625;958250
2022.03_13-10-2022;Брянская область;45_75_days;EpiVacCorona;512;265;777;659625;298625;958250
2022.03_13-10-2022;Брянская область;45_75_days;SputnikLite;9084;4869;13953;659625;298625;958250
2022.03_13-10-2022;Брянская область;45_75_days;SputnikV;8126;4892;13018;659625;298625;958250
2022.03_13-10-2022;Брянская область;75_90_days;AllVaccines;15491;8364;23855;659625;298625;958250
2022.03_13-10-2022;Брянская область;75_90_days;CoviVac;139;53;192;659625;298625;958250
2022.03_13-10-2022;Брянская область;75_90_days;EpiVacCorona;260;118;378;659625;298625;958250
2022.03_13-10-2022;Брянская область;75_90_days;SputnikLite;13066;7302;20368;659625;298625;958250
2022.03_13-10-2022;Брянская область;75_90_days;SputnikV;2026;891;2917;659625;298625;958250
2022.03_13-10-2022;Брянская область;90_105_days;AllVaccines;10361;6627;16988;659625;298625;958250
2022.03_13-10-2022;Брянская область;90_105_days;CoviVac;179;48;227;659625;298625;958250
2022.03_13-10-2022;Брянская область;90_105_days;EpiVacCorona;467;252;719;659625;298625;958250
2022.03_13-10-2022;Брянская область;90_105_days;SputnikLite;6031;4235;10266;659625;298625;958250
2022.03_13-10-2022;Брянская область;90_105_days;SputnikV;3684;2092;5776;659625;298625;958250
2022.03_13-10-2022;Владимирская область;105_165_days;AllVaccines;131038;66963;198001;739166;354521;1093687
2022.03_13-10-2022;Владимирская область;105_165_days;CoviVac;2495;604;3099;739166;354521;1093687
2022.03_13-10-2022;Владимирская область;105_165_days;EpiVacCorona;7606;4131;11737;739166;354521;1093687
2022.03_13-10-2022;Владимирская область;105_165_days;SputnikLite;46912;30730;77642;739166;354521;1093687
2022.03_13-10-2022;Владимирская область;105_165_days;SputnikV;74025;31498;105523;739166;354521;1093687
2022.03_13-10-2022;Владимирская область;165_195_days;AllVaccines;28750;18097;46847;739166;354521;1093687
2022.03_13-10-2022;Владимирская область;165_195_days;CoviVac;81;21;102;739166;354521;1093687
2022.03_13-10-2022;Владимирская область;165_195_days;EpiVacCorona;243;146;389;739166;354521;1093687
2022.03_13-10-2022;Владимирская область;165_195_days;SputnikLite;19457;13472;32929;739166;354521;1093687
2022.03_13-10-2022;Владимирская область;165_195_days;SputnikV;8969;4458;13427;739166;354521;1093687
2022.03_13-10-2022;Владимирская область;21_45_days;AllVaccines;4474;2646;7120;739166;354521;1093687
2022.03_13-10-2022;Владимирская область;21_45_days;CoviVac;87;47;134;739166;354521;1093687
2022.03_13-10-2022;Владимирская область;21_45_days;EpiVacCorona;226;158;384;739166;354521;1093687
2022.03_13-10-2022;Владимирская область;21_45_days;SputnikLite;1100;809;1909;739166;354521;1093687
2022.03_13-10-2022;Владимирская область;21_45_days;SputnikV;3061;1632;4693;739166;354521;1093687
2022.03_13-10-2022;Владимирская область;45_75_days;AllVaccines;14046;8273;22319;739166;354521;1093687
2022.03_13-10-2022;Владимирская область;45_75_days;CoviVac;229;75;304;739166;354521;1093687
2022.03_13-10-2022;Владимирская область;45_75_days;EpiVacCorona;449;282;731;739166;354521;1093687
2022.03_13-10-2022;Владимирская область;45_75_days;SputnikLite;6758;3737;10495;739166;354521;1093687
2022.03_13-10-2022;Владимирская область;45_75_days;SputnikV;6610;4179;10789;739166;354521;1093687
2022.03_13-10-2022;Владимирская область;75_90_days;AllVaccines;12017;7911;19928;739166;354521;1093687
2022.03_13-10-2022;Владимирская область;75_90_days;CoviVac;67;42;109;739166;354521;1093687
2022.03_13-10-2022;Владимирская область;75_90_days;EpiVacCorona;257;217;474;739166;354521;1093687
2022.03_13-10-2022;Владимирская область;75_90_days;SputnikLite;9743;6814;16557;739166;354521;1093687
2022.03_13-10-2022;Владимирская область;75_90_days;SputnikV;1950;838;2788;739166;354521;1093687
2022.03_13-10-2022;Владимирская область;90_105_days;AllVaccines;7227;4547;11774;739166;354521;1093687
2022.03_13-10-2022;Владимирская область;90_105_days;CoviVac;64;23;87;739166;354521;1093687
2022.03_13-10-2022;Владимирская область;90_105_days;EpiVacCorona;627;443;1070;739166;354521;1093687
2022.03_13-10-2022;Владимирская область;90_105_days;SputnikLite;2652;2329;4981;739166;354521;1093687
2022.03_13-10-2022;Владимирская область;90_105_days;SputnikV;3884;1752;5636;739166;354521;1093687
2022.03_13-10-2022;Волгоградская область;105_165_days;AllVaccines;256795;141911;398706;1387837;615020;2002857
2022.03_13-10-2022;Волгоградская область;105_165_days;CoviVac;1485;452;1937;1387837;615020;2002857
2022.03_13-10-2022;Волгоградская область;105_165_days;EpiVacCorona;6561;3115;9676;1387837;615020;2002857
2022.03_13-10-2022;Волгоградская область;105_165_days;SputnikLite;67833;45659;113492;1387837;615020;2002857
2022.03_13-10-2022;Волгоградская область;105_165_days;SputnikV;180916;92685;273601;1387837;615020;2002857
2022.03_13-10-2022;Волгоградская область;165_195_days;AllVaccines;56789;32333;89122;1387837;615020;2002857
2022.03_13-10-2022;Волгоградская область;165_195_days;CoviVac;494;189;683;1387837;615020;2002857
2022.03_13-10-2022;Волгоградская область;165_195_days;EpiVacCorona;833;325;1158;1387837;615020;2002857
2022.03_13-10-2022;Волгоградская область;165_195_days;SputnikLite;35404;22248;57652;1387837;615020;2002857
2022.03_13-10-2022;Волгоградская область;165_195_days;SputnikV;20058;9571;29629;1387837;615020;2002857
2022.03_13-10-2022;Волгоградская область;21_45_days;AllVaccines;16560;8592;25152;1387837;615020;2002857
2022.03_13-10-2022;Волгоградская область;21_45_days;CoviVac;294;88;382;1387837;615020;2002857
2022.03_13-10-2022;Волгоградская область;21_45_days;EpiVacCorona;1271;584;1855;1387837;615020;2002857
2022.03_13-10-2022;Волгоградская область;21_45_days;SputnikLite;6021;2821;8842;1387837;615020;2002857
2022.03_13-10-2022;Волгоградская область;21_45_days;SputnikV;8974;5099;14073;1387837;615020;2002857
2022.03_13-10-2022;Волгоградская область;45_75_days;AllVaccines;51225;24398;75623;1387837;615020;2002857
2022.03_13-10-2022;Волгоградская область;45_75_days;CoviVac;831;219;1050;1387837;615020;2002857
2022.03_13-10-2022;Волгоградская область;45_75_days;EpiVacCorona;2106;951;3057;1387837;615020;2002857
2022.03_13-10-2022;Волгоградская область;45_75_days;SputnikLite;28034;11465;39499;1387837;615020;2002857
2022.03_13-10-2022;Волгоградская область;45_75_days;SputnikV;20254;11763;32017;1387837;615020;2002857
2022.03_13-10-2022;Волгоградская область;75_90_days;AllVaccines;34060;16004;50064;1387837;615020;2002857
2022.03_13-10-2022;Волгоградская область;75_90_days;CoviVac;242;73;315;1387837;615020;2002857
2022.03_13-10-2022;Волгоградская область;75_90_days;EpiVacCorona;553;972;1525;1387837;615020;2002857
2022.03_13-10-2022;Волгоградская область;75_90_days;SputnikLite;27429;11493;38922;1387837;615020;2002857
2022.03_13-10-2022;Волгоградская область;75_90_days;SputnikV;5836;3466;9302;1387837;615020;2002857
2022.03_13-10-2022;Волгоградская область;90_105_days;AllVaccines;24815;16001;40816;1387837;615020;2002857
2022.03_13-10-2022;Волгоградская область;90_105_days;CoviVac;186;85;271;1387837;615020;2002857
2022.03_13-10-2022;Волгоградская область;90_105_days;EpiVacCorona;879;1327;2206;1387837;615020;2002857
2022.03_13-10-2022;Волгоградская область;90_105_days;SputnikLite;13819;8699;22518;1387837;615020;2002857
2022.03_13-10-2022;Волгоградская область;90_105_days;SputnikV;9931;5890;15821;1387837;615020;2002857
2022.03_13-10-2022;Вологодская область;105_165_days;AllVaccines;119458;61270;180728;628100;275171;903271
2022.03_13-10-2022;Вологодская область;105_165_days;CoviVac;3500;570;4070;628100;275171;903271
2022.03_13-10-2022;Вологодская область;105_165_days;EpiVacCorona;4994;1980;6974;628100;275171;903271
2022.03_13-10-2022;Вологодская область;105_165_days;SputnikLite;28537;20680;49217;628100;275171;903271
2022.03_13-10-2022;Вологодская область;105_165_days;SputnikV;82427;38040;120467;628100;275171;903271
2022.03_13-10-2022;Вологодская область;165_195_days;AllVaccines;49870;17406;67276;628100;275171;903271
2022.03_13-10-2022;Вологодская область;165_195_days;CoviVac;23;1;24;628100;275171;903271
2022.03_13-10-2022;Вологодская область;165_195_days;EpiVacCorona;81;50;131;628100;275171;903271
2022.03_13-10-2022;Вологодская область;165_195_days;SputnikLite;44469;12932;57401;628100;275171;903271
2022.03_13-10-2022;Вологодская область;165_195_days;SputnikV;5297;4423;9720;628100;275171;903271
2022.03_13-10-2022;Вологодская область;21_45_days;AllVaccines;6403;3729;10132;628100;275171;903271
2022.03_13-10-2022;Вологодская область;21_45_days;CoviVac;113;17;130;628100;275171;903271
2022.03_13-10-2022;Вологодская область;21_45_days;EpiVacCorona;212;123;335;628100;275171;903271
2022.03_13-10-2022;Вологодская область;21_45_days;SputnikLite;1349;518;1867;628100;275171;903271
2022.03_13-10-2022;Вологодская область;21_45_days;SputnikV;4729;3071;7800;628100;275171;903271
2022.03_13-10-2022;Вологодская область;45_75_days;AllVaccines;15237;7489;22726;628100;275171;903271
2022.03_13-10-2022;Вологодская область;45_75_days;CoviVac;380;116;496;628100;275171;903271
2022.03_13-10-2022;Вологодская область;45_75_days;EpiVacCorona;653;335;988;628100;275171;903271
2022.03_13-10-2022;Вологодская область;45_75_days;SputnikLite;4682;1963;6645;628100;275171;903271
2022.03_13-10-2022;Вологодская область;45_75_days;SputnikV;9522;5075;14597;628100;275171;903271
2022.03_13-10-2022;Вологодская область;75_90_days;AllVaccines;11298;6090;17388;628100;275171;903271
2022.03_13-10-2022;Вологодская область;75_90_days;CoviVac;205;78;283;628100;275171;903271
2022.03_13-10-2022;Вологодская область;75_90_days;EpiVacCorona;330;173;503;628100;275171;903271
2022.03_13-10-2022;Вологодская область;75_90_days;SputnikLite;7142;4526;11668;628100;275171;903271
2022.03_13-10-2022;Вологодская область;75_90_days;SputnikV;3621;1313;4934;628100;275171;903271
2022.03_13-10-2022;Вологодская область;90_105_days;AllVaccines;12004;6017;18021;628100;275171;903271
2022.03_13-10-2022;Вологодская область;90_105_days;CoviVac;379;60;439;628100;275171;903271
2022.03_13-10-2022;Вологодская область;90_105_days;EpiVacCorona;602;309;911;628100;275171;903271
2022.03_13-10-2022;Вологодская область;90_105_days;SputnikLite;4261;3037;7298;628100;275171;903271
2022.03_13-10-2022;Вологодская область;90_105_days;SputnikV;6762;2611;9373;628100;275171;903271
2022.03_13-10-2022;Воронежская область;105_165_days;AllVaccines;281712;118350;400062;1293123;602333;1895456
2022.03_13-10-2022;Воронежская область;105_165_days;CoviVac;1636;493;2129;1293123;602333;1895456
2022.03_13-10-2022;Воронежская область;105_165_days;EpiVacCorona;10867;5048;15915;1293123;602333;1895456
2022.03_13-10-2022;Воронежская область;105_165_days;SputnikLite;60110;47505;107615;1293123;602333;1895456
2022.03_13-10-2022;Воронежская область;105_165_days;SputnikV;209099;65304;274403;1293123;602333;1895456
2022.03_13-10-2022;Воронежская область;165_195_days;AllVaccines;81811;40415;122226;1293123;602333;1895456
2022.03_13-10-2022;Воронежская область;165_195_days;CoviVac;1166;401;1567;1293123;602333;1895456
2022.03_13-10-2022;Воронежская область;165_195_days;EpiVacCorona;647;303;950;1293123;602333;1895456
2022.03_13-10-2022;Воронежская область;165_195_days;SputnikLite;56907;27990;84897;1293123;602333;1895456
2022.03_13-10-2022;Воронежская область;165_195_days;SputnikV;23091;11721;34812;1293123;602333;1895456
2022.03_13-10-2022;Воронежская область;21_45_days;AllVaccines;12858;7547;20405;1293123;602333;1895456
2022.03_13-10-2022;Воронежская область;21_45_days;CoviVac;319;142;461;1293123;602333;1895456
2022.03_13-10-2022;Воронежская область;21_45_days;EpiVacCorona;997;766;1763;1293123;602333;1895456
2022.03_13-10-2022;Воронежская область;21_45_days;SputnikLite;3506;2445;5951;1293123;602333;1895456
2022.03_13-10-2022;Воронежская область;21_45_days;SputnikV;8036;4194;12230;1293123;602333;1895456
2022.03_13-10-2022;Воронежская область;45_75_days;AllVaccines;36311;19760;56071;1293123;602333;1895456
2022.03_13-10-2022;Воронежская область;45_75_days;CoviVac;467;149;616;1293123;602333;1895456
2022.03_13-10-2022;Воронежская область;45_75_days;EpiVacCorona;1020;619;1639;1293123;602333;1895456
2022.03_13-10-2022;Воронежская область;45_75_days;SputnikLite;19643;8768;28411;1293123;602333;1895456
2022.03_13-10-2022;Воронежская область;45_75_days;SputnikV;15181;10224;25405;1293123;602333;1895456
2022.03_13-10-2022;Воронежская область;75_90_days;AllVaccines;26489;12982;39471;1293123;602333;1895456
2022.03_13-10-2022;Воронежская область;75_90_days;CoviVac;256;72;328;1293123;602333;1895456
2022.03_13-10-2022;Воронежская область;75_90_days;EpiVacCorona;414;185;599;1293123;602333;1895456
2022.03_13-10-2022;Воронежская область;75_90_days;SputnikLite;22204;10812;33016;1293123;602333;1895456
2022.03_13-10-2022;Воронежская область;75_90_days;SputnikV;3615;1913;5528;1293123;602333;1895456
2022.03_13-10-2022;Воронежская область;90_105_days;AllVaccines;18526;11254;29780;1293123;602333;1895456
2022.03_13-10-2022;Воронежская область;90_105_days;CoviVac;255;121;376;1293123;602333;1895456
2022.03_13-10-2022;Воронежская область;90_105_days;EpiVacCorona;979;670;1649;1293123;602333;1895456
2022.03_13-10-2022;Воронежская область;90_105_days;SputnikLite;9396;6977;16373;1293123;602333;1895456
2022.03_13-10-2022;Воронежская область;90_105_days;SputnikV;7896;3486;11382;1293123;602333;1895456
2022.03_13-10-2022;Еврейская автономная область;105_165_days;AllVaccines;19713;5885;25598;88207;31969;120176
2022.03_13-10-2022;Еврейская автономная область;105_165_days;CoviVac;303;55;358;88207;31969;120176
2022.03_13-10-2022;Еврейская автономная область;105_165_days;EpiVacCorona;1863;317;2180;88207;31969;120176
2022.03_13-10-2022;Еврейская автономная область;105_165_days;SputnikLite;4496;2392;6888;88207;31969;120176
2022.03_13-10-2022;Еврейская автономная область;105_165_days;SputnikV;13051;3121;16172;88207;31969;120176
2022.03_13-10-2022;Еврейская автономная область;165_195_days;AllVaccines;2444;1464;3908;88207;31969;120176
2022.03_13-10-2022;Еврейская автономная область;165_195_days;CoviVac;2;0;2;88207;31969;120176
2022.03_13-10-2022;Еврейская автономная область;165_195_days;EpiVacCorona;63;20;83;88207;31969;120176
2022.03_13-10-2022;Еврейская автономная область;165_195_days;SputnikLite;1675;1148;2823;88207;31969;120176
2022.03_13-10-2022;Еврейская автономная область;165_195_days;SputnikV;704;296;1000;88207;31969;120176
2022.03_13-10-2022;Еврейская автономная область;21_45_days;AllVaccines;799;247;1046;88207;31969;120176
2022.03_13-10-2022;Еврейская автономная область;21_45_days;CoviVac;29;2;31;88207;31969;120176
2022.03_13-10-2022;Еврейская автономная область;21_45_days;EpiVacCorona;266;72;338;88207;31969;120176
2022.03_13-10-2022;Еврейская автономная область;21_45_days;SputnikLite;160;75;235;88207;31969;120176
2022.03_13-10-2022;Еврейская автономная область;21_45_days;SputnikV;344;98;442;88207;31969;120176
2022.03_13-10-2022;Еврейская автономная область;45_75_days;AllVaccines;4927;1737;6664;88207;31969;120176
2022.03_13-10-2022;Еврейская автономная область;45_75_days;CoviVac;274;45;319;88207;31969;120176
2022.03_13-10-2022;Еврейская автономная область;45_75_days;EpiVacCorona;523;264;787;88207;31969;120176
2022.03_13-10-2022;Еврейская автономная область;45_75_days;SputnikLite;2800;1003;3803;88207;31969;120176
2022.03_13-10-2022;Еврейская автономная область;45_75_days;SputnikV;1330;425;1755;88207;31969;120176
2022.03_13-10-2022;Еврейская автономная область;75_90_days;AllVaccines;2054;782;2836;88207;31969;120176
2022.03_13-10-2022;Еврейская автономная область;75_90_days;CoviVac;118;29;147;88207;31969;120176
2022.03_13-10-2022;Еврейская автономная область;75_90_days;EpiVacCorona;302;96;398;88207;31969;120176
2022.03_13-10-2022;Еврейская автономная область;75_90_days;SputnikLite;1183;570;1753;88207;31969;120176
2022.03_13-10-2022;Еврейская автономная область;75_90_days;SputnikV;451;87;538;88207;31969;120176
2022.03_13-10-2022;Еврейская автономная область;90_105_days;AllVaccines;2453;859;3312;88207;31969;120176
2022.03_13-10-2022;Еврейская автономная область;90_105_days;CoviVac;253;41;294;88207;31969;120176
2022.03_13-10-2022;Еврейская автономная область;90_105_days;EpiVacCorona;575;144;719;88207;31969;120176
2022.03_13-10-2022;Еврейская автономная область;90_105_days;SputnikLite;920;492;1412;88207;31969;120176
2022.03_13-10-2022;Еврейская автономная область;90_105_days;SputnikV;705;182;887;88207;31969;120176
2022.03_13-10-2022;Забайкальский край;105_165_days;AllVaccines;122631;49477;172108;596322;191826;788148
2022.03_13-10-2022;Забайкальский край;105_165_days;CoviVac;1341;118;1459;596322;191826;788148
2022.03_13-10-2022;Забайкальский край;105_165_days;EpiVacCorona;6382;2172;8554;596322;191826;788148
2022.03_13-10-2022;Забайкальский край;105_165_days;SputnikLite;46084;20460;66544;596322;191826;788148
2022.03_13-10-2022;Забайкальский край;105_165_days;SputnikV;68824;26727;95551;596322;191826;788148
2022.03_13-10-2022;Забайкальский край;165_195_days;AllVaccines;31223;13834;45057;596322;191826;788148
2022.03_13-10-2022;Забайкальский край;165_195_days;CoviVac;148;15;163;596322;191826;788148
2022.03_13-10-2022;Забайкальский край;165_195_days;EpiVacCorona;83;35;118;596322;191826;788148
2022.03_13-10-2022;Забайкальский край;165_195_days;SputnikLite;26097;11587;37684;596322;191826;788148
2022.03_13-10-2022;Забайкальский край;165_195_days;SputnikV;4895;2197;7092;596322;191826;788148
2022.03_13-10-2022;Забайкальский край;21_45_days;AllVaccines;15307;4750;20057;596322;191826;788148
2022.03_13-10-2022;Забайкальский край;21_45_days;CoviVac;624;87;711;596322;191826;788148
2022.03_13-10-2022;Забайкальский край;21_45_days;EpiVacCorona;2140;542;2682;596322;191826;788148
2022.03_13-10-2022;Забайкальский край;21_45_days;SputnikLite;1559;297;1856;596322;191826;788148
2022.03_13-10-2022;Забайкальский край;21_45_days;SputnikV;10984;3824;14808;596322;191826;788148
2022.03_13-10-2022;Забайкальский край;45_75_days;AllVaccines;28341;8186;36527;596322;191826;788148
2022.03_13-10-2022;Забайкальский край;45_75_days;CoviVac;824;129;953;596322;191826;788148
2022.03_13-10-2022;Забайкальский край;45_75_days;EpiVacCorona;3066;1022;4088;596322;191826;788148
2022.03_13-10-2022;Забайкальский край;45_75_days;SputnikLite;8538;1390;9928;596322;191826;788148
2022.03_13-10-2022;Забайкальский край;45_75_days;SputnikV;15913;5645;21558;596322;191826;788148
2022.03_13-10-2022;Забайкальский край;75_90_days;AllVaccines;15197;4234;19431;596322;191826;788148
2022.03_13-10-2022;Забайкальский край;75_90_days;CoviVac;159;13;172;596322;191826;788148
2022.03_13-10-2022;Забайкальский край;75_90_days;EpiVacCorona;1029;355;1384;596322;191826;788148
2022.03_13-10-2022;Забайкальский край;75_90_days;SputnikLite;10027;2746;12773;596322;191826;788148
2022.03_13-10-2022;Забайкальский край;75_90_days;SputnikV;3982;1120;5102;596322;191826;788148
2022.03_13-10-2022;Забайкальский край;90_105_days;AllVaccines;13696;4825;18521;596322;191826;788148
2022.03_13-10-2022;Забайкальский край;90_105_days;CoviVac;136;30;166;596322;191826;788148
2022.03_13-10-2022;Забайкальский край;90_105_days;EpiVacCorona;1532;474;2006;596322;191826;788148
2022.03_13-10-2022;Забайкальский край;90_105_days;SputnikLite;5863;2336;8199;596322;191826;788148
2022.03_13-10-2022;Забайкальский край;90_105_days;SputnikV;6165;1985;8150;596322;191826;788148
2022.03_13-10-2022;Ивановская область;105_165_days;AllVaccines;53693;42721;96414;549803;255947;805750
2022.03_13-10-2022;Ивановская область;105_165_days;CoviVac;718;134;852;549803;255947;805750
2022.03_13-10-2022;Ивановская область;105_165_days;EpiVacCorona;1782;1529;3311;549803;255947;805750
2022.03_13-10-2022;Ивановская область;105_165_days;SputnikLite;23362;20819;44181;549803;255947;805750
2022.03_13-10-2022;Ивановская область;105_165_days;SputnikV;27831;20239;48070;549803;255947;805750
2022.03_13-10-2022;Ивановская область;165_195_days;AllVaccines;21392;15212;36604;549803;255947;805750
2022.03_13-10-2022;Ивановская область;165_195_days;CoviVac;87;15;102;549803;255947;805750
2022.03_13-10-2022;Ивановская область;165_195_days;EpiVacCorona;129;114;243;549803;255947;805750
2022.03_13-10-2022;Ивановская область;165_195_days;SputnikLite;15765;11394;27159;549803;255947;805750
2022.03_13-10-2022;Ивановская область;165_195_days;SputnikV;5411;3689;9100;549803;255947;805750
2022.03_13-10-2022;Ивановская область;21_45_days;AllVaccines;4273;2689;6962;549803;255947;805750
2022.03_13-10-2022;Ивановская область;21_45_days;CoviVac;107;10;117;549803;255947;805750
2022.03_13-10-2022;Ивановская область;21_45_days;EpiVacCorona;193;101;294;549803;255947;805750
2022.03_13-10-2022;Ивановская область;21_45_days;SputnikLite;1615;1296;2911;549803;255947;805750
2022.03_13-10-2022;Ивановская область;21_45_days;SputnikV;2358;1282;3640;549803;255947;805750
2022.03_13-10-2022;Ивановская область;45_75_days;AllVaccines;12470;6054;18524;549803;255947;805750
2022.03_13-10-2022;Ивановская область;45_75_days;CoviVac;243;39;282;549803;255947;805750
2022.03_13-10-2022;Ивановская область;45_75_days;EpiVacCorona;373;177;550;549803;255947;805750
2022.03_13-10-2022;Ивановская область;45_75_days;SputnikLite;6451;2587;9038;549803;255947;805750
2022.03_13-10-2022;Ивановская область;45_75_days;SputnikV;5403;3251;8654;549803;255947;805750
2022.03_13-10-2022;Ивановская область;75_90_days;AllVaccines;9714;4451;14165;549803;255947;805750
2022.03_13-10-2022;Ивановская область;75_90_days;CoviVac;68;10;78;549803;255947;805750
2022.03_13-10-2022;Ивановская область;75_90_days;EpiVacCorona;288;94;382;549803;255947;805750
2022.03_13-10-2022;Ивановская область;75_90_days;SputnikLite;8209;3828;12037;549803;255947;805750
2022.03_13-10-2022;Ивановская область;75_90_days;SputnikV;1149;519;1668;549803;255947;805750
2022.03_13-10-2022;Ивановская область;90_105_days;AllVaccines;5297;3801;9098;549803;255947;805750
2022.03_13-10-2022;Ивановская область;90_105_days;CoviVac;61;9;70;549803;255947;805750
2022.03_13-10-2022;Ивановская область;90_105_days;EpiVacCorona;331;202;533;549803;255947;805750
2022.03_13-10-2022;Ивановская область;90_105_days;SputnikLite;2970;2243;5213;549803;255947;805750
2022.03_13-10-2022;Ивановская область;90_105_days;SputnikV;1935;1347;3282;549803;255947;805750
2022.03_13-10-2022;Иркутская область;105_165_days;AllVaccines;327400;105682;433082;1316761;480655;1797416
2022.03_13-10-2022;Иркутская область;105_165_days;CoviVac;4168;864;5032;1316761;480655;1797416
2022.03_13-10-2022;Иркутская область;105_165_days;EpiVacCorona;6703;2160;8863;1316761;480655;1797416
2022.03_13-10-2022;Иркутская область;105_165_days;SputnikLite;73252;52267;125519;1316761;480655;1797416
2022.03_13-10-2022;Иркутская область;105_165_days;SputnikV;243277;50391;293668;1316761;480655;1797416
2022.03_13-10-2022;Иркутская область;165_195_days;AllVaccines;53121;28945;82066;1316761;480655;1797416
2022.03_13-10-2022;Иркутская область;165_195_days;CoviVac;520;181;701;1316761;480655;1797416
2022.03_13-10-2022;Иркутская область;165_195_days;EpiVacCorona;840;404;1244;1316761;480655;1797416
2022.03_13-10-2022;Иркутская область;165_195_days;SputnikLite;30317;21719;52036;1316761;480655;1797416
2022.03_13-10-2022;Иркутская область;165_195_days;SputnikV;21444;6641;28085;1316761;480655;1797416
2022.03_13-10-2022;Иркутская область;21_45_days;AllVaccines;13019;4795;17814;1316761;480655;1797416
2022.03_13-10-2022;Иркутская область;21_45_days;CoviVac;278;57;335;1316761;480655;1797416
2022.03_13-10-2022;Иркутская область;21_45_days;EpiVacCorona;539;208;747;1316761;480655;1797416
2022.03_13-10-2022;Иркутская область;21_45_days;SputnikLite;2069;538;2607;1316761;480655;1797416
2022.03_13-10-2022;Иркутская область;21_45_days;SputnikV;10133;3992;14125;1316761;480655;1797416
2022.03_13-10-2022;Иркутская область;45_75_days;AllVaccines;41189;18095;59284;1316761;480655;1797416
2022.03_13-10-2022;Иркутская область;45_75_days;CoviVac;459;228;687;1316761;480655;1797416
2022.03_13-10-2022;Иркутская область;45_75_days;EpiVacCorona;1296;1091;2387;1316761;480655;1797416
2022.03_13-10-2022;Иркутская область;45_75_days;SputnikLite;17146;7904;25050;1316761;480655;1797416
2022.03_13-10-2022;Иркутская область;45_75_days;SputnikV;22288;8872;31160;1316761;480655;1797416
2022.03_13-10-2022;Иркутская область;75_90_days;AllVaccines;29818;11919;41737;1316761;480655;1797416
2022.03_13-10-2022;Иркутская область;75_90_days;CoviVac;172;44;216;1316761;480655;1797416
2022.03_13-10-2022;Иркутская область;75_90_days;EpiVacCorona;590;337;927;1316761;480655;1797416
2022.03_13-10-2022;Иркутская область;75_90_days;SputnikLite;19170;9571;28741;1316761;480655;1797416
2022.03_13-10-2022;Иркутская область;75_90_days;SputnikV;9886;1967;11853;1316761;480655;1797416
2022.03_13-10-2022;Иркутская область;90_105_days;AllVaccines;27821;12948;40769;1316761;480655;1797416
2022.03_13-10-2022;Иркутская область;90_105_days;CoviVac;149;47;196;1316761;480655;1797416
2022.03_13-10-2022;Иркутская область;90_105_days;EpiVacCorona;802;416;1218;1316761;480655;1797416
2022.03_13-10-2022;Иркутская область;90_105_days;SputnikLite;11512;8918;20430;1316761;480655;1797416
2022.03_13-10-2022;Иркутская область;90_105_days;SputnikV;15358;3567;18925;1316761;480655;1797416
2022.03_13-10-2022;Кабардино-Балкарская Республика;105_165_days;AllVaccines;51908;16414;68322;502388;159241;661629
2022.03_13-10-2022;Кабардино-Балкарская Республика;105_165_days;CoviVac;331;85;416;502388;159241;661629
2022.03_13-10-2022;Кабардино-Балкарская Республика;105_165_days;EpiVacCorona;1493;407;1900;502388;159241;661629
2022.03_13-10-2022;Кабардино-Балкарская Республика;105_165_days;SputnikLite;29764;8453;38217;502388;159241;661629
2022.03_13-10-2022;Кабардино-Балкарская Республика;105_165_days;SputnikV;20320;7469;27789;502388;159241;661629
2022.03_13-10-2022;Кабардино-Балкарская Республика;165_195_days;AllVaccines;20664;6727;27391;502388;159241;661629
2022.03_13-10-2022;Кабардино-Балкарская Республика;165_195_days;CoviVac;121;45;166;502388;159241;661629
2022.03_13-10-2022;Кабардино-Балкарская Республика;165_195_days;EpiVacCorona;65;29;94;502388;159241;661629
2022.03_13-10-2022;Кабардино-Балкарская Республика;165_195_days;SputnikLite;16420;4860;21280;502388;159241;661629
2022.03_13-10-2022;Кабардино-Балкарская Республика;165_195_days;SputnikV;4058;1793;5851;502388;159241;661629
2022.03_13-10-2022;Кабардино-Балкарская Республика;21_45_days;AllVaccines;2678;1210;3888;502388;159241;661629
2022.03_13-10-2022;Кабардино-Балкарская Республика;21_45_days;CoviVac;59;9;68;502388;159241;661629
2022.03_13-10-2022;Кабардино-Балкарская Республика;21_45_days;EpiVacCorona;338;94;432;502388;159241;661629
2022.03_13-10-2022;Кабардино-Балкарская Республика;21_45_days;SputnikLite;636;273;909;502388;159241;661629
2022.03_13-10-2022;Кабардино-Балкарская Республика;21_45_days;SputnikV;1645;834;2479;502388;159241;661629
2022.03_13-10-2022;Кабардино-Балкарская Республика;45_75_days;AllVaccines;11181;4501;15682;502388;159241;661629
2022.03_13-10-2022;Кабардино-Балкарская Республика;45_75_days;CoviVac;227;48;275;502388;159241;661629
2022.03_13-10-2022;Кабардино-Балкарская Республика;45_75_days;EpiVacCorona;596;193;789;502388;159241;661629
2022.03_13-10-2022;Кабардино-Балкарская Республика;45_75_days;SputnikLite;5767;1833;7600;502388;159241;661629
2022.03_13-10-2022;Кабардино-Балкарская Республика;45_75_days;SputnikV;4591;2427;7018;502388;159241;661629
2022.03_13-10-2022;Кабардино-Балкарская Республика;75_90_days;AllVaccines;8243;3054;11297;502388;159241;661629
2022.03_13-10-2022;Кабардино-Балкарская Республика;75_90_days;CoviVac;54;23;77;502388;159241;661629
2022.03_13-10-2022;Кабардино-Балкарская Республика;75_90_days;EpiVacCorona;179;52;231;502388;159241;661629
2022.03_13-10-2022;Кабардино-Балкарская Республика;75_90_days;SputnikLite;6799;2510;9309;502388;159241;661629
2022.03_13-10-2022;Кабардино-Балкарская Республика;75_90_days;SputnikV;1211;469;1680;502388;159241;661629
2022.03_13-10-2022;Кабардино-Балкарская Республика;90_105_days;AllVaccines;6314;2386;8700;502388;159241;661629
2022.03_13-10-2022;Кабардино-Балкарская Республика;90_105_days;CoviVac;54;28;82;502388;159241;661629
2022.03_13-10-2022;Кабардино-Балкарская Республика;90_105_days;EpiVacCorona;667;162;829;502388;159241;661629
2022.03_13-10-2022;Кабардино-Балкарская Республика;90_105_days;SputnikLite;3567;1469;5036;502388;159241;661629
2022.03_13-10-2022;Кабардино-Балкарская Республика;90_105_days;SputnikV;2026;727;2753;502388;159241;661629
2022.03_13-10-2022;Калининградская область;105_165_days;AllVaccines;113164;55956;169120;585700;231702;817402
2022.03_13-10-2022;Калининградская область;105_165_days;CoviVac;1723;428;2151;585700;231702;817402
2022.03_13-10-2022;Калининградская область;105_165_days;EpiVacCorona;3410;1201;4611;585700;231702;817402
2022.03_13-10-2022;Калининградская область;105_165_days;SputnikLite;23372;21354;44726;585700;231702;817402
2022.03_13-10-2022;Калининградская область;105_165_days;SputnikV;84659;32973;117632;585700;231702;817402
2022.03_13-10-2022;Калининградская область;165_195_days;AllVaccines;42289;14007;56296;585700;231702;817402
2022.03_13-10-2022;Калининградская область;165_195_days;CoviVac;139;41;180;585700;231702;817402
2022.03_13-10-2022;Калининградская область;165_195_days;EpiVacCorona;343;94;437;585700;231702;817402
2022.03_13-10-2022;Калининградская область;165_195_days;SputnikLite;29800;9392;39192;585700;231702;817402
2022.03_13-10-2022;Калининградская область;165_195_days;SputnikV;12007;4480;16487;585700;231702;817402
2022.03_13-10-2022;Калининградская область;21_45_days;AllVaccines;5355;3137;8492;585700;231702;817402
2022.03_13-10-2022;Калининградская область;21_45_days;CoviVac;85;29;114;585700;231702;817402
2022.03_13-10-2022;Калининградская область;21_45_days;EpiVacCorona;128;79;207;585700;231702;817402
2022.03_13-10-2022;Калининградская область;21_45_days;SputnikLite;1110;835;1945;585700;231702;817402
2022.03_13-10-2022;Калининградская область;21_45_days;SputnikV;4032;2194;6226;585700;231702;817402
2022.03_13-10-2022;Калининградская область;45_75_days;AllVaccines;15473;7409;22882;585700;231702;817402
2022.03_13-10-2022;Калининградская область;45_75_days;CoviVac;226;65;291;585700;231702;817402
2022.03_13-10-2022;Калининградская область;45_75_days;EpiVacCorona;501;235;736;585700;231702;817402
2022.03_13-10-2022;Калининградская область;45_75_days;SputnikLite;5741;2657;8398;585700;231702;817402
2022.03_13-10-2022;Калининградская область;45_75_days;SputnikV;9005;4452;13457;585700;231702;817402
2022.03_13-10-2022;Калининградская область;75_90_days;AllVaccines;14467;7058;21525;585700;231702;817402
2022.03_13-10-2022;Калининградская область;75_90_days;CoviVac;129;52;181;585700;231702;817402
2022.03_13-10-2022;Калининградская область;75_90_days;EpiVacCorona;314;125;439;585700;231702;817402
2022.03_13-10-2022;Калининградская область;75_90_days;SputnikLite;10961;5736;16697;585700;231702;817402
2022.03_13-10-2022;Калининградская область;75_90_days;SputnikV;3063;1145;4208;585700;231702;817402
2022.03_13-10-2022;Калининградская область;90_105_days;AllVaccines;9943;5893;15836;585700;231702;817402
2022.03_13-10-2022;Калининградская область;90_105_days;CoviVac;211;63;274;585700;231702;817402
2022.03_13-10-2022;Калининградская область;90_105_days;EpiVacCorona;488;240;728;585700;231702;817402
2022.03_13-10-2022;Калининградская область;90_105_days;SputnikLite;3767;3295;7062;585700;231702;817402
2022.03_13-10-2022;Калининградская область;90_105_days;SputnikV;5477;2295;7772;585700;231702;817402
2022.03_13-10-2022;Калужская область;105_165_days;AllVaccines;148900;51973;200873;559789;253023;812812
2022.03_13-10-2022;Калужская область;105_165_days;CoviVac;3002;721;3723;559789;253023;812812
2022.03_13-10-2022;Калужская область;105_165_days;EpiVacCorona;6130;2110;8240;559789;253023;812812
2022.03_13-10-2022;Калужская область;105_165_days;SputnikLite;25408;17716;43124;559789;253023;812812
2022.03_13-10-2022;Калужская область;105_165_days;SputnikV;114360;31426;145786;559789;253023;812812
2022.03_13-10-2022;Калужская область;165_195_days;AllVaccines;34432;15804;50236;559789;253023;812812
2022.03_13-10-2022;Калужская область;165_195_days;CoviVac;134;27;161;559789;253023;812812
2022.03_13-10-2022;Калужская область;165_195_days;EpiVacCorona;376;262;638;559789;253023;812812
2022.03_13-10-2022;Калужская область;165_195_days;SputnikLite;26941;12298;39239;559789;253023;812812
2022.03_13-10-2022;Калужская область;165_195_days;SputnikV;6981;3217;10198;559789;253023;812812
2022.03_13-10-2022;Калужская область;21_45_days;AllVaccines;5458;2933;8391;559789;253023;812812
2022.03_13-10-2022;Калужская область;21_45_days;CoviVac;155;50;205;559789;253023;812812
2022.03_13-10-2022;Калужская область;21_45_days;EpiVacCorona;371;154;525;559789;253023;812812
2022.03_13-10-2022;Калужская область;21_45_days;SputnikLite;1173;993;2166;559789;253023;812812
2022.03_13-10-2022;Калужская область;21_45_days;SputnikV;3759;1736;5495;559789;253023;812812
2022.03_13-10-2022;Калужская область;45_75_days;AllVaccines;13179;6596;19775;559789;253023;812812
2022.03_13-10-2022;Калужская область;45_75_days;CoviVac;238;91;329;559789;253023;812812
2022.03_13-10-2022;Калужская область;45_75_days;EpiVacCorona;386;194;580;559789;253023;812812
2022.03_13-10-2022;Калужская область;45_75_days;SputnikLite;5086;2882;7968;559789;253023;812812
2022.03_13-10-2022;Калужская область;45_75_days;SputnikV;7469;3429;10898;559789;253023;812812
2022.03_13-10-2022;Калужская область;75_90_days;AllVaccines;11085;6446;17531;559789;253023;812812
2022.03_13-10-2022;Калужская область;75_90_days;CoviVac;113;43;156;559789;253023;812812
2022.03_13-10-2022;Калужская область;75_90_days;EpiVacCorona;210;85;295;559789;253023;812812
2022.03_13-10-2022;Калужская область;75_90_days;SputnikLite;7868;5381;13249;559789;253023;812812
2022.03_13-10-2022;Калужская область;75_90_days;SputnikV;2894;937;3831;559789;253023;812812
2022.03_13-10-2022;Калужская область;90_105_days;AllVaccines;10320;5498;15818;559789;253023;812812
2022.03_13-10-2022;Калужская область;90_105_days;CoviVac;80;25;105;559789;253023;812812
2022.03_13-10-2022;Калужская область;90_105_days;EpiVacCorona;341;219;560;559789;253023;812812
2022.03_13-10-2022;Калужская область;90_105_days;SputnikLite;3750;3070;6820;559789;253023;812812
2022.03_13-10-2022;Калужская область;90_105_days;SputnikV;6149;2184;8333;559789;253023;812812
2022.03_13-10-2022;Камчатский край;105_165_days;AllVaccines;32460;9688;42148;189425;56856;246281
2022.03_13-10-2022;Камчатский край;105_165_days;CoviVac;435;85;520;189425;56856;246281
2022.03_13-10-2022;Камчатский край;105_165_days;EpiVacCorona;932;309;1241;189425;56856;246281
2022.03_13-10-2022;Камчатский край;105_165_days;SputnikLite;15736;5732;21468;189425;56856;246281
2022.03_13-10-2022;Камчатский край;105_165_days;SputnikV;15357;3562;18919;189425;56856;246281
2022.03_13-10-2022;Камчатский край;165_195_days;AllVaccines;8144;2746;10890;189425;56856;246281
2022.03_13-10-2022;Камчатский край;165_195_days;CoviVac;3;3;6;189425;56856;246281
2022.03_13-10-2022;Камчатский край;165_195_days;EpiVacCorona;329;80;409;189425;56856;246281
2022.03_13-10-2022;Камчатский край;165_195_days;SputnikLite;5175;2146;7321;189425;56856;246281
2022.03_13-10-2022;Камчатский край;165_195_days;SputnikV;2637;517;3154;189425;56856;246281
2022.03_13-10-2022;Камчатский край;21_45_days;AllVaccines;2882;880;3762;189425;56856;246281
2022.03_13-10-2022;Камчатский край;21_45_days;CoviVac;55;7;62;189425;56856;246281
2022.03_13-10-2022;Камчатский край;21_45_days;EpiVacCorona;311;99;410;189425;56856;246281
2022.03_13-10-2022;Камчатский край;21_45_days;SputnikLite;510;169;679;189425;56856;246281
2022.03_13-10-2022;Камчатский край;21_45_days;SputnikV;2006;605;2611;189425;56856;246281
2022.03_13-10-2022;Камчатский край;45_75_days;AllVaccines;4489;1208;5697;189425;56856;246281
2022.03_13-10-2022;Камчатский край;45_75_days;CoviVac;45;5;50;189425;56856;246281
2022.03_13-10-2022;Камчатский край;45_75_days;EpiVacCorona;266;83;349;189425;56856;246281
2022.03_13-10-2022;Камчатский край;45_75_days;SputnikLite;1627;471;2098;189425;56856;246281
2022.03_13-10-2022;Камчатский край;45_75_days;SputnikV;2551;649;3200;189425;56856;246281
2022.03_13-10-2022;Камчатский край;75_90_days;AllVaccines;3240;1140;4380;189425;56856;246281
2022.03_13-10-2022;Камчатский край;75_90_days;CoviVac;6;2;8;189425;56856;246281
2022.03_13-10-2022;Камчатский край;75_90_days;EpiVacCorona;40;26;66;189425;56856;246281
2022.03_13-10-2022;Камчатский край;75_90_days;SputnikLite;2487;1022;3509;189425;56856;246281
2022.03_13-10-2022;Камчатский край;75_90_days;SputnikV;707;90;797;189425;56856;246281
2022.03_13-10-2022;Камчатский край;90_105_days;AllVaccines;2614;870;3484;189425;56856;246281
2022.03_13-10-2022;Камчатский край;90_105_days;CoviVac;10;3;13;189425;56856;246281
2022.03_13-10-2022;Камчатский край;90_105_days;EpiVacCorona;97;37;134;189425;56856;246281
2022.03_13-10-2022;Камчатский край;90_105_days;SputnikLite;1410;592;2002;189425;56856;246281
2022.03_13-10-2022;Камчатский край;90_105_days;SputnikV;1097;238;1335;189425;56856;246281
2022.03_13-10-2022;Карачаево-Черкесская Республика;105_165_days;AllVaccines;27808;10052;37860;266261;94005;360266
2022.03_13-10-2022;Карачаево-Черкесская Республика;105_165_days;CoviVac;160;61;221;266261;94005;360266
2022.03_13-10-2022;Карачаево-Черкесская Республика;105_165_days;EpiVacCorona;327;93;420;266261;94005;360266
2022.03_13-10-2022;Карачаево-Черкесская Республика;105_165_days;SputnikLite;17946;5808;23754;266261;94005;360266
2022.03_13-10-2022;Карачаево-Черкесская Республика;105_165_days;SputnikV;9375;4090;13465;266261;94005;360266
2022.03_13-10-2022;Карачаево-Черкесская Республика;165_195_days;AllVaccines;6218;2872;9090;266261;94005;360266
2022.03_13-10-2022;Карачаево-Черкесская Республика;165_195_days;CoviVac;14;14;28;266261;94005;360266
2022.03_13-10-2022;Карачаево-Черкесская Республика;165_195_days;EpiVacCorona;60;14;74;266261;94005;360266
2022.03_13-10-2022;Карачаево-Черкесская Республика;165_195_days;SputnikLite;4160;1913;6073;266261;94005;360266
2022.03_13-10-2022;Карачаево-Черкесская Республика;165_195_days;SputnikV;1984;931;2915;266261;94005;360266
2022.03_13-10-2022;Карачаево-Черкесская Республика;21_45_days;AllVaccines;5002;1578;6580;266261;94005;360266
2022.03_13-10-2022;Карачаево-Черкесская Республика;21_45_days;CoviVac;268;93;361;266261;94005;360266
2022.03_13-10-2022;Карачаево-Черкесская Республика;21_45_days;EpiVacCorona;757;206;963;266261;94005;360266
2022.03_13-10-2022;Карачаево-Черкесская Республика;21_45_days;SputnikLite;1327;496;1823;266261;94005;360266
2022.03_13-10-2022;Карачаево-Черкесская Республика;21_45_days;SputnikV;2650;783;3433;266261;94005;360266
2022.03_13-10-2022;Карачаево-Черкесская Республика;45_75_days;AllVaccines;7491;3092;10583;266261;94005;360266
2022.03_13-10-2022;Карачаево-Черкесская Республика;45_75_days;CoviVac;59;29;88;266261;94005;360266
2022.03_13-10-2022;Карачаево-Черкесская Республика;45_75_days;EpiVacCorona;680;173;853;266261;94005;360266
2022.03_13-10-2022;Карачаево-Черкесская Республика;45_75_days;SputnikLite;2023;715;2738;266261;94005;360266
2022.03_13-10-2022;Карачаево-Черкесская Республика;45_75_days;SputnikV;4729;2175;6904;266261;94005;360266
2022.03_13-10-2022;Карачаево-Черкесская Республика;75_90_days;AllVaccines;5750;1885;7635;266261;94005;360266
2022.03_13-10-2022;Карачаево-Черкесская Республика;75_90_days;CoviVac;101;24;125;266261;94005;360266
2022.03_13-10-2022;Карачаево-Черкесская Республика;75_90_days;EpiVacCorona;28;13;41;266261;94005;360266
2022.03_13-10-2022;Карачаево-Черкесская Республика;75_90_days;SputnikLite;4302;1468;5770;266261;94005;360266
2022.03_13-10-2022;Карачаево-Черкесская Республика;75_90_days;SputnikV;1319;380;1699;266261;94005;360266
2022.03_13-10-2022;Карачаево-Черкесская Республика;90_105_days;AllVaccines;4393;1508;5901;266261;94005;360266
2022.03_13-10-2022;Карачаево-Черкесская Республика;90_105_days;CoviVac;35;15;50;266261;94005;360266
2022.03_13-10-2022;Карачаево-Черкесская Республика;90_105_days;EpiVacCorona;474;133;607;266261;94005;360266
2022.03_13-10-2022;Карачаево-Черкесская Республика;90_105_days;SputnikLite;1965;811;2776;266261;94005;360266
2022.03_13-10-2022;Карачаево-Черкесская Республика;90_105_days;SputnikV;1919;549;2468;266261;94005;360266
2022.03_13-10-2022;Кемеровская область;105_165_days;AllVaccines;219600;106350;325950;1453976;610256;2064232
2022.03_13-10-2022;Кемеровская область;105_165_days;CoviVac;2920;563;3483;1453976;610256;2064232
2022.03_13-10-2022;Кемеровская область;105_165_days;EpiVacCorona;8713;4006;12719;1453976;610256;2064232
2022.03_13-10-2022;Кемеровская область;105_165_days;SputnikLite;49442;41770;91212;1453976;610256;2064232
2022.03_13-10-2022;Кемеровская область;105_165_days;SputnikV;158525;60011;218536;1453976;610256;2064232
2022.03_13-10-2022;Кемеровская область;165_195_days;AllVaccines;40053;26339;66392;1453976;610256;2064232
2022.03_13-10-2022;Кемеровская область;165_195_days;CoviVac;681;163;844;1453976;610256;2064232
2022.03_13-10-2022;Кемеровская область;165_195_days;EpiVacCorona;349;150;499;1453976;610256;2064232
2022.03_13-10-2022;Кемеровская область;165_195_days;SputnikLite;16131;18032;34163;1453976;610256;2064232
2022.03_13-10-2022;Кемеровская область;165_195_days;SputnikV;22892;7994;30886;1453976;610256;2064232
2022.03_13-10-2022;Кемеровская область;21_45_days;AllVaccines;15612;5397;21009;1453976;610256;2064232
2022.03_13-10-2022;Кемеровская область;21_45_days;CoviVac;367;93;460;1453976;610256;2064232
2022.03_13-10-2022;Кемеровская область;21_45_days;EpiVacCorona;959;455;1414;1453976;610256;2064232
2022.03_13-10-2022;Кемеровская область;21_45_days;SputnikLite;2685;919;3604;1453976;610256;2064232
2022.03_13-10-2022;Кемеровская область;21_45_days;SputnikV;11601;3930;15531;1453976;610256;2064232
2022.03_13-10-2022;Кемеровская область;45_75_days;AllVaccines;71150;27784;98934;1453976;610256;2064232
2022.03_13-10-2022;Кемеровская область;45_75_days;CoviVac;683;178;861;1453976;610256;2064232
2022.03_13-10-2022;Кемеровская область;45_75_days;EpiVacCorona;2878;1559;4437;1453976;610256;2064232
2022.03_13-10-2022;Кемеровская область;45_75_days;SputnikLite;33424;12177;45601;1453976;610256;2064232
2022.03_13-10-2022;Кемеровская область;45_75_days;SputnikV;34165;13870;48035;1453976;610256;2064232
2022.03_13-10-2022;Кемеровская область;75_90_days;AllVaccines;37690;15584;53274;1453976;610256;2064232
2022.03_13-10-2022;Кемеровская область;75_90_days;CoviVac;250;53;303;1453976;610256;2064232
2022.03_13-10-2022;Кемеровская область;75_90_days;EpiVacCorona;1805;1069;2874;1453976;610256;2064232
2022.03_13-10-2022;Кемеровская область;75_90_days;SputnikLite;27917;12204;40121;1453976;610256;2064232
2022.03_13-10-2022;Кемеровская область;75_90_days;SputnikV;7718;2258;9976;1453976;610256;2064232
2022.03_13-10-2022;Кемеровская область;90_105_days;AllVaccines;32139;15174;47313;1453976;610256;2064232
2022.03_13-10-2022;Кемеровская область;90_105_days;CoviVac;195;63;258;1453976;610256;2064232
2022.03_13-10-2022;Кемеровская область;90_105_days;EpiVacCorona;3389;1871;5260;1453976;610256;2064232
2022.03_13-10-2022;Кемеровская область;90_105_days;SputnikLite;13783;7765;21548;1453976;610256;2064232
2022.03_13-10-2022;Кемеровская область;90_105_days;SputnikV;14772;5475;20247;1453976;610256;2064232
2022.03_13-10-2022;Кировская область;105_165_days;AllVaccines;158848;89763;248611;663621;334585;998206
2022.03_13-10-2022;Кировская область;105_165_days;CoviVac;4137;475;4612;663621;334585;998206
2022.03_13-10-2022;Кировская область;105_165_days;EpiVacCorona;7546;2932;10478;663621;334585;998206
2022.03_13-10-2022;Кировская область;105_165_days;SputnikLite;56992;37271;94263;663621;334585;998206
2022.03_13-10-2022;Кировская область;105_165_days;SputnikV;90173;49085;139258;663621;334585;998206
2022.03_13-10-2022;Кировская область;165_195_days;AllVaccines;50695;24340;75035;663621;334585;998206
2022.03_13-10-2022;Кировская область;165_195_days;CoviVac;244;57;301;663621;334585;998206
2022.03_13-10-2022;Кировская область;165_195_days;EpiVacCorona;175;89;264;663621;334585;998206
2022.03_13-10-2022;Кировская область;165_195_days;SputnikLite;45205;20082;65287;663621;334585;998206
2022.03_13-10-2022;Кировская область;165_195_days;SputnikV;5071;4112;9183;663621;334585;998206
2022.03_13-10-2022;Кировская область;21_45_days;AllVaccines;6143;5383;11526;663621;334585;998206
2022.03_13-10-2022;Кировская область;21_45_days;CoviVac;67;9;76;663621;334585;998206
2022.03_13-10-2022;Кировская область;21_45_days;EpiVacCorona;156;78;234;663621;334585;998206
2022.03_13-10-2022;Кировская область;21_45_days;SputnikLite;2890;2548;5438;663621;334585;998206
2022.03_13-10-2022;Кировская область;21_45_days;SputnikV;3030;2748;5778;663621;334585;998206
2022.03_13-10-2022;Кировская область;45_75_days;AllVaccines;19212;12347;31559;663621;334585;998206
2022.03_13-10-2022;Кировская область;45_75_days;CoviVac;349;52;401;663621;334585;998206
2022.03_13-10-2022;Кировская область;45_75_days;EpiVacCorona;466;260;726;663621;334585;998206
2022.03_13-10-2022;Кировская область;45_75_days;SputnikLite;11227;5758;16985;663621;334585;998206
2022.03_13-10-2022;Кировская область;45_75_days;SputnikV;7170;6277;13447;663621;334585;998206
2022.03_13-10-2022;Кировская область;75_90_days;AllVaccines;17388;9749;27137;663621;334585;998206
2022.03_13-10-2022;Кировская область;75_90_days;CoviVac;204;54;258;663621;334585;998206
2022.03_13-10-2022;Кировская область;75_90_days;EpiVacCorona;352;157;509;663621;334585;998206
2022.03_13-10-2022;Кировская область;75_90_days;SputnikLite;14469;8232;22701;663621;334585;998206
2022.03_13-10-2022;Кировская область;75_90_days;SputnikV;2363;1306;3669;663621;334585;998206
2022.03_13-10-2022;Кировская область;90_105_days;AllVaccines;13826;9823;23649;663621;334585;998206
2022.03_13-10-2022;Кировская область;90_105_days;CoviVac;274;54;328;663621;334585;998206
2022.03_13-10-2022;Кировская область;90_105_days;EpiVacCorona;849;454;1303;663621;334585;998206
2022.03_13-10-2022;Кировская область;90_105_days;SputnikLite;8405;6079;14484;663621;334585;998206
2022.03_13-10-2022;Кировская область;90_105_days;SputnikV;4298;3236;7534;663621;334585;998206
2022.03_13-10-2022;Костромская область;105_165_days;AllVaccines;67308;34579;101887;339046;160543;499589
2022.03_13-10-2022;Костромская область;105_165_days;CoviVac;1127;316;1443;339046;160543;499589
2022.03_13-10-2022;Костромская область;105_165_days;EpiVacCorona;4990;2013;7003;339046;160543;499589
2022.03_13-10-2022;Костромская область;105_165_days;SputnikLite;34944;17247;52191;339046;160543;499589
2022.03_13-10-2022;Костромская область;105_165_days;SputnikV;26247;15003;41250;339046;160543;499589
2022.03_13-10-2022;Костромская область;165_195_days;AllVaccines;21330;10377;31707;339046;160543;499589
2022.03_13-10-2022;Костромская область;165_195_days;CoviVac;28;12;40;339046;160543;499589
2022.03_13-10-2022;Костромская область;165_195_days;EpiVacCorona;9;7;16;339046;160543;499589
2022.03_13-10-2022;Костромская область;165_195_days;SputnikLite;17722;8126;25848;339046;160543;499589
2022.03_13-10-2022;Костромская область;165_195_days;SputnikV;3571;2232;5803;339046;160543;499589
2022.03_13-10-2022;Костромская область;21_45_days;AllVaccines;2858;1630;4488;339046;160543;499589
2022.03_13-10-2022;Костромская область;21_45_days;CoviVac;117;25;142;339046;160543;499589
2022.03_13-10-2022;Костромская область;21_45_days;EpiVacCorona;354;200;554;339046;160543;499589
2022.03_13-10-2022;Костромская область;21_45_days;SputnikLite;313;200;513;339046;160543;499589
2022.03_13-10-2022;Костромская область;21_45_days;SputnikV;2074;1205;3279;339046;160543;499589
2022.03_13-10-2022;Костромская область;45_75_days;AllVaccines;11404;6293;17697;339046;160543;499589
2022.03_13-10-2022;Костромская область;45_75_days;CoviVac;408;160;568;339046;160543;499589
2022.03_13-10-2022;Костромская область;45_75_days;EpiVacCorona;696;379;1075;339046;160543;499589
2022.03_13-10-2022;Костромская область;45_75_days;SputnikLite;5253;2507;7760;339046;160543;499589
2022.03_13-10-2022;Костромская область;45_75_days;SputnikV;5047;3247;8294;339046;160543;499589
2022.03_13-10-2022;Костромская область;75_90_days;AllVaccines;4157;2291;6448;339046;160543;499589
2022.03_13-10-2022;Костромская область;75_90_days;CoviVac;105;31;136;339046;160543;499589
2022.03_13-10-2022;Костромская область;75_90_days;EpiVacCorona;291;142;433;339046;160543;499589
2022.03_13-10-2022;Костромская область;75_90_days;SputnikLite;2896;1771;4667;339046;160543;499589
2022.03_13-10-2022;Костромская область;75_90_days;SputnikV;865;347;1212;339046;160543;499589
2022.03_13-10-2022;Костромская область;90_105_days;AllVaccines;4233;2597;6830;339046;160543;499589
2022.03_13-10-2022;Костромская область;90_105_days;CoviVac;100;22;122;339046;160543;499589
2022.03_13-10-2022;Костромская область;90_105_days;EpiVacCorona;437;204;641;339046;160543;499589
2022.03_13-10-2022;Костромская область;90_105_days;SputnikLite;2054;1596;3650;339046;160543;499589
2022.03_13-10-2022;Костромская область;90_105_days;SputnikV;1642;775;2417;339046;160543;499589
2022.03_13-10-2022;Краснодарский край;105_165_days;AllVaccines;586775;279232;866007;3157155;1334085;4491240
2022.03_13-10-2022;Краснодарский край;105_165_days;CoviVac;5795;1840;7635;3157155;1334085;4491240
2022.03_13-10-2022;Краснодарский край;105_165_days;EpiVacCorona;10884;5700;16584;3157155;1334085;4491240
2022.03_13-10-2022;Краснодарский край;105_165_days;SputnikLite;92388;90125;182513;3157155;1334085;4491240
2022.03_13-10-2022;Краснодарский край;105_165_days;SputnikV;477708;181567;659275;3157155;1334085;4491240
2022.03_13-10-2022;Краснодарский край;165_195_days;AllVaccines;103389;71093;174482;3157155;1334085;4491240
2022.03_13-10-2022;Краснодарский край;165_195_days;CoviVac;2015;653;2668;3157155;1334085;4491240
2022.03_13-10-2022;Краснодарский край;165_195_days;EpiVacCorona;2119;1130;3249;3157155;1334085;4491240
2022.03_13-10-2022;Краснодарский край;165_195_days;SputnikLite;26107;32377;58484;3157155;1334085;4491240
2022.03_13-10-2022;Краснодарский край;165_195_days;SputnikV;73148;36933;110081;3157155;1334085;4491240
2022.03_13-10-2022;Краснодарский край;21_45_days;AllVaccines;53949;52312;106261;3157155;1334085;4491240
2022.03_13-10-2022;Краснодарский край;21_45_days;CoviVac;378;147;525;3157155;1334085;4491240
2022.03_13-10-2022;Краснодарский край;21_45_days;EpiVacCorona;7171;6748;13919;3157155;1334085;4491240
2022.03_13-10-2022;Краснодарский край;21_45_days;SputnikLite;4120;3062;7182;3157155;1334085;4491240
2022.03_13-10-2022;Краснодарский край;21_45_days;SputnikV;42280;42355;84635;3157155;1334085;4491240
2022.03_13-10-2022;Краснодарский край;45_75_days;AllVaccines;101863;63861;165724;3157155;1334085;4491240
2022.03_13-10-2022;Краснодарский край;45_75_days;CoviVac;1043;301;1344;3157155;1334085;4491240
2022.03_13-10-2022;Краснодарский край;45_75_days;EpiVacCorona;3969;3935;7904;3157155;1334085;4491240
2022.03_13-10-2022;Краснодарский край;45_75_days;SputnikLite;26512;10302;36814;3157155;1334085;4491240
2022.03_13-10-2022;Краснодарский край;45_75_days;SputnikV;70339;49323;119662;3157155;1334085;4491240
2022.03_13-10-2022;Краснодарский край;75_90_days;AllVaccines;66866;35683;102549;3157155;1334085;4491240
2022.03_13-10-2022;Краснодарский край;75_90_days;CoviVac;540;174;714;3157155;1334085;4491240
2022.03_13-10-2022;Краснодарский край;75_90_days;EpiVacCorona;1138;975;2113;3157155;1334085;4491240
2022.03_13-10-2022;Краснодарский край;75_90_days;SputnikLite;43182;20016;63198;3157155;1334085;4491240
2022.03_13-10-2022;Краснодарский край;75_90_days;SputnikV;22006;14518;36524;3157155;1334085;4491240
2022.03_13-10-2022;Краснодарский край;90_105_days;AllVaccines;67123;35575;102698;3157155;1334085;4491240
2022.03_13-10-2022;Краснодарский край;90_105_days;CoviVac;384;134;518;3157155;1334085;4491240
2022.03_13-10-2022;Краснодарский край;90_105_days;EpiVacCorona;1435;605;2040;3157155;1334085;4491240
2022.03_13-10-2022;Краснодарский край;90_105_days;SputnikLite;19623;15063;34686;3157155;1334085;4491240
2022.03_13-10-2022;Краснодарский край;90_105_days;SputnikV;45681;19773;65454;3157155;1334085;4491240
2022.03_13-10-2022;Красноярский край;105_165_days;AllVaccines;295423;118687;414110;1637377;585822;2223199
2022.03_13-10-2022;Красноярский край;105_165_days;CoviVac;4081;950;5031;1637377;585822;2223199
2022.03_13-10-2022;Красноярский край;105_165_days;EpiVacCorona;12620;6607;19227;1637377;585822;2223199
2022.03_13-10-2022;Красноярский край;105_165_days;SputnikLite;86888;44231;131119;1637377;585822;2223199
2022.03_13-10-2022;Красноярский край;105_165_days;SputnikV;191834;66899;258733;1637377;585822;2223199
2022.03_13-10-2022;Красноярский край;165_195_days;AllVaccines;73411;28883;102294;1637377;585822;2223199
2022.03_13-10-2022;Красноярский край;165_195_days;CoviVac;809;209;1018;1637377;585822;2223199
2022.03_13-10-2022;Красноярский край;165_195_days;EpiVacCorona;391;221;612;1637377;585822;2223199
2022.03_13-10-2022;Красноярский край;165_195_days;SputnikLite;50667;19634;70301;1637377;585822;2223199
2022.03_13-10-2022;Красноярский край;165_195_days;SputnikV;21544;8819;30363;1637377;585822;2223199
2022.03_13-10-2022;Красноярский край;21_45_days;AllVaccines;23990;8201;32191;1637377;585822;2223199
2022.03_13-10-2022;Красноярский край;21_45_days;CoviVac;510;209;719;1637377;585822;2223199
2022.03_13-10-2022;Красноярский край;21_45_days;EpiVacCorona;1179;589;1768;1637377;585822;2223199
2022.03_13-10-2022;Красноярский край;21_45_days;SputnikLite;4654;889;5543;1637377;585822;2223199
2022.03_13-10-2022;Красноярский край;21_45_days;SputnikV;17647;6514;24161;1637377;585822;2223199
2022.03_13-10-2022;Красноярский край;45_75_days;AllVaccines;77483;29162;106645;1637377;585822;2223199
2022.03_13-10-2022;Красноярский край;45_75_days;CoviVac;1175;474;1649;1637377;585822;2223199
2022.03_13-10-2022;Красноярский край;45_75_days;EpiVacCorona;2096;1348;3444;1637377;585822;2223199
2022.03_13-10-2022;Красноярский край;45_75_days;SputnikLite;37757;12430;50187;1637377;585822;2223199
2022.03_13-10-2022;Красноярский край;45_75_days;SputnikV;36455;14910;51365;1637377;585822;2223199
2022.03_13-10-2022;Красноярский край;75_90_days;AllVaccines;46242;18378;64620;1637377;585822;2223199
2022.03_13-10-2022;Красноярский край;75_90_days;CoviVac;413;126;539;1637377;585822;2223199
2022.03_13-10-2022;Красноярский край;75_90_days;EpiVacCorona;985;585;1570;1637377;585822;2223199
2022.03_13-10-2022;Красноярский край;75_90_days;SputnikLite;33406;14532;47938;1637377;585822;2223199
2022.03_13-10-2022;Красноярский край;75_90_days;SputnikV;11438;3135;14573;1637377;585822;2223199
2022.03_13-10-2022;Красноярский край;90_105_days;AllVaccines;37489;15808;53297;1637377;585822;2223199
2022.03_13-10-2022;Красноярский край;90_105_days;CoviVac;382;94;476;1637377;585822;2223199
2022.03_13-10-2022;Красноярский край;90_105_days;EpiVacCorona;1617;871;2488;1637377;585822;2223199
2022.03_13-10-2022;Красноярский край;90_105_days;SputnikLite;14646;8421;23067;1637377;585822;2223199
2022.03_13-10-2022;Красноярский край;90_105_days;SputnikV;20844;6422;27266;1637377;585822;2223199
2022.03_13-10-2022;Курганская область;105_165_days;AllVaccines;108529;53435;161964;425081;217502;642583
2022.03_13-10-2022;Курганская область;105_165_days;CoviVac;1821;594;2415;425081;217502;642583
2022.03_13-10-2022;Курганская область;105_165_days;EpiVacCorona;1473;762;2235;425081;217502;642583
2022.03_13-10-2022;Курганская область;105_165_days;SputnikLite;23269;25141;48410;425081;217502;642583
2022.03_13-10-2022;Курганская область;105_165_days;SputnikV;81966;26938;108904;425081;217502;642583
2022.03_13-10-2022;Курганская область;165_195_days;AllVaccines;34522;14591;49113;425081;217502;642583
2022.03_13-10-2022;Курганская область;165_195_days;CoviVac;201;60;261;425081;217502;642583
2022.03_13-10-2022;Курганская область;165_195_days;EpiVacCorona;40;24;64;425081;217502;642583
2022.03_13-10-2022;Курганская область;165_195_days;SputnikLite;25415;11603;37018;425081;217502;642583
2022.03_13-10-2022;Курганская область;165_195_days;SputnikV;8866;2904;11770;425081;217502;642583
2022.03_13-10-2022;Курганская область;21_45_days;AllVaccines;5787;3906;9693;425081;217502;642583
2022.03_13-10-2022;Курганская область;21_45_days;CoviVac;66;15;81;425081;217502;642583
2022.03_13-10-2022;Курганская область;21_45_days;EpiVacCorona;696;461;1157;425081;217502;642583
2022.03_13-10-2022;Курганская область;21_45_days;SputnikLite;2670;1738;4408;425081;217502;642583
2022.03_13-10-2022;Курганская область;21_45_days;SputnikV;2355;1692;4047;425081;217502;642583
2022.03_13-10-2022;Курганская область;45_75_days;AllVaccines;23507;13956;37463;425081;217502;642583
2022.03_13-10-2022;Курганская область;45_75_days;CoviVac;193;50;243;425081;217502;642583
2022.03_13-10-2022;Курганская область;45_75_days;EpiVacCorona;1367;998;2365;425081;217502;642583
2022.03_13-10-2022;Курганская область;45_75_days;SputnikLite;15085;8271;23356;425081;217502;642583
2022.03_13-10-2022;Курганская область;45_75_days;SputnikV;6862;4637;11499;425081;217502;642583
2022.03_13-10-2022;Курганская область;75_90_days;AllVaccines;13317;7467;20784;425081;217502;642583
2022.03_13-10-2022;Курганская область;75_90_days;CoviVac;84;20;104;425081;217502;642583
2022.03_13-10-2022;Курганская область;75_90_days;EpiVacCorona;497;317;814;425081;217502;642583
2022.03_13-10-2022;Курганская область;75_90_days;SputnikLite;10551;6156;16707;425081;217502;642583
2022.03_13-10-2022;Курганская область;75_90_days;SputnikV;2185;974;3159;425081;217502;642583
2022.03_13-10-2022;Курганская область;90_105_days;AllVaccines;9607;6790;16397;425081;217502;642583
2022.03_13-10-2022;Курганская область;90_105_days;CoviVac;95;37;132;425081;217502;642583
2022.03_13-10-2022;Курганская область;90_105_days;EpiVacCorona;713;545;1258;425081;217502;642583
2022.03_13-10-2022;Курганская область;90_105_days;SputnikLite;5117;4264;9381;425081;217502;642583
2022.03_13-10-2022;Курганская область;90_105_days;SputnikV;3682;1944;5626;425081;217502;642583
2022.03_13-10-2022;Курская область;105_165_days;AllVaccines;111700;61070;172770;604409;285634;890043
2022.03_13-10-2022;Курская область;105_165_days;CoviVac;2531;578;3109;604409;285634;890043
2022.03_13-10-2022;Курская область;105_165_days;EpiVacCorona;5820;2781;8601;604409;285634;890043
2022.03_13-10-2022;Курская область;105_165_days;SputnikLite;39617;28602;68219;604409;285634;890043
2022.03_13-10-2022;Курская область;105_165_days;SputnikV;63732;29109;92841;604409;285634;890043
2022.03_13-10-2022;Курская область;165_195_days;AllVaccines;31457;21260;52717;604409;285634;890043
2022.03_13-10-2022;Курская область;165_195_days;CoviVac;163;18;181;604409;285634;890043
2022.03_13-10-2022;Курская область;165_195_days;EpiVacCorona;369;204;573;604409;285634;890043
2022.03_13-10-2022;Курская область;165_195_days;SputnikLite;23574;16506;40080;604409;285634;890043
2022.03_13-10-2022;Курская область;165_195_days;SputnikV;7351;4532;11883;604409;285634;890043
2022.03_13-10-2022;Курская область;21_45_days;AllVaccines;8599;3174;11773;604409;285634;890043
2022.03_13-10-2022;Курская область;21_45_days;CoviVac;400;91;491;604409;285634;890043
2022.03_13-10-2022;Курская область;21_45_days;EpiVacCorona;563;224;787;604409;285634;890043
2022.03_13-10-2022;Курская область;21_45_days;SputnikLite;2276;642;2918;604409;285634;890043
2022.03_13-10-2022;Курская область;21_45_days;SputnikV;5360;2217;7577;604409;285634;890043
2022.03_13-10-2022;Курская область;45_75_days;AllVaccines;23841;9248;33089;604409;285634;890043
2022.03_13-10-2022;Курская область;45_75_days;CoviVac;502;98;600;604409;285634;890043
2022.03_13-10-2022;Курская область;45_75_days;EpiVacCorona;1278;607;1885;604409;285634;890043
2022.03_13-10-2022;Курская область;45_75_days;SputnikLite;15402;5263;20665;604409;285634;890043
2022.03_13-10-2022;Курская область;45_75_days;SputnikV;6659;3280;9939;604409;285634;890043
2022.03_13-10-2022;Курская область;75_90_days;AllVaccines;17509;7396;24905;604409;285634;890043
2022.03_13-10-2022;Курская область;75_90_days;CoviVac;218;52;270;604409;285634;890043
2022.03_13-10-2022;Курская область;75_90_days;EpiVacCorona;627;305;932;604409;285634;890043
2022.03_13-10-2022;Курская область;75_90_days;SputnikLite;15053;6353;21406;604409;285634;890043
2022.03_13-10-2022;Курская область;75_90_days;SputnikV;1611;686;2297;604409;285634;890043
2022.03_13-10-2022;Курская область;90_105_days;AllVaccines;10619;5684;16303;604409;285634;890043
2022.03_13-10-2022;Курская область;90_105_days;CoviVac;247;61;308;604409;285634;890043
2022.03_13-10-2022;Курская область;90_105_days;EpiVacCorona;853;427;1280;604409;285634;890043
2022.03_13-10-2022;Курская область;90_105_days;SputnikLite;5921;3444;9365;604409;285634;890043
2022.03_13-10-2022;Курская область;90_105_days;SputnikV;3598;1752;5350;604409;285634;890043
2022.03_13-10-2022;Ленинградская область;105_165_days;AllVaccines;184750;91699;276449;1100343;462742;1563085
2022.03_13-10-2022;Ленинградская область;105_165_days;CoviVac;2454;356;2810;1100343;462742;1563085
2022.03_13-10-2022;Ленинградская область;105_165_days;EpiVacCorona;4358;2331;6689;1100343;462742;1563085
2022.03_13-10-2022;Ленинградская область;105_165_days;SputnikLite;47606;34849;82455;1100343;462742;1563085
2022.03_13-10-2022;Ленинградская область;105_165_days;SputnikV;130332;54163;184495;1100343;462742;1563085
2022.03_13-10-2022;Ленинградская область;165_195_days;AllVaccines;58822;26366;85188;1100343;462742;1563085
2022.03_13-10-2022;Ленинградская область;165_195_days;CoviVac;970;211;1181;1100343;462742;1563085
2022.03_13-10-2022;Ленинградская область;165_195_days;EpiVacCorona;114;36;150;1100343;462742;1563085
2022.03_13-10-2022;Ленинградская область;165_195_days;SputnikLite;40104;17992;58096;1100343;462742;1563085
2022.03_13-10-2022;Ленинградская область;165_195_days;SputnikV;17634;8127;25761;1100343;462742;1563085
2022.03_13-10-2022;Ленинградская область;21_45_days;AllVaccines;9939;5197;15136;1100343;462742;1563085
2022.03_13-10-2022;Ленинградская область;21_45_days;CoviVac;193;19;212;1100343;462742;1563085
2022.03_13-10-2022;Ленинградская область;21_45_days;EpiVacCorona;190;81;271;1100343;462742;1563085
2022.03_13-10-2022;Ленинградская область;21_45_days;SputnikLite;2234;1526;3760;1100343;462742;1563085
2022.03_13-10-2022;Ленинградская область;21_45_days;SputnikV;7322;3571;10893;1100343;462742;1563085
2022.03_13-10-2022;Ленинградская область;45_75_days;AllVaccines;28475;14032;42507;1100343;462742;1563085
2022.03_13-10-2022;Ленинградская область;45_75_days;CoviVac;342;75;417;1100343;462742;1563085
2022.03_13-10-2022;Ленинградская область;45_75_days;EpiVacCorona;538;269;807;1100343;462742;1563085
2022.03_13-10-2022;Ленинградская область;45_75_days;SputnikLite;9929;5659;15588;1100343;462742;1563085
2022.03_13-10-2022;Ленинградская область;45_75_days;SputnikV;17666;8029;25695;1100343;462742;1563085
2022.03_13-10-2022;Ленинградская область;75_90_days;AllVaccines;18467;10477;28944;1100343;462742;1563085
2022.03_13-10-2022;Ленинградская область;75_90_days;CoviVac;136;29;165;1100343;462742;1563085
2022.03_13-10-2022;Ленинградская область;75_90_days;EpiVacCorona;411;217;628;1100343;462742;1563085
2022.03_13-10-2022;Ленинградская область;75_90_days;SputnikLite;11832;8245;20077;1100343;462742;1563085
2022.03_13-10-2022;Ленинградская область;75_90_days;SputnikV;6088;1986;8074;1100343;462742;1563085
2022.03_13-10-2022;Ленинградская область;90_105_days;AllVaccines;18715;10153;28868;1100343;462742;1563085
2022.03_13-10-2022;Ленинградская область;90_105_days;CoviVac;280;58;338;1100343;462742;1563085
2022.03_13-10-2022;Ленинградская область;90_105_days;EpiVacCorona;547;350;897;1100343;462742;1563085
2022.03_13-10-2022;Ленинградская область;90_105_days;SputnikLite;6389;5318;11707;1100343;462742;1563085
2022.03_13-10-2022;Ленинградская область;90_105_days;SputnikV;11499;4427;15926;1100343;462742;1563085
2022.03_13-10-2022;Липецкая область;105_165_days;AllVaccines;162017;61040;223057;621641;290878;912519
2022.03_13-10-2022;Липецкая область;105_165_days;CoviVac;677;86;763;621641;290878;912519
2022.03_13-10-2022;Липецкая область;105_165_days;EpiVacCorona;8051;2025;10076;621641;290878;912519
2022.03_13-10-2022;Липецкая область;105_165_days;SputnikLite;34627;29780;64407;621641;290878;912519
2022.03_13-10-2022;Липецкая область;105_165_days;SputnikV;118662;29149;147811;621641;290878;912519
2022.03_13-10-2022;Липецкая область;165_195_days;AllVaccines;37306;18337;55643;621641;290878;912519
2022.03_13-10-2022;Липецкая область;165_195_days;CoviVac;616;65;681;621641;290878;912519
2022.03_13-10-2022;Липецкая область;165_195_days;EpiVacCorona;438;102;540;621641;290878;912519
2022.03_13-10-2022;Липецкая область;165_195_days;SputnikLite;20711;13561;34272;621641;290878;912519
2022.03_13-10-2022;Липецкая область;165_195_days;SputnikV;15541;4609;20150;621641;290878;912519
2022.03_13-10-2022;Липецкая область;21_45_days;AllVaccines;11385;4664;16049;621641;290878;912519
2022.03_13-10-2022;Липецкая область;21_45_days;CoviVac;600;25;625;621641;290878;912519
2022.03_13-10-2022;Липецкая область;21_45_days;EpiVacCorona;964;541;1505;621641;290878;912519
2022.03_13-10-2022;Липецкая область;21_45_days;SputnikLite;2123;995;3118;621641;290878;912519
2022.03_13-10-2022;Липецкая область;21_45_days;SputnikV;7698;3103;10801;621641;290878;912519
2022.03_13-10-2022;Липецкая область;45_75_days;AllVaccines;21056;8835;29891;621641;290878;912519
2022.03_13-10-2022;Липецкая область;45_75_days;CoviVac;419;27;446;621641;290878;912519
2022.03_13-10-2022;Липецкая область;45_75_days;EpiVacCorona;1534;847;2381;621641;290878;912519
2022.03_13-10-2022;Липецкая область;45_75_days;SputnikLite;9232;3759;12991;621641;290878;912519
2022.03_13-10-2022;Липецкая область;45_75_days;SputnikV;9871;4202;14073;621641;290878;912519
2022.03_13-10-2022;Липецкая область;75_90_days;AllVaccines;13619;6227;19846;621641;290878;912519
2022.03_13-10-2022;Липецкая область;75_90_days;CoviVac;64;6;70;621641;290878;912519
2022.03_13-10-2022;Липецкая область;75_90_days;EpiVacCorona;771;320;1091;621641;290878;912519
2022.03_13-10-2022;Липецкая область;75_90_days;SputnikLite;10952;5371;16323;621641;290878;912519
2022.03_13-10-2022;Липецкая область;75_90_days;SputnikV;1832;530;2362;621641;290878;912519
2022.03_13-10-2022;Липецкая область;90_105_days;AllVaccines;10136;5261;15397;621641;290878;912519
2022.03_13-10-2022;Липецкая область;90_105_days;CoviVac;91;13;104;621641;290878;912519
2022.03_13-10-2022;Липецкая область;90_105_days;EpiVacCorona;1565;537;2102;621641;290878;912519
2022.03_13-10-2022;Липецкая область;90_105_days;SputnikLite;3615;3181;6796;621641;290878;912519
2022.03_13-10-2022;Липецкая область;90_105_days;SputnikV;4865;1530;6395;621641;290878;912519
2022.03_13-10-2022;Магаданская область;105_165_days;AllVaccines;15272;4569;19841;83196;26810;110006
2022.03_13-10-2022;Магаданская область;105_165_days;CoviVac;247;55;302;83196;26810;110006
2022.03_13-10-2022;Магаданская область;105_165_days;EpiVacCorona;1432;183;1615;83196;26810;110006
2022.03_13-10-2022;Магаданская область;105_165_days;SputnikLite;7759;3043;10802;83196;26810;110006
2022.03_13-10-2022;Магаданская область;105_165_days;SputnikV;5834;1288;7122;83196;26810;110006
2022.03_13-10-2022;Магаданская область;165_195_days;AllVaccines;5037;1459;6496;83196;26810;110006
2022.03_13-10-2022;Магаданская область;165_195_days;CoviVac;67;19;86;83196;26810;110006
2022.03_13-10-2022;Магаданская область;165_195_days;EpiVacCorona;0;1;1;83196;26810;110006
2022.03_13-10-2022;Магаданская область;165_195_days;SputnikLite;4107;1207;5314;83196;26810;110006
2022.03_13-10-2022;Магаданская область;165_195_days;SputnikV;863;232;1095;83196;26810;110006
2022.03_13-10-2022;Магаданская область;21_45_days;AllVaccines;1638;506;2144;83196;26810;110006
2022.03_13-10-2022;Магаданская область;21_45_days;CoviVac;11;4;15;83196;26810;110006
2022.03_13-10-2022;Магаданская область;21_45_days;EpiVacCorona;71;16;87;83196;26810;110006
2022.03_13-10-2022;Магаданская область;21_45_days;SputnikLite;921;312;1233;83196;26810;110006
2022.03_13-10-2022;Магаданская область;21_45_days;SputnikV;635;174;809;83196;26810;110006
2022.03_13-10-2022;Магаданская область;45_75_days;AllVaccines;4479;1132;5611;83196;26810;110006
2022.03_13-10-2022;Магаданская область;45_75_days;CoviVac;155;19;174;83196;26810;110006
2022.03_13-10-2022;Магаданская область;45_75_days;EpiVacCorona;239;65;304;83196;26810;110006
2022.03_13-10-2022;Магаданская область;45_75_days;SputnikLite;2652;629;3281;83196;26810;110006
2022.03_13-10-2022;Магаданская область;45_75_days;SputnikV;1433;419;1852;83196;26810;110006
2022.03_13-10-2022;Магаданская область;75_90_days;AllVaccines;2973;842;3815;83196;26810;110006
2022.03_13-10-2022;Магаданская область;75_90_days;CoviVac;57;17;74;83196;26810;110006
2022.03_13-10-2022;Магаданская область;75_90_days;EpiVacCorona;119;28;147;83196;26810;110006
2022.03_13-10-2022;Магаданская область;75_90_days;SputnikLite;2394;713;3107;83196;26810;110006
2022.03_13-10-2022;Магаданская область;75_90_days;SputnikV;403;84;487;83196;26810;110006
2022.03_13-10-2022;Магаданская область;90_105_days;AllVaccines;1910;603;2513;83196;26810;110006
2022.03_13-10-2022;Магаданская область;90_105_days;CoviVac;58;9;67;83196;26810;110006
2022.03_13-10-2022;Магаданская область;90_105_days;EpiVacCorona;151;29;180;83196;26810;110006
2022.03_13-10-2022;Магаданская область;90_105_days;SputnikLite;1004;416;1420;83196;26810;110006
2022.03_13-10-2022;Магаданская область;90_105_days;SputnikV;697;149;846;83196;26810;110006
2022.03_13-10-2022;Московская область;105_165_days;AllVaccines;607810;306422;914232;4485323;1674471;6159794
2022.03_13-10-2022;Московская область;105_165_days;CoviVac;7668;3139;10807;4485323;1674471;6159794
2022.03_13-10-2022;Московская область;105_165_days;EpiVacCorona;10093;8276;18369;4485323;1674471;6159794
2022.03_13-10-2022;Московская область;105_165_days;SputnikLite;130143;114715;244858;4485323;1674471;6159794
2022.03_13-10-2022;Московская область;105_165_days;SputnikV;459906;180292;640198;4485323;1674471;6159794
2022.03_13-10-2022;Московская область;165_195_days;AllVaccines;172436;96671;269107;4485323;1674471;6159794
2022.03_13-10-2022;Московская область;165_195_days;CoviVac;2689;1026;3715;4485323;1674471;6159794
2022.03_13-10-2022;Московская область;165_195_days;EpiVacCorona;1259;911;2170;4485323;1674471;6159794
2022.03_13-10-2022;Московская область;165_195_days;SputnikLite;65505;64752;130257;4485323;1674471;6159794
2022.03_13-10-2022;Московская область;165_195_days;SputnikV;102983;29982;132965;4485323;1674471;6159794
2022.03_13-10-2022;Московская область;21_45_days;AllVaccines;64829;26475;91304;4485323;1674471;6159794
2022.03_13-10-2022;Московская область;21_45_days;CoviVac;616;175;791;4485323;1674471;6159794
2022.03_13-10-2022;Московская область;21_45_days;EpiVacCorona;1414;1087;2501;4485323;1674471;6159794
2022.03_13-10-2022;Московская область;21_45_days;SputnikLite;22476;13329;35805;4485323;1674471;6159794
2022.03_13-10-2022;Московская область;21_45_days;SputnikV;40323;11884;52207;4485323;1674471;6159794
2022.03_13-10-2022;Московская область;45_75_days;AllVaccines;163567;61065;224632;4485323;1674471;6159794
2022.03_13-10-2022;Московская область;45_75_days;CoviVac;1887;551;2438;4485323;1674471;6159794
2022.03_13-10-2022;Московская область;45_75_days;EpiVacCorona;2774;1505;4279;4485323;1674471;6159794
2022.03_13-10-2022;Московская область;45_75_days;SputnikLite;71745;31484;103229;4485323;1674471;6159794
2022.03_13-10-2022;Московская область;45_75_days;SputnikV;87161;27525;114686;4485323;1674471;6159794
2022.03_13-10-2022;Московская область;75_90_days;AllVaccines;99207;42411;141618;4485323;1674471;6159794
2022.03_13-10-2022;Московская область;75_90_days;CoviVac;468;188;656;4485323;1674471;6159794
2022.03_13-10-2022;Московская область;75_90_days;EpiVacCorona;740;510;1250;4485323;1674471;6159794
2022.03_13-10-2022;Московская область;75_90_days;SputnikLite;73801;34840;108641;4485323;1674471;6159794
2022.03_13-10-2022;Московская область;75_90_days;SputnikV;24198;6873;31071;4485323;1674471;6159794
2022.03_13-10-2022;Московская область;90_105_days;AllVaccines;66976;33599;100575;4485323;1674471;6159794
2022.03_13-10-2022;Московская область;90_105_days;CoviVac;388;151;539;4485323;1674471;6159794
2022.03_13-10-2022;Московская область;90_105_days;EpiVacCorona;918;852;1770;4485323;1674471;6159794
2022.03_13-10-2022;Московская область;90_105_days;SputnikLite;26031;18714;44745;4485323;1674471;6159794
2022.03_13-10-2022;Московская область;90_105_days;SputnikV;39639;13882;53521;4485323;1674471;6159794
2022.03_13-10-2022;Мурманская область;105_165_days;AllVaccines;84599;28911;113510;436555;144366;580921
2022.03_13-10-2022;Мурманская область;105_165_days;CoviVac;1421;172;1593;436555;144366;580921
2022.03_13-10-2022;Мурманская область;105_165_days;EpiVacCorona;3008;1108;4116;436555;144366;580921
2022.03_13-10-2022;Мурманская область;105_165_days;SputnikLite;42212;15946;58158;436555;144366;580921
2022.03_13-10-2022;Мурманская область;105_165_days;SputnikV;37958;11685;49643;436555;144366;580921
2022.03_13-10-2022;Мурманская область;165_195_days;AllVaccines;23173;8044;31217;436555;144366;580921
2022.03_13-10-2022;Мурманская область;165_195_days;CoviVac;62;9;71;436555;144366;580921
2022.03_13-10-2022;Мурманская область;165_195_days;EpiVacCorona;144;56;200;436555;144366;580921
2022.03_13-10-2022;Мурманская область;165_195_days;SputnikLite;13182;5811;18993;436555;144366;580921
2022.03_13-10-2022;Мурманская область;165_195_days;SputnikV;9785;2168;11953;436555;144366;580921
2022.03_13-10-2022;Мурманская область;21_45_days;AllVaccines;6867;2649;9516;436555;144366;580921
2022.03_13-10-2022;Мурманская область;21_45_days;CoviVac;139;26;165;436555;144366;580921
2022.03_13-10-2022;Мурманская область;21_45_days;EpiVacCorona;38;15;53;436555;144366;580921
2022.03_13-10-2022;Мурманская область;21_45_days;SputnikLite;3520;1635;5155;436555;144366;580921
2022.03_13-10-2022;Мурманская область;21_45_days;SputnikV;3170;973;4143;436555;144366;580921
2022.03_13-10-2022;Мурманская область;45_75_days;AllVaccines;15412;5969;21381;436555;144366;580921
2022.03_13-10-2022;Мурманская область;45_75_days;CoviVac;300;40;340;436555;144366;580921
2022.03_13-10-2022;Мурманская область;45_75_days;EpiVacCorona;145;74;219;436555;144366;580921
2022.03_13-10-2022;Мурманская область;45_75_days;SputnikLite;9045;3501;12546;436555;144366;580921
2022.03_13-10-2022;Мурманская область;45_75_days;SputnikV;5922;2354;8276;436555;144366;580921
2022.03_13-10-2022;Мурманская область;75_90_days;AllVaccines;10297;3729;14026;436555;144366;580921
2022.03_13-10-2022;Мурманская область;75_90_days;CoviVac;67;15;82;436555;144366;580921
2022.03_13-10-2022;Мурманская область;75_90_days;EpiVacCorona;95;35;130;436555;144366;580921
2022.03_13-10-2022;Мурманская область;75_90_days;SputnikLite;7700;3186;10886;436555;144366;580921
2022.03_13-10-2022;Мурманская область;75_90_days;SputnikV;2435;493;2928;436555;144366;580921
2022.03_13-10-2022;Мурманская область;90_105_days;AllVaccines;8526;3308;11834;436555;144366;580921
2022.03_13-10-2022;Мурманская область;90_105_days;CoviVac;159;24;183;436555;144366;580921
2022.03_13-10-2022;Мурманская область;90_105_days;EpiVacCorona;372;152;524;436555;144366;580921
2022.03_13-10-2022;Мурманская область;90_105_days;SputnikLite;3329;1786;5115;436555;144366;580921
2022.03_13-10-2022;Мурманская область;90_105_days;SputnikV;4666;1346;6012;436555;144366;580921
2022.03_13-10-2022;Ненецкий автономный округ;105_165_days;AllVaccines;4396;1450;5846;24931;7449;32380
2022.03_13-10-2022;Ненецкий автономный округ;105_165_days;CoviVac;3;0;3;24931;7449;32380
2022.03_13-10-2022;Ненецкий автономный округ;105_165_days;EpiVacCorona;135;17;152;24931;7449;32380
2022.03_13-10-2022;Ненецкий автономный округ;105_165_days;SputnikLite;3442;1275;4717;24931;7449;32380
2022.03_13-10-2022;Ненецкий автономный округ;105_165_days;SputnikV;816;158;974;24931;7449;32380
2022.03_13-10-2022;Ненецкий автономный округ;165_195_days;AllVaccines;1250;564;1814;24931;7449;32380
2022.03_13-10-2022;Ненецкий автономный округ;165_195_days;CoviVac;62;1;63;24931;7449;32380
2022.03_13-10-2022;Ненецкий автономный округ;165_195_days;EpiVacCorona;14;8;22;24931;7449;32380
2022.03_13-10-2022;Ненецкий автономный округ;165_195_days;SputnikLite;1120;543;1663;24931;7449;32380
2022.03_13-10-2022;Ненецкий автономный округ;165_195_days;SputnikV;54;12;66;24931;7449;32380
2022.03_13-10-2022;Ненецкий автономный округ;21_45_days;AllVaccines;223;121;344;24931;7449;32380
2022.03_13-10-2022;Ненецкий автономный округ;21_45_days;EpiVacCorona;1;0;1;24931;7449;32380
2022.03_13-10-2022;Ненецкий автономный округ;21_45_days;SputnikLite;172;96;268;24931;7449;32380
2022.03_13-10-2022;Ненецкий автономный округ;21_45_days;SputnikV;50;25;75;24931;7449;32380
2022.03_13-10-2022;Ненецкий автономный округ;45_75_days;AllVaccines;504;241;745;24931;7449;32380
2022.03_13-10-2022;Ненецкий автономный округ;45_75_days;EpiVacCorona;1;0;1;24931;7449;32380
2022.03_13-10-2022;Ненецкий автономный округ;45_75_days;SputnikLite;363;205;568;24931;7449;32380
2022.03_13-10-2022;Ненецкий автономный округ;45_75_days;SputnikV;140;36;176;24931;7449;32380
2022.03_13-10-2022;Ненецкий автономный округ;75_90_days;AllVaccines;603;227;830;24931;7449;32380
2022.03_13-10-2022;Ненецкий автономный округ;75_90_days;EpiVacCorona;4;1;5;24931;7449;32380
2022.03_13-10-2022;Ненецкий автономный округ;75_90_days;SputnikLite;553;219;772;24931;7449;32380
2022.03_13-10-2022;Ненецкий автономный округ;75_90_days;SputnikV;46;7;53;24931;7449;32380
2022.03_13-10-2022;Ненецкий автономный округ;90_105_days;AllVaccines;351;89;440;24931;7449;32380
2022.03_13-10-2022;Ненецкий автономный округ;90_105_days;EpiVacCorona;9;1;10;24931;7449;32380
2022.03_13-10-2022;Ненецкий автономный округ;90_105_days;SputnikLite;273;83;356;24931;7449;32380
2022.03_13-10-2022;Ненецкий автономный округ;90_105_days;SputnikV;69;5;74;24931;7449;32380
2022.03_13-10-2022;Нижегородская область;105_165_days;AllVaccines;312950;179358;492308;1769909;800663;2570572
2022.03_13-10-2022;Нижегородская область;105_165_days;CoviVac;1429;285;1714;1769909;800663;2570572
2022.03_13-10-2022;Нижегородская область;105_165_days;EpiVacCorona;6962;4589;11551;1769909;800663;2570572
2022.03_13-10-2022;Нижегородская область;105_165_days;SputnikLite;88952;75967;164919;1769909;800663;2570572
2022.03_13-10-2022;Нижегородская область;105_165_days;SputnikV;215607;98517;314124;1769909;800663;2570572
2022.03_13-10-2022;Нижегородская область;165_195_days;AllVaccines;117427;50623;168050;1769909;800663;2570572
2022.03_13-10-2022;Нижегородская область;165_195_days;CoviVac;1274;271;1545;1769909;800663;2570572
2022.03_13-10-2022;Нижегородская область;165_195_days;EpiVacCorona;565;406;971;1769909;800663;2570572
2022.03_13-10-2022;Нижегородская область;165_195_days;SputnikLite;90859;37532;128391;1769909;800663;2570572
2022.03_13-10-2022;Нижегородская область;165_195_days;SputnikV;24729;12414;37143;1769909;800663;2570572
2022.03_13-10-2022;Нижегородская область;21_45_days;AllVaccines;14335;7005;21340;1769909;800663;2570572
2022.03_13-10-2022;Нижегородская область;21_45_days;CoviVac;414;102;516;1769909;800663;2570572
2022.03_13-10-2022;Нижегородская область;21_45_days;EpiVacCorona;1174;743;1917;1769909;800663;2570572
2022.03_13-10-2022;Нижегородская область;21_45_days;SputnikLite;2561;1674;4235;1769909;800663;2570572
2022.03_13-10-2022;Нижегородская область;21_45_days;SputnikV;10186;4486;14672;1769909;800663;2570572
2022.03_13-10-2022;Нижегородская область;45_75_days;AllVaccines;44265;20092;64357;1769909;800663;2570572
2022.03_13-10-2022;Нижегородская область;45_75_days;CoviVac;811;229;1040;1769909;800663;2570572
2022.03_13-10-2022;Нижегородская область;45_75_days;EpiVacCorona;1274;898;2172;1769909;800663;2570572
2022.03_13-10-2022;Нижегородская область;45_75_days;SputnikLite;23546;9710;33256;1769909;800663;2570572
2022.03_13-10-2022;Нижегородская область;45_75_days;SputnikV;18634;9255;27889;1769909;800663;2570572
2022.03_13-10-2022;Нижегородская область;75_90_days;AllVaccines;36091;18803;54894;1769909;800663;2570572
2022.03_13-10-2022;Нижегородская область;75_90_days;CoviVac;301;140;441;1769909;800663;2570572
2022.03_13-10-2022;Нижегородская область;75_90_days;EpiVacCorona;672;528;1200;1769909;800663;2570572
2022.03_13-10-2022;Нижегородская область;75_90_days;SputnikLite;29338;15792;45130;1769909;800663;2570572
2022.03_13-10-2022;Нижегородская область;75_90_days;SputnikV;5780;2343;8123;1769909;800663;2570572
2022.03_13-10-2022;Нижегородская область;90_105_days;AllVaccines;24580;17765;42345;1769909;800663;2570572
2022.03_13-10-2022;Нижегородская область;90_105_days;CoviVac;267;75;342;1769909;800663;2570572
2022.03_13-10-2022;Нижегородская область;90_105_days;EpiVacCorona;1435;1250;2685;1769909;800663;2570572
2022.03_13-10-2022;Нижегородская область;90_105_days;SputnikLite;11441;9564;21005;1769909;800663;2570572
2022.03_13-10-2022;Нижегородская область;90_105_days;SputnikV;11437;6876;18313;1769909;800663;2570572
2022.03_13-10-2022;Новгородская область;105_165_days;AllVaccines;48159;30406;78565;317276;158308;475584
2022.03_13-10-2022;Новгородская область;105_165_days;CoviVac;1254;415;1669;317276;158308;475584
2022.03_13-10-2022;Новгородская область;105_165_days;EpiVacCorona;2903;1486;4389;317276;158308;475584
2022.03_13-10-2022;Новгородская область;105_165_days;SputnikLite;16923;13898;30821;317276;158308;475584
2022.03_13-10-2022;Новгородская область;105_165_days;SputnikV;27079;14607;41686;317276;158308;475584
2022.03_13-10-2022;Новгородская область;165_195_days;AllVaccines;21949;9687;31636;317276;158308;475584
2022.03_13-10-2022;Новгородская область;165_195_days;CoviVac;34;5;39;317276;158308;475584
2022.03_13-10-2022;Новгородская область;165_195_days;EpiVacCorona;64;55;119;317276;158308;475584
2022.03_13-10-2022;Новгородская область;165_195_days;SputnikLite;19982;8327;28309;317276;158308;475584
2022.03_13-10-2022;Новгородская область;165_195_days;SputnikV;1869;1300;3169;317276;158308;475584
2022.03_13-10-2022;Новгородская область;21_45_days;AllVaccines;2571;2009;4580;317276;158308;475584
2022.03_13-10-2022;Новгородская область;21_45_days;CoviVac;126;46;172;317276;158308;475584
2022.03_13-10-2022;Новгородская область;21_45_days;EpiVacCorona;154;151;305;317276;158308;475584
2022.03_13-10-2022;Новгородская область;21_45_days;SputnikLite;405;475;880;317276;158308;475584
2022.03_13-10-2022;Новгородская область;21_45_days;SputnikV;1886;1337;3223;317276;158308;475584
2022.03_13-10-2022;Новгородская область;45_75_days;AllVaccines;7424;5326;12750;317276;158308;475584
2022.03_13-10-2022;Новгородская область;45_75_days;CoviVac;320;143;463;317276;158308;475584
2022.03_13-10-2022;Новгородская область;45_75_days;EpiVacCorona;549;447;996;317276;158308;475584
2022.03_13-10-2022;Новгородская область;45_75_days;SputnikLite;2466;1651;4117;317276;158308;475584
2022.03_13-10-2022;Новгородская область;45_75_days;SputnikV;4089;3085;7174;317276;158308;475584
2022.03_13-10-2022;Новгородская область;75_90_days;AllVaccines;4781;3464;8245;317276;158308;475584
2022.03_13-10-2022;Новгородская область;75_90_days;CoviVac;131;60;191;317276;158308;475584
2022.03_13-10-2022;Новгородская область;75_90_days;EpiVacCorona;242;132;374;317276;158308;475584
2022.03_13-10-2022;Новгородская область;75_90_days;SputnikLite;3373;2550;5923;317276;158308;475584
2022.03_13-10-2022;Новгородская область;75_90_days;SputnikV;1035;722;1757;317276;158308;475584
2022.03_13-10-2022;Новгородская область;90_105_days;AllVaccines;4579;3468;8047;317276;158308;475584
2022.03_13-10-2022;Новгородская область;90_105_days;CoviVac;163;66;229;317276;158308;475584
2022.03_13-10-2022;Новгородская область;90_105_days;EpiVacCorona;470;270;740;317276;158308;475584
2022.03_13-10-2022;Новгородская область;90_105_days;SputnikLite;1664;1523;3187;317276;158308;475584
2022.03_13-10-2022;Новгородская область;90_105_days;SputnikV;2282;1609;3891;317276;158308;475584
2022.03_13-10-2022;Новосибирская область;105_165_days;AllVaccines;353783;139559;493342;1571829;624100;2195929
2022.03_13-10-2022;Новосибирская область;105_165_days;CoviVac;1641;253;1894;1571829;624100;2195929
2022.03_13-10-2022;Новосибирская область;105_165_days;EpiVacCorona;9718;3409;13127;1571829;624100;2195929
2022.03_13-10-2022;Новосибирская область;105_165_days;SputnikLite;73889;56343;130232;1571829;624100;2195929
2022.03_13-10-2022;Новосибирская область;105_165_days;SputnikV;268535;79554;348089;1571829;624100;2195929
2022.03_13-10-2022;Новосибирская область;165_195_days;AllVaccines;76550;33576;110126;1571829;624100;2195929
2022.03_13-10-2022;Новосибирская область;165_195_days;CoviVac;1321;319;1640;1571829;624100;2195929
2022.03_13-10-2022;Новосибирская область;165_195_days;EpiVacCorona;626;398;1024;1571829;624100;2195929
2022.03_13-10-2022;Новосибирская область;165_195_days;SputnikLite;56521;23834;80355;1571829;624100;2195929
2022.03_13-10-2022;Новосибирская область;165_195_days;SputnikV;18082;9025;27107;1571829;624100;2195929
2022.03_13-10-2022;Новосибирская область;21_45_days;AllVaccines;12299;6231;18530;1571829;624100;2195929
2022.03_13-10-2022;Новосибирская область;21_45_days;CoviVac;443;85;528;1571829;624100;2195929
2022.03_13-10-2022;Новосибирская область;21_45_days;EpiVacCorona;489;238;727;1571829;624100;2195929
2022.03_13-10-2022;Новосибирская область;21_45_days;SputnikLite;869;578;1447;1571829;624100;2195929
2022.03_13-10-2022;Новосибирская область;21_45_days;SputnikV;10498;5330;15828;1571829;624100;2195929
2022.03_13-10-2022;Новосибирская область;45_75_days;AllVaccines;57213;28185;85398;1571829;624100;2195929
2022.03_13-10-2022;Новосибирская область;45_75_days;CoviVac;1092;243;1335;1571829;624100;2195929
2022.03_13-10-2022;Новосибирская область;45_75_days;EpiVacCorona;1399;952;2351;1571829;624100;2195929
2022.03_13-10-2022;Новосибирская область;45_75_days;SputnikLite;28294;13682;41976;1571829;624100;2195929
2022.03_13-10-2022;Новосибирская область;45_75_days;SputnikV;26428;13308;39736;1571829;624100;2195929
2022.03_13-10-2022;Новосибирская область;75_90_days;AllVaccines;41236;22303;63539;1571829;624100;2195929
2022.03_13-10-2022;Новосибирская область;75_90_days;CoviVac;413;118;531;1571829;624100;2195929
2022.03_13-10-2022;Новосибирская область;75_90_days;EpiVacCorona;568;374;942;1571829;624100;2195929
2022.03_13-10-2022;Новосибирская область;75_90_days;SputnikLite;30531;19003;49534;1571829;624100;2195929
2022.03_13-10-2022;Новосибирская область;75_90_days;SputnikV;9724;2808;12532;1571829;624100;2195929
2022.03_13-10-2022;Новосибирская область;90_105_days;AllVaccines;34307;19831;54138;1571829;624100;2195929
2022.03_13-10-2022;Новосибирская область;90_105_days;CoviVac;428;114;542;1571829;624100;2195929
2022.03_13-10-2022;Новосибирская область;90_105_days;EpiVacCorona;966;609;1575;1571829;624100;2195929
2022.03_13-10-2022;Новосибирская область;90_105_days;SputnikLite;14419;12317;26736;1571829;624100;2195929
2022.03_13-10-2022;Новосибирская область;90_105_days;SputnikV;18494;6791;25285;1571829;624100;2195929
2022.03_13-10-2022;Омская область;105_165_days;AllVaccines;220393;92549;312942;1058291;431046;1489337
2022.03_13-10-2022;Омская область;105_165_days;CoviVac;1678;401;2079;1058291;431046;1489337
2022.03_13-10-2022;Омская область;105_165_days;EpiVacCorona;6399;2188;8587;1058291;431046;1489337
2022.03_13-10-2022;Омская область;105_165_days;SputnikLite;46354;29559;75913;1058291;431046;1489337
2022.03_13-10-2022;Омская область;105_165_days;SputnikV;165962;60401;226363;1058291;431046;1489337
2022.03_13-10-2022;Омская область;165_195_days;AllVaccines;38707;18876;57583;1058291;431046;1489337
2022.03_13-10-2022;Омская область;165_195_days;CoviVac;410;126;536;1058291;431046;1489337
2022.03_13-10-2022;Омская область;165_195_days;EpiVacCorona;433;294;727;1058291;431046;1489337
2022.03_13-10-2022;Омская область;165_195_days;SputnikLite;23454;13014;36468;1058291;431046;1489337
2022.03_13-10-2022;Омская область;165_195_days;SputnikV;14410;5442;19852;1058291;431046;1489337
2022.03_13-10-2022;Омская область;21_45_days;AllVaccines;17416;6384;23800;1058291;431046;1489337
2022.03_13-10-2022;Омская область;21_45_days;CoviVac;299;65;364;1058291;431046;1489337
2022.03_13-10-2022;Омская область;21_45_days;EpiVacCorona;912;352;1264;1058291;431046;1489337
2022.03_13-10-2022;Омская область;21_45_days;SputnikLite;5337;1867;7204;1058291;431046;1489337
2022.03_13-10-2022;Омская область;21_45_days;SputnikV;10868;4100;14968;1058291;431046;1489337
2022.03_13-10-2022;Омская область;45_75_days;AllVaccines;42238;15815;58053;1058291;431046;1489337
2022.03_13-10-2022;Омская область;45_75_days;CoviVac;544;121;665;1058291;431046;1489337
2022.03_13-10-2022;Омская область;45_75_days;EpiVacCorona;1340;629;1969;1058291;431046;1489337
2022.03_13-10-2022;Омская область;45_75_days;SputnikLite;18312;5664;23976;1058291;431046;1489337
2022.03_13-10-2022;Омская область;45_75_days;SputnikV;22042;9401;31443;1058291;431046;1489337
2022.03_13-10-2022;Омская область;75_90_days;AllVaccines;24418;10498;34916;1058291;431046;1489337
2022.03_13-10-2022;Омская область;75_90_days;CoviVac;195;64;259;1058291;431046;1489337
2022.03_13-10-2022;Омская область;75_90_days;EpiVacCorona;523;191;714;1058291;431046;1489337
2022.03_13-10-2022;Омская область;75_90_days;SputnikLite;17325;8074;25399;1058291;431046;1489337
2022.03_13-10-2022;Омская область;75_90_days;SputnikV;6375;2169;8544;1058291;431046;1489337
2022.03_13-10-2022;Омская область;90_105_days;AllVaccines;22698;11323;34021;1058291;431046;1489337
2022.03_13-10-2022;Омская область;90_105_days;CoviVac;304;80;384;1058291;431046;1489337
2022.03_13-10-2022;Омская область;90_105_days;EpiVacCorona;1101;452;1553;1058291;431046;1489337
2022.03_13-10-2022;Омская область;90_105_days;SputnikLite;7796;5141;12937;1058291;431046;1489337
2022.03_13-10-2022;Омская область;90_105_days;SputnikV;13497;5650;19147;1058291;431046;1489337
2022.03_13-10-2022;Оренбургская область;105_165_days;AllVaccines;206901;102026;308927;1068899;440686;1509585
2022.03_13-10-2022;Оренбургская область;105_165_days;CoviVac;2292;366;2658;1068899;440686;1509585
2022.03_13-10-2022;Оренбургская область;105_165_days;EpiVacCorona;9911;4118;14029;1068899;440686;1509585
2022.03_13-10-2022;Оренбургская область;105_165_days;SputnikLite;53970;48046;102016;1068899;440686;1509585
2022.03_13-10-2022;Оренбургская область;105_165_days;SputnikV;140728;49496;190224;1068899;440686;1509585
2022.03_13-10-2022;Оренбургская область;165_195_days;AllVaccines;41578;25677;67255;1068899;440686;1509585
2022.03_13-10-2022;Оренбургская область;165_195_days;CoviVac;452;80;532;1068899;440686;1509585
2022.03_13-10-2022;Оренбургская область;165_195_days;EpiVacCorona;240;123;363;1068899;440686;1509585
2022.03_13-10-2022;Оренбургская область;165_195_days;SputnikLite;18476;17861;36337;1068899;440686;1509585
2022.03_13-10-2022;Оренбургская область;165_195_days;SputnikV;22410;7613;30023;1068899;440686;1509585
2022.03_13-10-2022;Оренбургская область;21_45_days;AllVaccines;11577;3891;15468;1068899;440686;1509585
2022.03_13-10-2022;Оренбургская область;21_45_days;CoviVac;464;46;510;1068899;440686;1509585
2022.03_13-10-2022;Оренбургская область;21_45_days;EpiVacCorona;634;208;842;1068899;440686;1509585
2022.03_13-10-2022;Оренбургская область;21_45_days;SputnikLite;977;293;1270;1068899;440686;1509585
2022.03_13-10-2022;Оренбургская область;21_45_days;SputnikV;9502;3344;12846;1068899;440686;1509585
2022.03_13-10-2022;Оренбургская область;45_75_days;AllVaccines;61269;20981;82250;1068899;440686;1509585
2022.03_13-10-2022;Оренбургская область;45_75_days;CoviVac;830;65;895;1068899;440686;1509585
2022.03_13-10-2022;Оренбургская область;45_75_days;EpiVacCorona;2026;826;2852;1068899;440686;1509585
2022.03_13-10-2022;Оренбургская область;45_75_days;SputnikLite;38403;12720;51123;1068899;440686;1509585
2022.03_13-10-2022;Оренбургская область;45_75_days;SputnikV;20010;7370;27380;1068899;440686;1509585
2022.03_13-10-2022;Оренбургская область;75_90_days;AllVaccines;38482;12939;51421;1068899;440686;1509585
2022.03_13-10-2022;Оренбургская область;75_90_days;CoviVac;260;39;299;1068899;440686;1509585
2022.03_13-10-2022;Оренбургская область;75_90_days;EpiVacCorona;1343;421;1764;1068899;440686;1509585
2022.03_13-10-2022;Оренбургская область;75_90_days;SputnikLite;32008;11064;43072;1068899;440686;1509585
2022.03_13-10-2022;Оренбургская область;75_90_days;SputnikV;4871;1415;6286;1068899;440686;1509585
2022.03_13-10-2022;Оренбургская область;90_105_days;AllVaccines;19778;9532;29310;1068899;440686;1509585
2022.03_13-10-2022;Оренбургская область;90_105_days;CoviVac;309;37;346;1068899;440686;1509585
2022.03_13-10-2022;Оренбургская область;90_105_days;EpiVacCorona;1245;552;1797;1068899;440686;1509585
2022.03_13-10-2022;Оренбургская область;90_105_days;SputnikLite;10340;5985;16325;1068899;440686;1509585
2022.03_13-10-2022;Оренбургская область;90_105_days;SputnikV;7884;2958;10842;1068899;440686;1509585
2022.03_13-10-2022;Орловская область;105_165_days;AllVaccines;92238;42213;134451;398663;193123;591786
2022.03_13-10-2022;Орловская область;105_165_days;CoviVac;2650;678;3328;398663;193123;591786
2022.03_13-10-2022;Орловская область;105_165_days;EpiVacCorona;1171;576;1747;398663;193123;591786
2022.03_13-10-2022;Орловская область;105_165_days;SputnikLite;21249;17965;39214;398663;193123;591786
2022.03_13-10-2022;Орловская область;105_165_days;SputnikV;67168;22994;90162;398663;193123;591786
2022.03_13-10-2022;Орловская область;165_195_days;AllVaccines;27777;13939;41716;398663;193123;591786
2022.03_13-10-2022;Орловская область;165_195_days;CoviVac;3;0;3;398663;193123;591786
2022.03_13-10-2022;Орловская область;165_195_days;EpiVacCorona;152;63;215;398663;193123;591786
2022.03_13-10-2022;Орловская область;165_195_days;SputnikLite;23461;11441;34902;398663;193123;591786
2022.03_13-10-2022;Орловская область;165_195_days;SputnikV;4161;2435;6596;398663;193123;591786
2022.03_13-10-2022;Орловская область;21_45_days;AllVaccines;3421;1446;4867;398663;193123;591786
2022.03_13-10-2022;Орловская область;21_45_days;CoviVac;133;22;155;398663;193123;591786
2022.03_13-10-2022;Орловская область;21_45_days;EpiVacCorona;344;102;446;398663;193123;591786
2022.03_13-10-2022;Орловская область;21_45_days;SputnikLite;352;166;518;398663;193123;591786
2022.03_13-10-2022;Орловская область;21_45_days;SputnikV;2592;1156;3748;398663;193123;591786
2022.03_13-10-2022;Орловская область;45_75_days;AllVaccines;9963;5072;15035;398663;193123;591786
2022.03_13-10-2022;Орловская область;45_75_days;CoviVac;209;36;245;398663;193123;591786
2022.03_13-10-2022;Орловская область;45_75_days;EpiVacCorona;495;186;681;398663;193123;591786
2022.03_13-10-2022;Орловская область;45_75_days;SputnikLite;5475;2871;8346;398663;193123;591786
2022.03_13-10-2022;Орловская область;45_75_days;SputnikV;3784;1979;5763;398663;193123;591786
2022.03_13-10-2022;Орловская область;75_90_days;AllVaccines;8380;4252;12632;398663;193123;591786
2022.03_13-10-2022;Орловская область;75_90_days;CoviVac;119;23;142;398663;193123;591786
2022.03_13-10-2022;Орловская область;75_90_days;EpiVacCorona;189;92;281;398663;193123;591786
2022.03_13-10-2022;Орловская область;75_90_days;SputnikLite;6546;3517;10063;398663;193123;591786
2022.03_13-10-2022;Орловская область;75_90_days;SputnikV;1526;620;2146;398663;193123;591786
2022.03_13-10-2022;Орловская область;90_105_days;AllVaccines;7188;4780;11968;398663;193123;591786
2022.03_13-10-2022;Орловская область;90_105_days;CoviVac;210;58;268;398663;193123;591786
2022.03_13-10-2022;Орловская область;90_105_days;EpiVacCorona;355;165;520;398663;193123;591786
2022.03_13-10-2022;Орловская область;90_105_days;SputnikLite;3406;2953;6359;398663;193123;591786
2022.03_13-10-2022;Орловская область;90_105_days;SputnikV;3217;1604;4821;398663;193123;591786
2022.03_13-10-2022;Пензенская область;105_165_days;AllVaccines;187700;89742;277442;710438;350687;1061125
2022.03_13-10-2022;Пензенская область;105_165_days;CoviVac;2347;478;2825;710438;350687;1061125
2022.03_13-10-2022;Пензенская область;105_165_days;EpiVacCorona;3569;1659;5228;710438;350687;1061125
2022.03_13-10-2022;Пензенская область;105_165_days;SputnikLite;25189;16098;41287;710438;350687;1061125
2022.03_13-10-2022;Пензенская область;105_165_days;SputnikV;156595;71507;228102;710438;350687;1061125
2022.03_13-10-2022;Пензенская область;165_195_days;AllVaccines;40934;21980;62914;710438;350687;1061125
2022.03_13-10-2022;Пензенская область;165_195_days;CoviVac;132;20;152;710438;350687;1061125
2022.03_13-10-2022;Пензенская область;165_195_days;EpiVacCorona;397;147;544;710438;350687;1061125
2022.03_13-10-2022;Пензенская область;165_195_days;SputnikLite;24592;5913;30505;710438;350687;1061125
2022.03_13-10-2022;Пензенская область;165_195_days;SputnikV;15813;15900;31713;710438;350687;1061125
2022.03_13-10-2022;Пензенская область;21_45_days;AllVaccines;16843;22558;39401;710438;350687;1061125
2022.03_13-10-2022;Пензенская область;21_45_days;CoviVac;483;352;835;710438;350687;1061125
2022.03_13-10-2022;Пензенская область;21_45_days;EpiVacCorona;1536;3673;5209;710438;350687;1061125
2022.03_13-10-2022;Пензенская область;21_45_days;SputnikLite;5050;2865;7915;710438;350687;1061125
2022.03_13-10-2022;Пензенская область;21_45_days;SputnikV;9774;15668;25442;710438;350687;1061125
2022.03_13-10-2022;Пензенская область;45_75_days;AllVaccines;31349;24130;55479;710438;350687;1061125
2022.03_13-10-2022;Пензенская область;45_75_days;CoviVac;462;188;650;710438;350687;1061125
2022.03_13-10-2022;Пензенская область;45_75_days;EpiVacCorona;1525;2165;3690;710438;350687;1061125
2022.03_13-10-2022;Пензенская область;45_75_days;SputnikLite;16079;7565;23644;710438;350687;1061125
2022.03_13-10-2022;Пензенская область;45_75_days;SputnikV;13283;14212;27495;710438;350687;1061125
2022.03_13-10-2022;Пензенская область;75_90_days;AllVaccines;18727;13847;32574;710438;350687;1061125
2022.03_13-10-2022;Пензенская область;75_90_days;CoviVac;120;56;176;710438;350687;1061125
2022.03_13-10-2022;Пензенская область;75_90_days;EpiVacCorona;450;841;1291;710438;350687;1061125
2022.03_13-10-2022;Пензенская область;75_90_days;SputnikLite;14553;7044;21597;710438;350687;1061125
2022.03_13-10-2022;Пензенская область;75_90_days;SputnikV;3604;5906;9510;710438;350687;1061125
2022.03_13-10-2022;Пензенская область;90_105_days;AllVaccines;13233;15434;28667;710438;350687;1061125
2022.03_13-10-2022;Пензенская область;90_105_days;CoviVac;143;79;222;710438;350687;1061125
2022.03_13-10-2022;Пензенская область;90_105_days;EpiVacCorona;602;2585;3187;710438;350687;1061125
2022.03_13-10-2022;Пензенская область;90_105_days;SputnikLite;7083;4683;11766;710438;350687;1061125
2022.03_13-10-2022;Пензенская область;90_105_days;SputnikV;5405;8087;13492;710438;350687;1061125
2022.03_13-10-2022;Пермский край;105_165_days;AllVaccines;269466;123240;392706;1423011;574038;1997049
2022.03_13-10-2022;Пермский край;105_165_days;CoviVac;2580;550;3130;1423011;574038;1997049
2022.03_13-10-2022;Пермский край;105_165_days;EpiVacCorona;3899;1391;5290;1423011;574038;1997049
2022.03_13-10-2022;Пермский край;105_165_days;SputnikLite;52060;48018;100078;1423011;574038;1997049
2022.03_13-10-2022;Пермский край;105_165_days;SputnikV;210927;73281;284208;1423011;574038;1997049
2022.03_13-10-2022;Пермский край;165_195_days;AllVaccines;73077;29409;102486;1423011;574038;1997049
2022.03_13-10-2022;Пермский край;165_195_days;CoviVac;1051;282;1333;1423011;574038;1997049
2022.03_13-10-2022;Пермский край;165_195_days;EpiVacCorona;650;315;965;1423011;574038;1997049
2022.03_13-10-2022;Пермский край;165_195_days;SputnikLite;43772;19699;63471;1423011;574038;1997049
2022.03_13-10-2022;Пермский край;165_195_days;SputnikV;27604;9113;36717;1423011;574038;1997049
2022.03_13-10-2022;Пермский край;21_45_days;AllVaccines;11812;5920;17732;1423011;574038;1997049
2022.03_13-10-2022;Пермский край;21_45_days;CoviVac;306;57;363;1423011;574038;1997049
2022.03_13-10-2022;Пермский край;21_45_days;EpiVacCorona;487;267;754;1423011;574038;1997049
2022.03_13-10-2022;Пермский край;21_45_days;SputnikLite;2864;1390;4254;1423011;574038;1997049
2022.03_13-10-2022;Пермский край;21_45_days;SputnikV;8155;4206;12361;1423011;574038;1997049
2022.03_13-10-2022;Пермский край;45_75_days;AllVaccines;38121;19485;57606;1423011;574038;1997049
2022.03_13-10-2022;Пермский край;45_75_days;CoviVac;743;140;883;1423011;574038;1997049
2022.03_13-10-2022;Пермский край;45_75_days;EpiVacCorona;834;503;1337;1423011;574038;1997049
2022.03_13-10-2022;Пермский край;45_75_days;SputnikLite;18867;10041;28908;1423011;574038;1997049
2022.03_13-10-2022;Пермский край;45_75_days;SputnikV;17677;8801;26478;1423011;574038;1997049
2022.03_13-10-2022;Пермский край;75_90_days;AllVaccines;31491;16962;48453;1423011;574038;1997049
2022.03_13-10-2022;Пермский край;75_90_days;CoviVac;407;87;494;1423011;574038;1997049
2022.03_13-10-2022;Пермский край;75_90_days;EpiVacCorona;362;142;504;1423011;574038;1997049
2022.03_13-10-2022;Пермский край;75_90_days;SputnikLite;23974;14724;38698;1423011;574038;1997049
2022.03_13-10-2022;Пермский край;75_90_days;SputnikV;6748;2009;8757;1423011;574038;1997049
2022.03_13-10-2022;Пермский край;90_105_days;AllVaccines;21970;12184;34154;1423011;574038;1997049
2022.03_13-10-2022;Пермский край;90_105_days;CoviVac;513;105;618;1423011;574038;1997049
2022.03_13-10-2022;Пермский край;90_105_days;EpiVacCorona;579;227;806;1423011;574038;1997049
2022.03_13-10-2022;Пермский край;90_105_days;SputnikLite;8611;7304;15915;1423011;574038;1997049
2022.03_13-10-2022;Пермский край;90_105_days;SputnikV;12267;4548;16815;1423011;574038;1997049
2022.03_13-10-2022;Приморский край;105_165_days;AllVaccines;317139;86612;403751;1086430;416518;1502948
2022.03_13-10-2022;Приморский край;105_165_days;CoviVac;4310;381;4691;1086430;416518;1502948
2022.03_13-10-2022;Приморский край;105_165_days;EpiVacCorona;4041;1615;5656;1086430;416518;1502948
2022.03_13-10-2022;Приморский край;105_165_days;SputnikLite;51230;32794;84024;1086430;416518;1502948
2022.03_13-10-2022;Приморский край;105_165_days;SputnikV;257558;51822;309380;1086430;416518;1502948
2022.03_13-10-2022;Приморский край;165_195_days;AllVaccines;37629;16258;53887;1086430;416518;1502948
2022.03_13-10-2022;Приморский край;165_195_days;CoviVac;731;95;826;1086430;416518;1502948
2022.03_13-10-2022;Приморский край;165_195_days;EpiVacCorona;749;328;1077;1086430;416518;1502948
2022.03_13-10-2022;Приморский край;165_195_days;SputnikLite;22827;11549;34376;1086430;416518;1502948
2022.03_13-10-2022;Приморский край;165_195_days;SputnikV;13322;4286;17608;1086430;416518;1502948
2022.03_13-10-2022;Приморский край;21_45_days;AllVaccines;14087;5763;19850;1086430;416518;1502948
2022.03_13-10-2022;Приморский край;21_45_days;CoviVac;255;17;272;1086430;416518;1502948
2022.03_13-10-2022;Приморский край;21_45_days;EpiVacCorona;1179;642;1821;1086430;416518;1502948
2022.03_13-10-2022;Приморский край;21_45_days;SputnikLite;7602;3606;11208;1086430;416518;1502948
2022.03_13-10-2022;Приморский край;21_45_days;SputnikV;5051;1498;6549;1086430;416518;1502948
2022.03_13-10-2022;Приморский край;45_75_days;AllVaccines;34041;14939;48980;1086430;416518;1502948
2022.03_13-10-2022;Приморский край;45_75_days;CoviVac;312;37;349;1086430;416518;1502948
2022.03_13-10-2022;Приморский край;45_75_days;EpiVacCorona;1845;829;2674;1086430;416518;1502948
2022.03_13-10-2022;Приморский край;45_75_days;SputnikLite;19179;9720;28899;1086430;416518;1502948
2022.03_13-10-2022;Приморский край;45_75_days;SputnikV;12705;4353;17058;1086430;416518;1502948
2022.03_13-10-2022;Приморский край;75_90_days;AllVaccines;24284;14089;38373;1086430;416518;1502948
2022.03_13-10-2022;Приморский край;75_90_days;CoviVac;131;17;148;1086430;416518;1502948
2022.03_13-10-2022;Приморский край;75_90_days;EpiVacCorona;486;255;741;1086430;416518;1502948
2022.03_13-10-2022;Приморский край;75_90_days;SputnikLite;17031;12006;29037;1086430;416518;1502948
2022.03_13-10-2022;Приморский край;75_90_days;SputnikV;6636;1811;8447;1086430;416518;1502948
2022.03_13-10-2022;Приморский край;90_105_days;AllVaccines;19164;9655;28819;1086430;416518;1502948
2022.03_13-10-2022;Приморский край;90_105_days;CoviVac;171;17;188;1086430;416518;1502948
2022.03_13-10-2022;Приморский край;90_105_days;EpiVacCorona;641;375;1016;1086430;416518;1502948
2022.03_13-10-2022;Приморский край;90_105_days;SputnikLite;5994;5231;11225;1086430;416518;1502948
2022.03_13-10-2022;Приморский край;90_105_days;SputnikV;12358;4032;16390;1086430;416518;1502948
2022.03_13-10-2022;Псковская область;105_165_days;AllVaccines;49639;30856;80495;337881;166663;504544
2022.03_13-10-2022;Псковская область;105_165_days;CoviVac;1137;203;1340;337881;166663;504544
2022.03_13-10-2022;Псковская область;105_165_days;EpiVacCorona;1890;869;2759;337881;166663;504544
2022.03_13-10-2022;Псковская область;105_165_days;SputnikLite;15138;15892;31030;337881;166663;504544
2022.03_13-10-2022;Псковская область;105_165_days;SputnikV;31474;13892;45366;337881;166663;504544
2022.03_13-10-2022;Псковская область;165_195_days;AllVaccines;13906;9427;23333;337881;166663;504544
2022.03_13-10-2022;Псковская область;165_195_days;CoviVac;12;3;15;337881;166663;504544
2022.03_13-10-2022;Псковская область;165_195_days;EpiVacCorona;341;138;479;337881;166663;504544
2022.03_13-10-2022;Псковская область;165_195_days;SputnikLite;7935;7052;14987;337881;166663;504544
2022.03_13-10-2022;Псковская область;165_195_days;SputnikV;5618;2234;7852;337881;166663;504544
2022.03_13-10-2022;Псковская область;21_45_days;AllVaccines;3329;1570;4899;337881;166663;504544
2022.03_13-10-2022;Псковская область;21_45_days;CoviVac;96;7;103;337881;166663;504544
2022.03_13-10-2022;Псковская область;21_45_days;EpiVacCorona;208;122;330;337881;166663;504544
2022.03_13-10-2022;Псковская область;21_45_days;SputnikLite;193;129;322;337881;166663;504544
2022.03_13-10-2022;Псковская область;21_45_days;SputnikV;2832;1312;4144;337881;166663;504544
2022.03_13-10-2022;Псковская область;45_75_days;AllVaccines;11413;5885;17298;337881;166663;504544
2022.03_13-10-2022;Псковская область;45_75_days;CoviVac;264;29;293;337881;166663;504544
2022.03_13-10-2022;Псковская область;45_75_days;EpiVacCorona;607;387;994;337881;166663;504544
2022.03_13-10-2022;Псковская область;45_75_days;SputnikLite;3692;1865;5557;337881;166663;504544
2022.03_13-10-2022;Псковская область;45_75_days;SputnikV;6850;3604;10454;337881;166663;504544
2022.03_13-10-2022;Псковская область;75_90_days;AllVaccines;7487;4241;11728;337881;166663;504544
2022.03_13-10-2022;Псковская область;75_90_days;CoviVac;145;16;161;337881;166663;504544
2022.03_13-10-2022;Псковская область;75_90_days;EpiVacCorona;204;105;309;337881;166663;504544
2022.03_13-10-2022;Псковская область;75_90_days;SputnikLite;5243;3486;8729;337881;166663;504544
2022.03_13-10-2022;Псковская область;75_90_days;SputnikV;1895;634;2529;337881;166663;504544
2022.03_13-10-2022;Псковская область;90_105_days;AllVaccines;5511;3037;8548;337881;166663;504544
2022.03_13-10-2022;Псковская область;90_105_days;CoviVac;199;18;217;337881;166663;504544
2022.03_13-10-2022;Псковская область;90_105_days;EpiVacCorona;266;188;454;337881;166663;504544
2022.03_13-10-2022;Псковская область;90_105_days;SputnikLite;1798;1664;3462;337881;166663;504544
2022.03_13-10-2022;Псковская область;90_105_days;SputnikV;3248;1167;4415;337881;166663;504544
2022.03_13-10-2022;РФ;105_165_days;AllVaccines;15409366;6782815;22192181;82332898;33454776;115787674
2022.03_13-10-2022;РФ;105_165_days;CoviVac;203447;43920;247367;82332898;33454776;115787674
2022.03_13-10-2022;РФ;105_165_days;EpiVacCorona;422687;184789;607476;82332898;33454776;115787674
2022.03_13-10-2022;РФ;105_165_days;SputnikLite;4009335;2638287;6647622;82332898;33454776;115787674
2022.03_13-10-2022;РФ;105_165_days;SputnikV;10773897;3915819;14689716;82332898;33454776;115787674
2022.03_13-10-2022;РФ;165_195_days;AllVaccines;3957400;1840834;5798234;82332898;33454776;115787674
2022.03_13-10-2022;РФ;165_195_days;CoviVac;41662;10382;52044;82332898;33454776;115787674
2022.03_13-10-2022;РФ;165_195_days;EpiVacCorona;33101;17193;50294;82332898;33454776;115787674
2022.03_13-10-2022;РФ;165_195_days;SputnikLite;2510079;1234443;3744522;82332898;33454776;115787674
2022.03_13-10-2022;РФ;165_195_days;SputnikV;1372558;578816;1951374;82332898;33454776;115787674
2022.03_13-10-2022;РФ;21_45_days;AllVaccines;1086577;532603;1619180;82332898;33454776;115787674
2022.03_13-10-2022;РФ;21_45_days;CoviVac;25429;7109;32538;82332898;33454776;115787674
2022.03_13-10-2022;РФ;21_45_days;EpiVacCorona;69998;42082;112080;82332898;33454776;115787674
2022.03_13-10-2022;РФ;21_45_days;SputnikLite;277638;129675;407313;82332898;33454776;115787674
2022.03_13-10-2022;РФ;21_45_days;SputnikV;713512;353737;1067249;82332898;33454776;115787674
2022.03_13-10-2022;РФ;45_75_days;AllVaccines;2962990;1282274;4245264;82332898;33454776;115787674
2022.03_13-10-2022;РФ;45_75_days;CoviVac;41799;9889;51688;82332898;33454776;115787674
2022.03_13-10-2022;РФ;45_75_days;EpiVacCorona;122635;68766;191401;82332898;33454776;115787674
2022.03_13-10-2022;РФ;45_75_days;SputnikLite;1347328;526728;1874056;82332898;33454776;115787674
2022.03_13-10-2022;РФ;45_75_days;SputnikV;1451228;676891;2128119;82332898;33454776;115787674
2022.03_13-10-2022;РФ;75_90_days;AllVaccines;1943591;851261;2794852;82332898;33454776;115787674
2022.03_13-10-2022;РФ;75_90_days;CoviVac;15969;4075;20044;82332898;33454776;115787674
2022.03_13-10-2022;РФ;75_90_days;EpiVacCorona;48300;25494;73794;82332898;33454776;115787674
2022.03_13-10-2022;РФ;75_90_days;SputnikLite;1442594;660112;2102706;82332898;33454776;115787674
2022.03_13-10-2022;РФ;75_90_days;SputnikV;436728;161580;598308;82332898;33454776;115787674
2022.03_13-10-2022;РФ;90_105_days;AllVaccines;1447455;738158;2185613;82332898;33454776;115787674
2022.03_13-10-2022;РФ;90_105_days;CoviVac;17720;4345;22065;82332898;33454776;115787674
2022.03_13-10-2022;РФ;90_105_days;EpiVacCorona;58823;33386;92209;82332898;33454776;115787674
2022.03_13-10-2022;РФ;90_105_days;SputnikLite;646375;399236;1045611;82332898;33454776;115787674
2022.03_13-10-2022;РФ;90_105_days;SputnikV;724537;301191;1025728;82332898;33454776;115787674
2022.03_13-10-2022;Республика Адыгея;105_165_days;AllVaccines;34117;16258;50375;256368;104563;360931
2022.03_13-10-2022;Республика Адыгея;105_165_days;CoviVac;508;137;645;256368;104563;360931
2022.03_13-10-2022;Республика Адыгея;105_165_days;EpiVacCorona;933;507;1440;256368;104563;360931
2022.03_13-10-2022;Республика Адыгея;105_165_days;SputnikLite;13773;8132;21905;256368;104563;360931
2022.03_13-10-2022;Республика Адыгея;105_165_days;SputnikV;18903;7482;26385;256368;104563;360931
2022.03_13-10-2022;Республика Адыгея;165_195_days;AllVaccines;17091;6002;23093;256368;104563;360931
2022.03_13-10-2022;Республика Адыгея;165_195_days;CoviVac;25;3;28;256368;104563;360931
2022.03_13-10-2022;Республика Адыгея;165_195_days;EpiVacCorona;64;36;100;256368;104563;360931
2022.03_13-10-2022;Республика Адыгея;165_195_days;SputnikLite;14184;4758;18942;256368;104563;360931
2022.03_13-10-2022;Республика Адыгея;165_195_days;SputnikV;2818;1205;4023;256368;104563;360931
2022.03_13-10-2022;Республика Адыгея;21_45_days;AllVaccines;1931;1321;3252;256368;104563;360931
2022.03_13-10-2022;Республика Адыгея;21_45_days;CoviVac;11;0;11;256368;104563;360931
2022.03_13-10-2022;Республика Адыгея;21_45_days;EpiVacCorona;8;8;16;256368;104563;360931
2022.03_13-10-2022;Республика Адыгея;21_45_days;SputnikLite;1116;821;1937;256368;104563;360931
2022.03_13-10-2022;Республика Адыгея;21_45_days;SputnikV;796;492;1288;256368;104563;360931
2022.03_13-10-2022;Республика Адыгея;45_75_days;AllVaccines;7153;3302;10455;256368;104563;360931
2022.03_13-10-2022;Республика Адыгея;45_75_days;CoviVac;48;13;61;256368;104563;360931
2022.03_13-10-2022;Республика Адыгея;45_75_days;EpiVacCorona;121;61;182;256368;104563;360931
2022.03_13-10-2022;Республика Адыгея;45_75_days;SputnikLite;3852;1526;5378;256368;104563;360931
2022.03_13-10-2022;Республика Адыгея;45_75_days;SputnikV;3132;1702;4834;256368;104563;360931
2022.03_13-10-2022;Республика Адыгея;75_90_days;AllVaccines;5136;2261;7397;256368;104563;360931
2022.03_13-10-2022;Республика Адыгея;75_90_days;CoviVac;26;3;29;256368;104563;360931
2022.03_13-10-2022;Республика Адыгея;75_90_days;EpiVacCorona;199;87;286;256368;104563;360931
2022.03_13-10-2022;Республика Адыгея;75_90_days;SputnikLite;4106;1926;6032;256368;104563;360931
2022.03_13-10-2022;Республика Адыгея;75_90_days;SputnikV;805;245;1050;256368;104563;360931
2022.03_13-10-2022;Республика Адыгея;90_105_days;AllVaccines;3849;2070;5919;256368;104563;360931
2022.03_13-10-2022;Республика Адыгея;90_105_days;CoviVac;32;8;40;256368;104563;360931
2022.03_13-10-2022;Республика Адыгея;90_105_days;EpiVacCorona;177;49;226;256368;104563;360931
2022.03_13-10-2022;Республика Адыгея;90_105_days;SputnikLite;2444;1488;3932;256368;104563;360931
2022.03_13-10-2022;Республика Адыгея;90_105_days;SputnikV;1196;525;1721;256368;104563;360931
2022.03_13-10-2022;Республика Алтай;105_165_days;AllVaccines;21053;8818;29871;117210;36468;153678
2022.03_13-10-2022;Республика Алтай;105_165_days;CoviVac;189;38;227;117210;36468;153678
2022.03_13-10-2022;Республика Алтай;105_165_days;EpiVacCorona;419;138;557;117210;36468;153678
2022.03_13-10-2022;Республика Алтай;105_165_days;SputnikLite;13792;6024;19816;117210;36468;153678
2022.03_13-10-2022;Республика Алтай;105_165_days;SputnikV;6653;2618;9271;117210;36468;153678
2022.03_13-10-2022;Республика Алтай;165_195_days;AllVaccines;4975;2818;7793;117210;36468;153678
2022.03_13-10-2022;Республика Алтай;165_195_days;CoviVac;17;8;25;117210;36468;153678
2022.03_13-10-2022;Республика Алтай;165_195_days;EpiVacCorona;31;28;59;117210;36468;153678
2022.03_13-10-2022;Республика Алтай;165_195_days;SputnikLite;3338;2287;5625;117210;36468;153678
2022.03_13-10-2022;Республика Алтай;165_195_days;SputnikV;1589;495;2084;117210;36468;153678
2022.03_13-10-2022;Республика Алтай;21_45_days;AllVaccines;2090;805;2895;117210;36468;153678
2022.03_13-10-2022;Республика Алтай;21_45_days;CoviVac;108;13;121;117210;36468;153678
2022.03_13-10-2022;Республика Алтай;21_45_days;EpiVacCorona;104;27;131;117210;36468;153678
2022.03_13-10-2022;Республика Алтай;21_45_days;SputnikLite;928;296;1224;117210;36468;153678
2022.03_13-10-2022;Республика Алтай;21_45_days;SputnikV;950;469;1419;117210;36468;153678
2022.03_13-10-2022;Республика Алтай;45_75_days;AllVaccines;5821;1818;7639;117210;36468;153678
2022.03_13-10-2022;Республика Алтай;45_75_days;CoviVac;180;37;217;117210;36468;153678
2022.03_13-10-2022;Республика Алтай;45_75_days;EpiVacCorona;279;70;349;117210;36468;153678
2022.03_13-10-2022;Республика Алтай;45_75_days;SputnikLite;2698;576;3274;117210;36468;153678
2022.03_13-10-2022;Республика Алтай;45_75_days;SputnikV;2664;1135;3799;117210;36468;153678
2022.03_13-10-2022;Республика Алтай;75_90_days;AllVaccines;4292;1242;5534;117210;36468;153678
2022.03_13-10-2022;Республика Алтай;75_90_days;CoviVac;39;14;53;117210;36468;153678
2022.03_13-10-2022;Республика Алтай;75_90_days;EpiVacCorona;80;36;116;117210;36468;153678
2022.03_13-10-2022;Республика Алтай;75_90_days;SputnikLite;3645;1011;4656;117210;36468;153678
2022.03_13-10-2022;Республика Алтай;75_90_days;SputnikV;528;181;709;117210;36468;153678
2022.03_13-10-2022;Республика Алтай;90_105_days;AllVaccines;3478;1210;4688;117210;36468;153678
2022.03_13-10-2022;Республика Алтай;90_105_days;CoviVac;43;9;52;117210;36468;153678
2022.03_13-10-2022;Республика Алтай;90_105_days;EpiVacCorona;128;37;165;117210;36468;153678
2022.03_13-10-2022;Республика Алтай;90_105_days;SputnikLite;2235;852;3087;117210;36468;153678
2022.03_13-10-2022;Республика Алтай;90_105_days;SputnikV;1072;312;1384;117210;36468;153678
2022.03_13-10-2022;Республика Башкортостан;105_165_days;AllVaccines;515159;189258;704417;2235962;869874;3105836
2022.03_13-10-2022;Республика Башкортостан;105_165_days;CoviVac;7526;2001;9527;2235962;869874;3105836
2022.03_13-10-2022;Республика Башкортостан;105_165_days;EpiVacCorona;13128;6347;19475;2235962;869874;3105836
2022.03_13-10-2022;Республика Башкортостан;105_165_days;SputnikLite;83876;46218;130094;2235962;869874;3105836
2022.03_13-10-2022;Республика Башкортостан;105_165_days;SputnikV;410629;134692;545321;2235962;869874;3105836
2022.03_13-10-2022;Республика Башкортостан;165_195_days;AllVaccines;111872;41945;153817;2235962;869874;3105836
2022.03_13-10-2022;Республика Башкортостан;165_195_days;CoviVac;1289;399;1688;2235962;869874;3105836
2022.03_13-10-2022;Республика Башкортостан;165_195_days;EpiVacCorona;1505;724;2229;2235962;869874;3105836
2022.03_13-10-2022;Республика Башкортостан;165_195_days;SputnikLite;45173;17243;62416;2235962;869874;3105836
2022.03_13-10-2022;Республика Башкортостан;165_195_days;SputnikV;63905;23579;87484;2235962;869874;3105836
2022.03_13-10-2022;Республика Башкортостан;21_45_days;AllVaccines;45435;24474;69909;2235962;869874;3105836
2022.03_13-10-2022;Республика Башкортостан;21_45_days;CoviVac;590;221;811;2235962;869874;3105836
2022.03_13-10-2022;Республика Башкортостан;21_45_days;EpiVacCorona;4210;2989;7199;2235962;869874;3105836
2022.03_13-10-2022;Республика Башкортостан;21_45_days;SputnikLite;11959;4149;16108;2235962;869874;3105836
2022.03_13-10-2022;Республика Башкортостан;21_45_days;SputnikV;28676;17115;45791;2235962;869874;3105836
2022.03_13-10-2022;Республика Башкортостан;45_75_days;AllVaccines;85197;41648;126845;2235962;869874;3105836
2022.03_13-10-2022;Республика Башкортостан;45_75_days;CoviVac;620;139;759;2235962;869874;3105836
2022.03_13-10-2022;Республика Башкортостан;45_75_days;EpiVacCorona;3901;2778;6679;2235962;869874;3105836
2022.03_13-10-2022;Республика Башкортостан;45_75_days;SputnikLite;28620;9229;37849;2235962;869874;3105836
2022.03_13-10-2022;Республика Башкортостан;45_75_days;SputnikV;52056;29502;81558;2235962;869874;3105836
2022.03_13-10-2022;Республика Башкортостан;75_90_days;AllVaccines;52444;19993;72437;2235962;869874;3105836
2022.03_13-10-2022;Республика Башкортостан;75_90_days;CoviVac;526;141;667;2235962;869874;3105836
2022.03_13-10-2022;Республика Башкортостан;75_90_days;EpiVacCorona;3184;1848;5032;2235962;869874;3105836
2022.03_13-10-2022;Республика Башкортостан;75_90_days;SputnikLite;33473;12651;46124;2235962;869874;3105836
2022.03_13-10-2022;Республика Башкортостан;75_90_days;SputnikV;15261;5353;20614;2235962;869874;3105836
2022.03_13-10-2022;Республика Башкортостан;90_105_days;AllVaccines;50445;19211;69656;2235962;869874;3105836
2022.03_13-10-2022;Республика Башкортостан;90_105_days;CoviVac;1596;234;1830;2235962;869874;3105836
2022.03_13-10-2022;Республика Башкортостан;90_105_days;EpiVacCorona;2600;1656;4256;2235962;869874;3105836
2022.03_13-10-2022;Республика Башкортостан;90_105_days;SputnikLite;21853;9288;31141;2235962;869874;3105836
2022.03_13-10-2022;Республика Башкортостан;90_105_days;SputnikV;24396;8033;32429;2235962;869874;3105836
2022.03_13-10-2022;Республика Бурятия;105_165_days;AllVaccines;100657;40902;141559;542372;176777;719149
2022.03_13-10-2022;Республика Бурятия;105_165_days;CoviVac;1453;383;1836;542372;176777;719149
2022.03_13-10-2022;Республика Бурятия;105_165_days;EpiVacCorona;1444;826;2270;542372;176777;719149
2022.03_13-10-2022;Республика Бурятия;105_165_days;SputnikLite;31981;17691;49672;542372;176777;719149
2022.03_13-10-2022;Республика Бурятия;105_165_days;SputnikV;65779;22002;87781;542372;176777;719149
2022.03_13-10-2022;Республика Бурятия;165_195_days;AllVaccines;24856;9582;34438;542372;176777;719149
2022.03_13-10-2022;Республика Бурятия;165_195_days;CoviVac;30;10;40;542372;176777;719149
2022.03_13-10-2022;Республика Бурятия;165_195_days;EpiVacCorona;210;74;284;542372;176777;719149
2022.03_13-10-2022;Республика Бурятия;165_195_days;SputnikLite;17519;7190;24709;542372;176777;719149
2022.03_13-10-2022;Республика Бурятия;165_195_days;SputnikV;7097;2308;9405;542372;176777;719149
2022.03_13-10-2022;Республика Бурятия;21_45_days;AllVaccines;11282;4261;15543;542372;176777;719149
2022.03_13-10-2022;Республика Бурятия;21_45_days;CoviVac;149;37;186;542372;176777;719149
2022.03_13-10-2022;Республика Бурятия;21_45_days;EpiVacCorona;775;338;1113;542372;176777;719149
2022.03_13-10-2022;Республика Бурятия;21_45_days;SputnikLite;3021;1130;4151;542372;176777;719149
2022.03_13-10-2022;Республика Бурятия;21_45_days;SputnikV;7337;2756;10093;542372;176777;719149
2022.03_13-10-2022;Республика Бурятия;45_75_days;AllVaccines;29202;11628;40830;542372;176777;719149
2022.03_13-10-2022;Республика Бурятия;45_75_days;CoviVac;244;90;334;542372;176777;719149
2022.03_13-10-2022;Республика Бурятия;45_75_days;EpiVacCorona;965;503;1468;542372;176777;719149
2022.03_13-10-2022;Республика Бурятия;45_75_days;SputnikLite;11253;3762;15015;542372;176777;719149
2022.03_13-10-2022;Республика Бурятия;45_75_days;SputnikV;16740;7273;24013;542372;176777;719149
2022.03_13-10-2022;Республика Бурятия;75_90_days;AllVaccines;15630;5516;21146;542372;176777;719149
2022.03_13-10-2022;Республика Бурятия;75_90_days;CoviVac;109;43;152;542372;176777;719149
2022.03_13-10-2022;Республика Бурятия;75_90_days;EpiVacCorona;624;295;919;542372;176777;719149
2022.03_13-10-2022;Республика Бурятия;75_90_days;SputnikLite;10794;3967;14761;542372;176777;719149
2022.03_13-10-2022;Республика Бурятия;75_90_days;SputnikV;4103;1211;5314;542372;176777;719149
2022.03_13-10-2022;Республика Бурятия;90_105_days;AllVaccines;12755;5524;18279;542372;176777;719149
2022.03_13-10-2022;Республика Бурятия;90_105_days;CoviVac;104;24;128;542372;176777;719149
2022.03_13-10-2022;Республика Бурятия;90_105_days;EpiVacCorona;312;241;553;542372;176777;719149
2022.03_13-10-2022;Республика Бурятия;90_105_days;SputnikLite;6465;3163;9628;542372;176777;719149
2022.03_13-10-2022;Республика Бурятия;90_105_days;SputnikV;5874;2096;7970;542372;176777;719149
2022.03_13-10-2022;Республика Дагестан;105_165_days;AllVaccines;197031;32559;229590;1856109;394621;2250730
2022.03_13-10-2022;Республика Дагестан;105_165_days;CoviVac;1962;353;2315;1856109;394621;2250730
2022.03_13-10-2022;Республика Дагестан;105_165_days;EpiVacCorona;12903;1876;14779;1856109;394621;2250730
2022.03_13-10-2022;Республика Дагестан;105_165_days;SputnikLite;45968;8182;54150;1856109;394621;2250730
2022.03_13-10-2022;Республика Дагестан;105_165_days;SputnikV;136198;22148;158346;1856109;394621;2250730
2022.03_13-10-2022;Республика Дагестан;165_195_days;AllVaccines;44645;14380;59025;1856109;394621;2250730
2022.03_13-10-2022;Республика Дагестан;165_195_days;CoviVac;193;68;261;1856109;394621;2250730
2022.03_13-10-2022;Республика Дагестан;165_195_days;EpiVacCorona;282;91;373;1856109;394621;2250730
2022.03_13-10-2022;Республика Дагестан;165_195_days;SputnikLite;20414;3102;23516;1856109;394621;2250730
2022.03_13-10-2022;Республика Дагестан;165_195_days;SputnikV;23756;11119;34875;1856109;394621;2250730
2022.03_13-10-2022;Республика Дагестан;21_45_days;AllVaccines;84789;22777;107566;1856109;394621;2250730
2022.03_13-10-2022;Республика Дагестан;21_45_days;CoviVac;3162;862;4024;1856109;394621;2250730
2022.03_13-10-2022;Республика Дагестан;21_45_days;EpiVacCorona;10624;2740;13364;1856109;394621;2250730
2022.03_13-10-2022;Республика Дагестан;21_45_days;SputnikLite;4039;1027;5066;1856109;394621;2250730
2022.03_13-10-2022;Республика Дагестан;21_45_days;SputnikV;66964;18148;85112;1856109;394621;2250730
2022.03_13-10-2022;Республика Дагестан;45_75_days;AllVaccines;168553;47550;216103;1856109;394621;2250730
2022.03_13-10-2022;Республика Дагестан;45_75_days;CoviVac;3089;552;3641;1856109;394621;2250730
2022.03_13-10-2022;Республика Дагестан;45_75_days;EpiVacCorona;12082;2933;15015;1856109;394621;2250730
2022.03_13-10-2022;Республика Дагестан;45_75_days;SputnikLite;15771;3201;18972;1856109;394621;2250730
2022.03_13-10-2022;Республика Дагестан;45_75_days;SputnikV;137611;40864;178475;1856109;394621;2250730
2022.03_13-10-2022;Республика Дагестан;75_90_days;AllVaccines;47356;13907;61263;1856109;394621;2250730
2022.03_13-10-2022;Республика Дагестан;75_90_days;CoviVac;774;150;924;1856109;394621;2250730
2022.03_13-10-2022;Республика Дагестан;75_90_days;EpiVacCorona;6357;1342;7699;1856109;394621;2250730
2022.03_13-10-2022;Республика Дагестан;75_90_days;SputnikLite;8407;2137;10544;1856109;394621;2250730
2022.03_13-10-2022;Республика Дагестан;75_90_days;SputnikV;31818;10278;42096;1856109;394621;2250730
2022.03_13-10-2022;Республика Дагестан;90_105_days;AllVaccines;34286;7152;41438;1856109;394621;2250730
2022.03_13-10-2022;Республика Дагестан;90_105_days;CoviVac;381;71;452;1856109;394621;2250730
2022.03_13-10-2022;Республика Дагестан;90_105_days;EpiVacCorona;5032;824;5856;1856109;394621;2250730
2022.03_13-10-2022;Республика Дагестан;90_105_days;SputnikLite;9803;2650;12453;1856109;394621;2250730
2022.03_13-10-2022;Республика Дагестан;90_105_days;SputnikV;19070;3607;22677;1856109;394621;2250730
2022.03_13-10-2022;Республика Ингушетия;105_165_days;AllVaccines;58048;13159;71207;295583;61477;357060
2022.03_13-10-2022;Республика Ингушетия;105_165_days;CoviVac;267;157;424;295583;61477;357060
2022.03_13-10-2022;Республика Ингушетия;105_165_days;EpiVacCorona;588;148;736;295583;61477;357060
2022.03_13-10-2022;Республика Ингушетия;105_165_days;SputnikLite;30484;6973;37457;295583;61477;357060
2022.03_13-10-2022;Республика Ингушетия;105_165_days;SputnikV;26709;5881;32590;295583;61477;357060
2022.03_13-10-2022;Республика Ингушетия;165_195_days;AllVaccines;8452;1447;9899;295583;61477;357060
2022.03_13-10-2022;Республика Ингушетия;165_195_days;SputnikLite;3615;692;4307;295583;61477;357060
2022.03_13-10-2022;Республика Ингушетия;165_195_days;SputnikV;4837;755;5592;295583;61477;357060
2022.03_13-10-2022;Республика Ингушетия;21_45_days;AllVaccines;5774;908;6682;295583;61477;357060
2022.03_13-10-2022;Республика Ингушетия;21_45_days;CoviVac;80;5;85;295583;61477;357060
2022.03_13-10-2022;Республика Ингушетия;21_45_days;EpiVacCorona;1503;339;1842;295583;61477;357060
2022.03_13-10-2022;Республика Ингушетия;21_45_days;SputnikLite;1413;140;1553;295583;61477;357060
2022.03_13-10-2022;Республика Ингушетия;21_45_days;SputnikV;2778;424;3202;295583;61477;357060
2022.03_13-10-2022;Республика Ингушетия;45_75_days;AllVaccines;18526;2955;21481;295583;61477;357060
2022.03_13-10-2022;Республика Ингушетия;45_75_days;CoviVac;42;6;48;295583;61477;357060
2022.03_13-10-2022;Республика Ингушетия;45_75_days;EpiVacCorona;2935;540;3475;295583;61477;357060
2022.03_13-10-2022;Республика Ингушетия;45_75_days;SputnikLite;7381;1082;8463;295583;61477;357060
2022.03_13-10-2022;Республика Ингушетия;45_75_days;SputnikV;8168;1327;9495;295583;61477;357060
2022.03_13-10-2022;Республика Ингушетия;75_90_days;AllVaccines;11219;2176;13395;295583;61477;357060
2022.03_13-10-2022;Республика Ингушетия;75_90_days;EpiVacCorona;94;36;130;295583;61477;357060
2022.03_13-10-2022;Республика Ингушетия;75_90_days;SputnikLite;5684;1206;6890;295583;61477;357060
2022.03_13-10-2022;Республика Ингушетия;75_90_days;SputnikV;5441;934;6375;295583;61477;357060
2022.03_13-10-2022;Республика Ингушетия;90_105_days;AllVaccines;14468;2402;16870;295583;61477;357060
2022.03_13-10-2022;Республика Ингушетия;90_105_days;CoviVac;124;38;162;295583;61477;357060
2022.03_13-10-2022;Республика Ингушетия;90_105_days;EpiVacCorona;1;0;1;295583;61477;357060
2022.03_13-10-2022;Республика Ингушетия;90_105_days;SputnikLite;8979;1232;10211;295583;61477;357060
2022.03_13-10-2022;Республика Ингушетия;90_105_days;SputnikV;5364;1132;6496;295583;61477;357060
2022.03_13-10-2022;Республика Калмыкия;105_165_days;AllVaccines;30638;12980;43618;150440;54890;205330
2022.03_13-10-2022;Республика Калмыкия;105_165_days;CoviVac;761;163;924;150440;54890;205330
2022.03_13-10-2022;Республика Калмыкия;105_165_days;EpiVacCorona;195;114;309;150440;54890;205330
2022.03_13-10-2022;Республика Калмыкия;105_165_days;SputnikLite;24424;10460;34884;150440;54890;205330
2022.03_13-10-2022;Республика Калмыкия;105_165_days;SputnikV;5258;2243;7501;150440;54890;205330
2022.03_13-10-2022;Республика Калмыкия;165_195_days;AllVaccines;8962;5945;14907;150440;54890;205330
2022.03_13-10-2022;Республика Калмыкия;165_195_days;CoviVac;58;18;76;150440;54890;205330
2022.03_13-10-2022;Республика Калмыкия;165_195_days;EpiVacCorona;1;0;1;150440;54890;205330
2022.03_13-10-2022;Республика Калмыкия;165_195_days;SputnikLite;8222;5552;13774;150440;54890;205330
2022.03_13-10-2022;Республика Калмыкия;165_195_days;SputnikV;681;375;1056;150440;54890;205330
2022.03_13-10-2022;Республика Калмыкия;21_45_days;AllVaccines;1309;792;2101;150440;54890;205330
2022.03_13-10-2022;Республика Калмыкия;21_45_days;CoviVac;5;1;6;150440;54890;205330
2022.03_13-10-2022;Республика Калмыкия;21_45_days;EpiVacCorona;50;22;72;150440;54890;205330
2022.03_13-10-2022;Республика Калмыкия;21_45_days;SputnikLite;949;604;1553;150440;54890;205330
2022.03_13-10-2022;Республика Калмыкия;21_45_days;SputnikV;305;165;470;150440;54890;205330
2022.03_13-10-2022;Республика Калмыкия;45_75_days;AllVaccines;4057;1764;5821;150440;54890;205330
2022.03_13-10-2022;Республика Калмыкия;45_75_days;CoviVac;27;14;41;150440;54890;205330
2022.03_13-10-2022;Республика Калмыкия;45_75_days;EpiVacCorona;112;23;135;150440;54890;205330
2022.03_13-10-2022;Республика Калмыкия;45_75_days;SputnikLite;3224;1376;4600;150440;54890;205330
2022.03_13-10-2022;Республика Калмыкия;45_75_days;SputnikV;694;351;1045;150440;54890;205330
2022.03_13-10-2022;Республика Калмыкия;75_90_days;AllVaccines;4219;1686;5905;150440;54890;205330
2022.03_13-10-2022;Республика Калмыкия;75_90_days;CoviVac;55;17;72;150440;54890;205330
2022.03_13-10-2022;Республика Калмыкия;75_90_days;EpiVacCorona;177;110;287;150440;54890;205330
2022.03_13-10-2022;Республика Калмыкия;75_90_days;SputnikLite;3791;1494;5285;150440;54890;205330
2022.03_13-10-2022;Республика Калмыкия;75_90_days;SputnikV;196;65;261;150440;54890;205330
2022.03_13-10-2022;Республика Калмыкия;90_105_days;AllVaccines;2120;905;3025;150440;54890;205330
2022.03_13-10-2022;Республика Калмыкия;90_105_days;CoviVac;30;10;40;150440;54890;205330
2022.03_13-10-2022;Республика Калмыкия;90_105_days;EpiVacCorona;101;37;138;150440;54890;205330
2022.03_13-10-2022;Республика Калмыкия;90_105_days;SputnikLite;1600;712;2312;150440;54890;205330
2022.03_13-10-2022;Республика Калмыкия;90_105_days;SputnikV;389;146;535;150440;54890;205330
2022.03_13-10-2022;Республика Карелия;105_165_days;AllVaccines;49927;36517;86444;334874;149526;484400
2022.03_13-10-2022;Республика Карелия;105_165_days;CoviVac;1299;304;1603;334874;149526;484400
2022.03_13-10-2022;Республика Карелия;105_165_days;EpiVacCorona;1494;897;2391;334874;149526;484400
2022.03_13-10-2022;Республика Карелия;105_165_days;SputnikLite;22200;20137;42337;334874;149526;484400
2022.03_13-10-2022;Республика Карелия;105_165_days;SputnikV;24934;15179;40113;334874;149526;484400
2022.03_13-10-2022;Республика Карелия;165_195_days;AllVaccines;23678;13372;37050;334874;149526;484400
2022.03_13-10-2022;Республика Карелия;165_195_days;CoviVac;11;4;15;334874;149526;484400
2022.03_13-10-2022;Республика Карелия;165_195_days;EpiVacCorona;64;66;130;334874;149526;484400
2022.03_13-10-2022;Республика Карелия;165_195_days;SputnikLite;20015;10483;30498;334874;149526;484400
2022.03_13-10-2022;Республика Карелия;165_195_days;SputnikV;3588;2819;6407;334874;149526;484400
2022.03_13-10-2022;Республика Карелия;21_45_days;AllVaccines;5894;3860;9754;334874;149526;484400
2022.03_13-10-2022;Республика Карелия;21_45_days;CoviVac;63;17;80;334874;149526;484400
2022.03_13-10-2022;Республика Карелия;21_45_days;EpiVacCorona;171;116;287;334874;149526;484400
2022.03_13-10-2022;Республика Карелия;21_45_days;SputnikLite;3298;2336;5634;334874;149526;484400
2022.03_13-10-2022;Республика Карелия;21_45_days;SputnikV;2362;1391;3753;334874;149526;484400
2022.03_13-10-2022;Республика Карелия;45_75_days;AllVaccines;12547;6749;19296;334874;149526;484400
2022.03_13-10-2022;Республика Карелия;45_75_days;CoviVac;281;52;333;334874;149526;484400
2022.03_13-10-2022;Республика Карелия;45_75_days;EpiVacCorona;510;350;860;334874;149526;484400
2022.03_13-10-2022;Республика Карелия;45_75_days;SputnikLite;6293;2771;9064;334874;149526;484400
2022.03_13-10-2022;Республика Карелия;45_75_days;SputnikV;5463;3576;9039;334874;149526;484400
2022.03_13-10-2022;Республика Карелия;75_90_days;AllVaccines;6741;3387;10128;334874;149526;484400
2022.03_13-10-2022;Республика Карелия;75_90_days;CoviVac;146;39;185;334874;149526;484400
2022.03_13-10-2022;Республика Карелия;75_90_days;EpiVacCorona;223;162;385;334874;149526;484400
2022.03_13-10-2022;Республика Карелия;75_90_days;SputnikLite;5103;2633;7736;334874;149526;484400
2022.03_13-10-2022;Республика Карелия;75_90_days;SputnikV;1269;553;1822;334874;149526;484400
2022.03_13-10-2022;Республика Карелия;90_105_days;AllVaccines;5487;3338;8825;334874;149526;484400
2022.03_13-10-2022;Республика Карелия;90_105_days;CoviVac;177;49;226;334874;149526;484400
2022.03_13-10-2022;Республика Карелия;90_105_days;EpiVacCorona;202;122;324;334874;149526;484400
2022.03_13-10-2022;Республика Карелия;90_105_days;SputnikLite;2737;1936;4673;334874;149526;484400
2022.03_13-10-2022;Республика Карелия;90_105_days;SputnikV;2371;1231;3602;334874;149526;484400
2022.03_13-10-2022;Республика Коми;105_165_days;AllVaccines;63756;32783;96539;465210;166370;631580
2022.03_13-10-2022;Республика Коми;105_165_days;CoviVac;857;195;1052;465210;166370;631580
2022.03_13-10-2022;Республика Коми;105_165_days;EpiVacCorona;1379;578;1957;465210;166370;631580
2022.03_13-10-2022;Республика Коми;105_165_days;SputnikLite;33356;18290;51646;465210;166370;631580
2022.03_13-10-2022;Республика Коми;105_165_days;SputnikV;28164;13720;41884;465210;166370;631580
2022.03_13-10-2022;Республика Коми;165_195_days;AllVaccines;17889;7759;25648;465210;166370;631580
2022.03_13-10-2022;Республика Коми;165_195_days;CoviVac;30;1;31;465210;166370;631580
2022.03_13-10-2022;Республика Коми;165_195_days;EpiVacCorona;2;3;5;465210;166370;631580
2022.03_13-10-2022;Республика Коми;165_195_days;SputnikLite;13515;5611;19126;465210;166370;631580
2022.03_13-10-2022;Республика Коми;165_195_days;SputnikV;4342;2144;6486;465210;166370;631580
2022.03_13-10-2022;Республика Коми;21_45_days;AllVaccines;8117;3013;11130;465210;166370;631580
2022.03_13-10-2022;Республика Коми;21_45_days;CoviVac;108;38;146;465210;166370;631580
2022.03_13-10-2022;Республика Коми;21_45_days;EpiVacCorona;208;52;260;465210;166370;631580
2022.03_13-10-2022;Республика Коми;21_45_days;SputnikLite;3695;1281;4976;465210;166370;631580
2022.03_13-10-2022;Республика Коми;21_45_days;SputnikV;4106;1642;5748;465210;166370;631580
2022.03_13-10-2022;Республика Коми;45_75_days;AllVaccines;13632;6027;19659;465210;166370;631580
2022.03_13-10-2022;Республика Коми;45_75_days;CoviVac;280;61;341;465210;166370;631580
2022.03_13-10-2022;Республика Коми;45_75_days;EpiVacCorona;467;265;732;465210;166370;631580
2022.03_13-10-2022;Республика Коми;45_75_days;SputnikLite;6747;2185;8932;465210;166370;631580
2022.03_13-10-2022;Республика Коми;45_75_days;SputnikV;6138;3516;9654;465210;166370;631580
2022.03_13-10-2022;Республика Коми;75_90_days;AllVaccines;11725;4584;16309;465210;166370;631580
2022.03_13-10-2022;Республика Коми;75_90_days;CoviVac;90;16;106;465210;166370;631580
2022.03_13-10-2022;Республика Коми;75_90_days;EpiVacCorona;289;116;405;465210;166370;631580
2022.03_13-10-2022;Республика Коми;75_90_days;SputnikLite;9589;3745;13334;465210;166370;631580
2022.03_13-10-2022;Республика Коми;75_90_days;SputnikV;1757;707;2464;465210;166370;631580
2022.03_13-10-2022;Республика Коми;90_105_days;AllVaccines;6789;3688;10477;465210;166370;631580
2022.03_13-10-2022;Республика Коми;90_105_days;CoviVac;145;42;187;465210;166370;631580
2022.03_13-10-2022;Республика Коми;90_105_days;EpiVacCorona;252;119;371;465210;166370;631580
2022.03_13-10-2022;Республика Коми;90_105_days;SputnikLite;3503;1948;5451;465210;166370;631580
2022.03_13-10-2022;Республика Коми;90_105_days;SputnikV;2889;1579;4468;465210;166370;631580
2022.03_13-10-2022;Республика Крым;105_165_days;AllVaccines;343807;119177;462984;1036087;480146;1516233
2022.03_13-10-2022;Республика Крым;105_165_days;CoviVac;3098;808;3906;1036087;480146;1516233
2022.03_13-10-2022;Республика Крым;105_165_days;EpiVacCorona;8300;3092;11392;1036087;480146;1516233
2022.03_13-10-2022;Республика Крым;105_165_days;SputnikLite;51726;54123;105849;1036087;480146;1516233
2022.03_13-10-2022;Республика Крым;105_165_days;SputnikV;280683;61154;341837;1036087;480146;1516233
2022.03_13-10-2022;Республика Крым;165_195_days;AllVaccines;46238;21178;67416;1036087;480146;1516233
2022.03_13-10-2022;Республика Крым;165_195_days;CoviVac;694;195;889;1036087;480146;1516233
2022.03_13-10-2022;Республика Крым;165_195_days;EpiVacCorona;502;212;714;1036087;480146;1516233
2022.03_13-10-2022;Республика Крым;165_195_days;SputnikLite;19225;14836;34061;1036087;480146;1516233
2022.03_13-10-2022;Республика Крым;165_195_days;SputnikV;25817;5935;31752;1036087;480146;1516233
2022.03_13-10-2022;Республика Крым;21_45_days;AllVaccines;10225;4933;15158;1036087;480146;1516233
2022.03_13-10-2022;Республика Крым;21_45_days;CoviVac;271;93;364;1036087;480146;1516233
2022.03_13-10-2022;Республика Крым;21_45_days;EpiVacCorona;1269;694;1963;1036087;480146;1516233
2022.03_13-10-2022;Республика Крым;21_45_days;SputnikLite;501;235;736;1036087;480146;1516233
2022.03_13-10-2022;Республика Крым;21_45_days;SputnikV;8184;3911;12095;1036087;480146;1516233
2022.03_13-10-2022;Республика Крым;45_75_days;AllVaccines;29746;14160;43906;1036087;480146;1516233
2022.03_13-10-2022;Республика Крым;45_75_days;CoviVac;460;163;623;1036087;480146;1516233
2022.03_13-10-2022;Республика Крым;45_75_days;EpiVacCorona;2646;1466;4112;1036087;480146;1516233
2022.03_13-10-2022;Республика Крым;45_75_days;SputnikLite;13200;6737;19937;1036087;480146;1516233
2022.03_13-10-2022;Республика Крым;45_75_days;SputnikV;13440;5794;19234;1036087;480146;1516233
2022.03_13-10-2022;Республика Крым;75_90_days;AllVaccines;33004;17519;50523;1036087;480146;1516233
2022.03_13-10-2022;Республика Крым;75_90_days;CoviVac;160;52;212;1036087;480146;1516233
2022.03_13-10-2022;Республика Крым;75_90_days;EpiVacCorona;694;374;1068;1036087;480146;1516233
2022.03_13-10-2022;Республика Крым;75_90_days;SputnikLite;26037;15557;41594;1036087;480146;1516233
2022.03_13-10-2022;Республика Крым;75_90_days;SputnikV;6113;1536;7649;1036087;480146;1516233
2022.03_13-10-2022;Республика Крым;90_105_days;AllVaccines;20115;12072;32187;1036087;480146;1516233
2022.03_13-10-2022;Республика Крым;90_105_days;CoviVac;119;34;153;1036087;480146;1516233
2022.03_13-10-2022;Республика Крым;90_105_days;EpiVacCorona;971;635;1606;1036087;480146;1516233
2022.03_13-10-2022;Республика Крым;90_105_days;SputnikLite;8271;7837;16108;1036087;480146;1516233
2022.03_13-10-2022;Республика Крым;90_105_days;SputnikV;10754;3566;14320;1036087;480146;1516233
2022.03_13-10-2022;Республика Марий Эл;105_165_days;AllVaccines;85318;34095;119413;370626;156749;527375
2022.03_13-10-2022;Республика Марий Эл;105_165_days;CoviVac;897;263;1160;370626;156749;527375
2022.03_13-10-2022;Республика Марий Эл;105_165_days;EpiVacCorona;5062;1617;6679;370626;156749;527375
2022.03_13-10-2022;Республика Марий Эл;105_165_days;SputnikLite;30071;14309;44380;370626;156749;527375
2022.03_13-10-2022;Республика Марий Эл;105_165_days;SputnikV;49288;17906;67194;370626;156749;527375
2022.03_13-10-2022;Республика Марий Эл;165_195_days;AllVaccines;36580;10072;46652;370626;156749;527375
2022.03_13-10-2022;Республика Марий Эл;165_195_days;CoviVac;20;5;25;370626;156749;527375
2022.03_13-10-2022;Республика Марий Эл;165_195_days;EpiVacCorona;71;24;95;370626;156749;527375
2022.03_13-10-2022;Республика Марий Эл;165_195_days;SputnikLite;32977;7808;40785;370626;156749;527375
2022.03_13-10-2022;Республика Марий Эл;165_195_days;SputnikV;3512;2235;5747;370626;156749;527375
2022.03_13-10-2022;Республика Марий Эл;21_45_days;AllVaccines;2309;2239;4548;370626;156749;527375
2022.03_13-10-2022;Республика Марий Эл;21_45_days;CoviVac;207;140;347;370626;156749;527375
2022.03_13-10-2022;Республика Марий Эл;21_45_days;EpiVacCorona;140;226;366;370626;156749;527375
2022.03_13-10-2022;Республика Марий Эл;21_45_days;SputnikLite;519;308;827;370626;156749;527375
2022.03_13-10-2022;Республика Марий Эл;21_45_days;SputnikV;1443;1565;3008;370626;156749;527375
2022.03_13-10-2022;Республика Марий Эл;45_75_days;AllVaccines;10603;8560;19163;370626;156749;527375
2022.03_13-10-2022;Республика Марий Эл;45_75_days;CoviVac;195;114;309;370626;156749;527375
2022.03_13-10-2022;Республика Марий Эл;45_75_days;EpiVacCorona;632;662;1294;370626;156749;527375
2022.03_13-10-2022;Республика Марий Эл;45_75_days;SputnikLite;6610;5168;11778;370626;156749;527375
2022.03_13-10-2022;Республика Марий Эл;45_75_days;SputnikV;3166;2616;5782;370626;156749;527375
2022.03_13-10-2022;Республика Марий Эл;75_90_days;AllVaccines;7919;4604;12523;370626;156749;527375
2022.03_13-10-2022;Республика Марий Эл;75_90_days;CoviVac;49;24;73;370626;156749;527375
2022.03_13-10-2022;Республика Марий Эл;75_90_days;EpiVacCorona;195;109;304;370626;156749;527375
2022.03_13-10-2022;Республика Марий Эл;75_90_days;SputnikLite;6596;4078;10674;370626;156749;527375
2022.03_13-10-2022;Республика Марий Эл;75_90_days;SputnikV;1079;393;1472;370626;156749;527375
2022.03_13-10-2022;Республика Марий Эл;90_105_days;AllVaccines;5930;3328;9258;370626;156749;527375
2022.03_13-10-2022;Республика Марий Эл;90_105_days;CoviVac;59;28;87;370626;156749;527375
2022.03_13-10-2022;Республика Марий Эл;90_105_days;EpiVacCorona;224;147;371;370626;156749;527375
2022.03_13-10-2022;Республика Марий Эл;90_105_days;SputnikLite;3074;1944;5018;370626;156749;527375
2022.03_13-10-2022;Республика Марий Эл;90_105_days;SputnikV;2573;1209;3782;370626;156749;527375
2022.03_13-10-2022;Республика Мордовия;105_165_days;AllVaccines;93344;50358;143702;448319;198808;647127
2022.03_13-10-2022;Республика Мордовия;105_165_days;CoviVac;1680;469;2149;448319;198808;647127
2022.03_13-10-2022;Республика Мордовия;105_165_days;EpiVacCorona;2884;1094;3978;448319;198808;647127
2022.03_13-10-2022;Республика Мордовия;105_165_days;SputnikLite;32178;22392;54570;448319;198808;647127
2022.03_13-10-2022;Республика Мордовия;105_165_days;SputnikV;56602;26403;83005;448319;198808;647127
2022.03_13-10-2022;Республика Мордовия;165_195_days;AllVaccines;30637;20797;51434;448319;198808;647127
2022.03_13-10-2022;Республика Мордовия;165_195_days;CoviVac;22;2;24;448319;198808;647127
2022.03_13-10-2022;Республика Мордовия;165_195_days;EpiVacCorona;135;53;188;448319;198808;647127
2022.03_13-10-2022;Республика Мордовия;165_195_days;SputnikLite;23858;14011;37869;448319;198808;647127
2022.03_13-10-2022;Республика Мордовия;165_195_days;SputnikV;6622;6731;13353;448319;198808;647127
2022.03_13-10-2022;Республика Мордовия;21_45_days;AllVaccines;10986;6564;17550;448319;198808;647127
2022.03_13-10-2022;Республика Мордовия;21_45_days;CoviVac;214;134;348;448319;198808;647127
2022.03_13-10-2022;Республика Мордовия;21_45_days;EpiVacCorona;747;542;1289;448319;198808;647127
2022.03_13-10-2022;Республика Мордовия;21_45_days;SputnikLite;4928;2597;7525;448319;198808;647127
2022.03_13-10-2022;Республика Мордовия;21_45_days;SputnikV;5097;3291;8388;448319;198808;647127
2022.03_13-10-2022;Республика Мордовия;45_75_days;AllVaccines;28346;13572;41918;448319;198808;647127
2022.03_13-10-2022;Республика Мордовия;45_75_days;CoviVac;348;77;425;448319;198808;647127
2022.03_13-10-2022;Республика Мордовия;45_75_days;EpiVacCorona;2739;1625;4364;448319;198808;647127
2022.03_13-10-2022;Республика Мордовия;45_75_days;SputnikLite;15278;6298;21576;448319;198808;647127
2022.03_13-10-2022;Республика Мордовия;45_75_days;SputnikV;9981;5572;15553;448319;198808;647127
2022.03_13-10-2022;Республика Мордовия;75_90_days;AllVaccines;16573;7107;23680;448319;198808;647127
2022.03_13-10-2022;Республика Мордовия;75_90_days;CoviVac;109;26;135;448319;198808;647127
2022.03_13-10-2022;Республика Мордовия;75_90_days;EpiVacCorona;713;463;1176;448319;198808;647127
2022.03_13-10-2022;Республика Мордовия;75_90_days;SputnikLite;13582;5233;18815;448319;198808;647127
2022.03_13-10-2022;Республика Мордовия;75_90_days;SputnikV;2169;1385;3554;448319;198808;647127
2022.03_13-10-2022;Республика Мордовия;90_105_days;AllVaccines;11385;5407;16792;448319;198808;647127
2022.03_13-10-2022;Республика Мордовия;90_105_days;CoviVac;116;39;155;448319;198808;647127
2022.03_13-10-2022;Республика Мордовия;90_105_days;EpiVacCorona;672;341;1013;448319;198808;647127
2022.03_13-10-2022;Республика Мордовия;90_105_days;SputnikLite;7552;3291;10843;448319;198808;647127
2022.03_13-10-2022;Республика Мордовия;90_105_days;SputnikV;3045;1736;4781;448319;198808;647127
2022.03_13-10-2022;Республика Саха (Якутия);105_165_days;AllVaccines;92591;27210;119801;568643;148395;717038
2022.03_13-10-2022;Республика Саха (Якутия);105_165_days;CoviVac;1824;296;2120;568643;148395;717038
2022.03_13-10-2022;Республика Саха (Якутия);105_165_days;EpiVacCorona;797;365;1162;568643;148395;717038
2022.03_13-10-2022;Республика Саха (Якутия);105_165_days;SputnikLite;49712;15510;65222;568643;148395;717038
2022.03_13-10-2022;Республика Саха (Якутия);105_165_days;SputnikV;40258;11039;51297;568643;148395;717038
2022.03_13-10-2022;Республика Саха (Якутия);165_195_days;AllVaccines;30572;7673;38245;568643;148395;717038
2022.03_13-10-2022;Республика Саха (Якутия);165_195_days;CoviVac;22;7;29;568643;148395;717038
2022.03_13-10-2022;Республика Саха (Якутия);165_195_days;EpiVacCorona;760;182;942;568643;148395;717038
2022.03_13-10-2022;Республика Саха (Якутия);165_195_days;SputnikLite;24885;6289;31174;568643;148395;717038
2022.03_13-10-2022;Республика Саха (Якутия);165_195_days;SputnikV;4905;1195;6100;568643;148395;717038
2022.03_13-10-2022;Республика Саха (Якутия);21_45_days;AllVaccines;9311;1920;11231;568643;148395;717038
2022.03_13-10-2022;Республика Саха (Якутия);21_45_days;CoviVac;121;18;139;568643;148395;717038
2022.03_13-10-2022;Республика Саха (Якутия);21_45_days;EpiVacCorona;422;139;561;568643;148395;717038
2022.03_13-10-2022;Республика Саха (Якутия);21_45_days;SputnikLite;2369;508;2877;568643;148395;717038
2022.03_13-10-2022;Республика Саха (Якутия);21_45_days;SputnikV;6399;1255;7654;568643;148395;717038
2022.03_13-10-2022;Республика Саха (Якутия);45_75_days;AllVaccines;22029;5444;27473;568643;148395;717038
2022.03_13-10-2022;Республика Саха (Якутия);45_75_days;CoviVac;214;26;240;568643;148395;717038
2022.03_13-10-2022;Республика Саха (Якутия);45_75_days;EpiVacCorona;796;319;1115;568643;148395;717038
2022.03_13-10-2022;Республика Саха (Якутия);45_75_days;SputnikLite;6736;1064;7800;568643;148395;717038
2022.03_13-10-2022;Республика Саха (Якутия);45_75_days;SputnikV;14283;4035;18318;568643;148395;717038
2022.03_13-10-2022;Республика Саха (Якутия);75_90_days;AllVaccines;15319;3603;18922;568643;148395;717038
2022.03_13-10-2022;Республика Саха (Якутия);75_90_days;CoviVac;133;14;147;568643;148395;717038
2022.03_13-10-2022;Республика Саха (Якутия);75_90_days;EpiVacCorona;183;63;246;568643;148395;717038
2022.03_13-10-2022;Республика Саха (Якутия);75_90_days;SputnikLite;12069;2823;14892;568643;148395;717038
2022.03_13-10-2022;Республика Саха (Якутия);75_90_days;SputnikV;2934;703;3637;568643;148395;717038
2022.03_13-10-2022;Республика Саха (Якутия);90_105_days;AllVaccines;11975;3367;15342;568643;148395;717038
2022.03_13-10-2022;Республика Саха (Якутия);90_105_days;CoviVac;128;20;148;568643;148395;717038
2022.03_13-10-2022;Республика Саха (Якутия);90_105_days;EpiVacCorona;173;63;236;568643;148395;717038
2022.03_13-10-2022;Республика Саха (Якутия);90_105_days;SputnikLite;6723;1761;8484;568643;148395;717038
2022.03_13-10-2022;Республика Саха (Якутия);90_105_days;SputnikV;4951;1523;6474;568643;148395;717038
2022.03_13-10-2022;Республика Северная Осетия - Алания;105_165_days;AllVaccines;57482;11495;68977;385443;144230;529673
2022.03_13-10-2022;Республика Северная Осетия - Алания;105_165_days;CoviVac;725;209;934;385443;144230;529673
2022.03_13-10-2022;Республика Северная Осетия - Алания;105_165_days;EpiVacCorona;1363;208;1571;385443;144230;529673
2022.03_13-10-2022;Республика Северная Осетия - Алания;105_165_days;SputnikLite;26252;5734;31986;385443;144230;529673
2022.03_13-10-2022;Республика Северная Осетия - Алания;105_165_days;SputnikV;29142;5344;34486;385443;144230;529673
2022.03_13-10-2022;Республика Северная Осетия - Алания;165_195_days;AllVaccines;11882;3101;14983;385443;144230;529673
2022.03_13-10-2022;Республика Северная Осетия - Алания;165_195_days;CoviVac;10;2;12;385443;144230;529673
2022.03_13-10-2022;Республика Северная Осетия - Алания;165_195_days;EpiVacCorona;177;32;209;385443;144230;529673
2022.03_13-10-2022;Республика Северная Осетия - Алания;165_195_days;SputnikLite;7258;1985;9243;385443;144230;529673
2022.03_13-10-2022;Республика Северная Осетия - Алания;165_195_days;SputnikV;4437;1082;5519;385443;144230;529673
2022.03_13-10-2022;Республика Северная Осетия - Алания;21_45_days;AllVaccines;3769;1716;5485;385443;144230;529673
2022.03_13-10-2022;Республика Северная Осетия - Алания;21_45_days;CoviVac;62;228;290;385443;144230;529673
2022.03_13-10-2022;Республика Северная Осетия - Алания;21_45_days;EpiVacCorona;288;473;761;385443;144230;529673
2022.03_13-10-2022;Республика Северная Осетия - Алания;21_45_days;SputnikLite;945;296;1241;385443;144230;529673
2022.03_13-10-2022;Республика Северная Осетия - Алания;21_45_days;SputnikV;2474;719;3193;385443;144230;529673
2022.03_13-10-2022;Республика Северная Осетия - Алания;45_75_days;AllVaccines;7484;2499;9983;385443;144230;529673
2022.03_13-10-2022;Республика Северная Осетия - Алания;45_75_days;CoviVac;70;19;89;385443;144230;529673
2022.03_13-10-2022;Республика Северная Осетия - Алания;45_75_days;EpiVacCorona;250;170;420;385443;144230;529673
2022.03_13-10-2022;Республика Северная Осетия - Алания;45_75_days;SputnikLite;2933;981;3914;385443;144230;529673
2022.03_13-10-2022;Республика Северная Осетия - Алания;45_75_days;SputnikV;4231;1329;5560;385443;144230;529673
2022.03_13-10-2022;Республика Северная Осетия - Алания;75_90_days;AllVaccines;5149;2044;7193;385443;144230;529673
2022.03_13-10-2022;Республика Северная Осетия - Алания;75_90_days;CoviVac;29;30;59;385443;144230;529673
2022.03_13-10-2022;Республика Северная Осетия - Алания;75_90_days;EpiVacCorona;827;365;1192;385443;144230;529673
2022.03_13-10-2022;Республика Северная Осетия - Алания;75_90_days;SputnikLite;2797;1055;3852;385443;144230;529673
2022.03_13-10-2022;Республика Северная Осетия - Алания;75_90_days;SputnikV;1496;594;2090;385443;144230;529673
2022.03_13-10-2022;Республика Северная Осетия - Алания;90_105_days;AllVaccines;5107;1308;6415;385443;144230;529673
2022.03_13-10-2022;Республика Северная Осетия - Алания;90_105_days;CoviVac;33;12;45;385443;144230;529673
2022.03_13-10-2022;Республика Северная Осетия - Алания;90_105_days;EpiVacCorona;953;213;1166;385443;144230;529673
2022.03_13-10-2022;Республика Северная Осетия - Алания;90_105_days;SputnikLite;2162;660;2822;385443;144230;529673
2022.03_13-10-2022;Республика Северная Осетия - Алания;90_105_days;SputnikV;1959;423;2382;385443;144230;529673
2022.03_13-10-2022;Республика Татарстан;105_165_days;AllVaccines;738743;244062;982805;2180132;866477;3046609
2022.03_13-10-2022;Республика Татарстан;105_165_days;CoviVac;2859;743;3602;2180132;866477;3046609
2022.03_13-10-2022;Республика Татарстан;105_165_days;EpiVacCorona;13806;7275;21081;2180132;866477;3046609
2022.03_13-10-2022;Республика Татарстан;105_165_days;SputnikLite;87017;55215;142232;2180132;866477;3046609
2022.03_13-10-2022;Республика Татарстан;105_165_days;SputnikV;635061;180829;815890;2180132;866477;3046609
2022.03_13-10-2022;Республика Татарстан;165_195_days;AllVaccines;137383;41642;179025;2180132;866477;3046609
2022.03_13-10-2022;Республика Татарстан;165_195_days;CoviVac;2177;462;2639;2180132;866477;3046609
2022.03_13-10-2022;Республика Татарстан;165_195_days;EpiVacCorona;2866;1307;4173;2180132;866477;3046609
2022.03_13-10-2022;Республика Татарстан;165_195_days;SputnikLite;61265;18647;79912;2180132;866477;3046609
2022.03_13-10-2022;Республика Татарстан;165_195_days;SputnikV;71075;21226;92301;2180132;866477;3046609
2022.03_13-10-2022;Республика Татарстан;21_45_days;AllVaccines;28804;11412;40216;2180132;866477;3046609
2022.03_13-10-2022;Республика Татарстан;21_45_days;CoviVac;402;189;591;2180132;866477;3046609
2022.03_13-10-2022;Республика Татарстан;21_45_days;EpiVacCorona;587;397;984;2180132;866477;3046609
2022.03_13-10-2022;Республика Татарстан;21_45_days;SputnikLite;10281;4744;15025;2180132;866477;3046609
2022.03_13-10-2022;Республика Татарстан;21_45_days;SputnikV;17534;6082;23616;2180132;866477;3046609
2022.03_13-10-2022;Республика Татарстан;45_75_days;AllVaccines;62486;27580;90066;2180132;866477;3046609
2022.03_13-10-2022;Республика Татарстан;45_75_days;CoviVac;419;199;618;2180132;866477;3046609
2022.03_13-10-2022;Республика Татарстан;45_75_days;EpiVacCorona;867;737;1604;2180132;866477;3046609
2022.03_13-10-2022;Республика Татарстан;45_75_days;SputnikLite;26879;10368;37247;2180132;866477;3046609
2022.03_13-10-2022;Республика Татарстан;45_75_days;SputnikV;34321;16276;50597;2180132;866477;3046609
2022.03_13-10-2022;Республика Татарстан;75_90_days;AllVaccines;36955;19545;56500;2180132;866477;3046609
2022.03_13-10-2022;Республика Татарстан;75_90_days;CoviVac;169;76;245;2180132;866477;3046609
2022.03_13-10-2022;Республика Татарстан;75_90_days;EpiVacCorona;527;440;967;2180132;866477;3046609
2022.03_13-10-2022;Республика Татарстан;75_90_days;SputnikLite;25384;14316;39700;2180132;866477;3046609
2022.03_13-10-2022;Республика Татарстан;75_90_days;SputnikV;10875;4713;15588;2180132;866477;3046609
2022.03_13-10-2022;Республика Татарстан;90_105_days;AllVaccines;30602;19068;49670;2180132;866477;3046609
2022.03_13-10-2022;Республика Татарстан;90_105_days;CoviVac;173;55;228;2180132;866477;3046609
2022.03_13-10-2022;Республика Татарстан;90_105_days;EpiVacCorona;635;538;1173;2180132;866477;3046609
2022.03_13-10-2022;Республика Татарстан;90_105_days;SputnikLite;10277;8438;18715;2180132;866477;3046609
2022.03_13-10-2022;Республика Татарстан;90_105_days;SputnikV;19517;10037;29554;2180132;866477;3046609
2022.03_13-10-2022;Республика Тыва;105_165_days;AllVaccines;30602;6219;36821;176122;31028;207150
2022.03_13-10-2022;Республика Тыва;105_165_days;CoviVac;25;2;27;176122;31028;207150
2022.03_13-10-2022;Республика Тыва;105_165_days;EpiVacCorona;213;35;248;176122;31028;207150
2022.03_13-10-2022;Республика Тыва;105_165_days;SputnikLite;20508;4613;25121;176122;31028;207150
2022.03_13-10-2022;Республика Тыва;105_165_days;SputnikV;9856;1569;11425;176122;31028;207150
2022.03_13-10-2022;Республика Тыва;165_195_days;AllVaccines;15964;4308;20272;176122;31028;207150
2022.03_13-10-2022;Республика Тыва;165_195_days;CoviVac;20;2;22;176122;31028;207150
2022.03_13-10-2022;Республика Тыва;165_195_days;EpiVacCorona;25;4;29;176122;31028;207150
2022.03_13-10-2022;Республика Тыва;165_195_days;SputnikLite;14446;3968;18414;176122;31028;207150
2022.03_13-10-2022;Республика Тыва;165_195_days;SputnikV;1473;334;1807;176122;31028;207150
2022.03_13-10-2022;Республика Тыва;21_45_days;AllVaccines;6821;1231;8052;176122;31028;207150
2022.03_13-10-2022;Республика Тыва;21_45_days;CoviVac;58;23;81;176122;31028;207150
2022.03_13-10-2022;Республика Тыва;21_45_days;EpiVacCorona;240;35;275;176122;31028;207150
2022.03_13-10-2022;Республика Тыва;21_45_days;SputnikLite;3690;740;4430;176122;31028;207150
2022.03_13-10-2022;Республика Тыва;21_45_days;SputnikV;2833;433;3266;176122;31028;207150
2022.03_13-10-2022;Республика Тыва;45_75_days;AllVaccines;10483;1799;12282;176122;31028;207150
2022.03_13-10-2022;Республика Тыва;45_75_days;CoviVac;34;3;37;176122;31028;207150
2022.03_13-10-2022;Республика Тыва;45_75_days;EpiVacCorona;128;21;149;176122;31028;207150
2022.03_13-10-2022;Республика Тыва;45_75_days;SputnikLite;5329;876;6205;176122;31028;207150
2022.03_13-10-2022;Республика Тыва;45_75_days;SputnikV;4992;899;5891;176122;31028;207150
2022.03_13-10-2022;Республика Тыва;75_90_days;AllVaccines;7405;1481;8886;176122;31028;207150
2022.03_13-10-2022;Республика Тыва;75_90_days;CoviVac;3;0;3;176122;31028;207150
2022.03_13-10-2022;Республика Тыва;75_90_days;EpiVacCorona;49;2;51;176122;31028;207150
2022.03_13-10-2022;Республика Тыва;75_90_days;SputnikLite;6279;1310;7589;176122;31028;207150
2022.03_13-10-2022;Республика Тыва;75_90_days;SputnikV;1074;169;1243;176122;31028;207150
2022.03_13-10-2022;Республика Тыва;90_105_days;AllVaccines;4293;940;5233;176122;31028;207150
2022.03_13-10-2022;Республика Тыва;90_105_days;EpiVacCorona;44;4;48;176122;31028;207150
2022.03_13-10-2022;Республика Тыва;90_105_days;SputnikLite;3130;739;3869;176122;31028;207150
2022.03_13-10-2022;Республика Тыва;90_105_days;SputnikV;1119;197;1316;176122;31028;207150
2022.03_13-10-2022;Республика Хакасия;105_165_days;AllVaccines;39766;21296;61062;291439;112190;403629
2022.03_13-10-2022;Республика Хакасия;105_165_days;CoviVac;786;240;1026;291439;112190;403629
2022.03_13-10-2022;Республика Хакасия;105_165_days;EpiVacCorona;879;413;1292;291439;112190;403629
2022.03_13-10-2022;Республика Хакасия;105_165_days;SputnikLite;17495;11273;28768;291439;112190;403629
2022.03_13-10-2022;Республика Хакасия;105_165_days;SputnikV;20606;9370;29976;291439;112190;403629
2022.03_13-10-2022;Республика Хакасия;165_195_days;AllVaccines;12132;6078;18210;291439;112190;403629
2022.03_13-10-2022;Республика Хакасия;165_195_days;CoviVac;140;80;220;291439;112190;403629
2022.03_13-10-2022;Республика Хакасия;165_195_days;EpiVacCorona;29;9;38;291439;112190;403629
2022.03_13-10-2022;Республика Хакасия;165_195_days;SputnikLite;9144;4612;13756;291439;112190;403629
2022.03_13-10-2022;Республика Хакасия;165_195_days;SputnikV;2819;1377;4196;291439;112190;403629
2022.03_13-10-2022;Республика Хакасия;21_45_days;AllVaccines;3280;1427;4707;291439;112190;403629
2022.03_13-10-2022;Республика Хакасия;21_45_days;CoviVac;75;15;90;291439;112190;403629
2022.03_13-10-2022;Республика Хакасия;21_45_days;EpiVacCorona;155;40;195;291439;112190;403629
2022.03_13-10-2022;Республика Хакасия;21_45_days;SputnikLite;652;281;933;291439;112190;403629
2022.03_13-10-2022;Республика Хакасия;21_45_days;SputnikV;2398;1091;3489;291439;112190;403629
2022.03_13-10-2022;Республика Хакасия;45_75_days;AllVaccines;12898;4731;17629;291439;112190;403629
2022.03_13-10-2022;Республика Хакасия;45_75_days;CoviVac;247;71;318;291439;112190;403629
2022.03_13-10-2022;Республика Хакасия;45_75_days;EpiVacCorona;594;208;802;291439;112190;403629
2022.03_13-10-2022;Республика Хакасия;45_75_days;SputnikLite;7626;2313;9939;291439;112190;403629
2022.03_13-10-2022;Республика Хакасия;45_75_days;SputnikV;4431;2139;6570;291439;112190;403629
2022.03_13-10-2022;Республика Хакасия;75_90_days;AllVaccines;8303;3087;11390;291439;112190;403629
2022.03_13-10-2022;Республика Хакасия;75_90_days;CoviVac;96;35;131;291439;112190;403629
2022.03_13-10-2022;Республика Хакасия;75_90_days;EpiVacCorona;220;96;316;291439;112190;403629
2022.03_13-10-2022;Республика Хакасия;75_90_days;SputnikLite;6907;2601;9508;291439;112190;403629
2022.03_13-10-2022;Республика Хакасия;75_90_days;SputnikV;1080;355;1435;291439;112190;403629
2022.03_13-10-2022;Республика Хакасия;90_105_days;AllVaccines;5075;2451;7526;291439;112190;403629
2022.03_13-10-2022;Республика Хакасия;90_105_days;CoviVac;120;33;153;291439;112190;403629
2022.03_13-10-2022;Республика Хакасия;90_105_days;EpiVacCorona;225;78;303;291439;112190;403629
2022.03_13-10-2022;Республика Хакасия;90_105_days;SputnikLite;2769;1524;4293;291439;112190;403629
2022.03_13-10-2022;Республика Хакасия;90_105_days;SputnikV;1961;816;2777;291439;112190;403629
2022.03_13-10-2022;Ростовская область;105_165_days;AllVaccines;289798;164017;453815;2367942;1020468;3388410
2022.03_13-10-2022;Ростовская область;105_165_days;CoviVac;2897;1219;4116;2367942;1020468;3388410
2022.03_13-10-2022;Ростовская область;105_165_days;EpiVacCorona;2837;1631;4468;2367942;1020468;3388410
2022.03_13-10-2022;Ростовская область;105_165_days;SputnikLite;69120;49836;118956;2367942;1020468;3388410
2022.03_13-10-2022;Ростовская область;105_165_days;SputnikV;214944;111331;326275;2367942;1020468;3388410
2022.03_13-10-2022;Ростовская область;165_195_days;AllVaccines;83469;42308;125777;2367942;1020468;3388410
2022.03_13-10-2022;Ростовская область;165_195_days;CoviVac;994;400;1394;2367942;1020468;3388410
2022.03_13-10-2022;Ростовская область;165_195_days;EpiVacCorona;905;454;1359;2367942;1020468;3388410
2022.03_13-10-2022;Ростовская область;165_195_days;SputnikLite;40557;24697;65254;2367942;1020468;3388410
2022.03_13-10-2022;Ростовская область;165_195_days;SputnikV;41013;16757;57770;2367942;1020468;3388410
2022.03_13-10-2022;Ростовская область;21_45_days;AllVaccines;41626;23834;65460;2367942;1020468;3388410
2022.03_13-10-2022;Ростовская область;21_45_days;CoviVac;656;179;835;2367942;1020468;3388410
2022.03_13-10-2022;Ростовская область;21_45_days;EpiVacCorona;2881;1562;4443;2367942;1020468;3388410
2022.03_13-10-2022;Ростовская область;21_45_days;SputnikLite;7640;2733;10373;2367942;1020468;3388410
2022.03_13-10-2022;Ростовская область;21_45_days;SputnikV;30449;19360;49809;2367942;1020468;3388410
2022.03_13-10-2022;Ростовская область;45_75_days;AllVaccines;118405;54415;172820;2367942;1020468;3388410
2022.03_13-10-2022;Ростовская область;45_75_days;CoviVac;1278;360;1638;2367942;1020468;3388410
2022.03_13-10-2022;Ростовская область;45_75_days;EpiVacCorona;4659;3040;7699;2367942;1020468;3388410
2022.03_13-10-2022;Ростовская область;45_75_days;SputnikLite;48708;14395;63103;2367942;1020468;3388410
2022.03_13-10-2022;Ростовская область;45_75_days;SputnikV;63760;36620;100380;2367942;1020468;3388410
2022.03_13-10-2022;Ростовская область;75_90_days;AllVaccines;47487;18541;66028;2367942;1020468;3388410
2022.03_13-10-2022;Ростовская область;75_90_days;CoviVac;417;141;558;2367942;1020468;3388410
2022.03_13-10-2022;Ростовская область;75_90_days;EpiVacCorona;745;421;1166;2367942;1020468;3388410
2022.03_13-10-2022;Ростовская область;75_90_days;SputnikLite;32226;11476;43702;2367942;1020468;3388410
2022.03_13-10-2022;Ростовская область;75_90_days;SputnikV;14099;6503;20602;2367942;1020468;3388410
2022.03_13-10-2022;Ростовская область;90_105_days;AllVaccines;38793;21999;60792;2367942;1020468;3388410
2022.03_13-10-2022;Ростовская область;90_105_days;CoviVac;225;96;321;2367942;1020468;3388410
2022.03_13-10-2022;Ростовская область;90_105_days;EpiVacCorona;291;193;484;2367942;1020468;3388410
2022.03_13-10-2022;Ростовская область;90_105_days;SputnikLite;13357;8023;21380;2367942;1020468;3388410
2022.03_13-10-2022;Ростовская область;90_105_days;SputnikV;24920;13687;38607;2367942;1020468;3388410
2022.03_13-10-2022;Рязанская область;105_165_days;AllVaccines;151104;62819;213923;600731;301318;902049
2022.03_13-10-2022;Рязанская область;105_165_days;CoviVac;2394;611;3005;600731;301318;902049
2022.03_13-10-2022;Рязанская область;105_165_days;EpiVacCorona;5867;1723;7590;600731;301318;902049
2022.03_13-10-2022;Рязанская область;105_165_days;SputnikLite;20494;21327;41821;600731;301318;902049
2022.03_13-10-2022;Рязанская область;105_165_days;SputnikV;122349;39158;161507;600731;301318;902049
2022.03_13-10-2022;Рязанская область;165_195_days;AllVaccines;28670;13414;42084;600731;301318;902049
2022.03_13-10-2022;Рязанская область;165_195_days;CoviVac;136;28;164;600731;301318;902049
2022.03_13-10-2022;Рязанская область;165_195_days;EpiVacCorona;623;164;787;600731;301318;902049
2022.03_13-10-2022;Рязанская область;165_195_days;SputnikLite;17964;9779;27743;600731;301318;902049
2022.03_13-10-2022;Рязанская область;165_195_days;SputnikV;9947;3443;13390;600731;301318;902049
2022.03_13-10-2022;Рязанская область;21_45_days;AllVaccines;4443;2212;6655;600731;301318;902049
2022.03_13-10-2022;Рязанская область;21_45_days;CoviVac;155;47;202;600731;301318;902049
2022.03_13-10-2022;Рязанская область;21_45_days;EpiVacCorona;117;55;172;600731;301318;902049
2022.03_13-10-2022;Рязанская область;21_45_days;SputnikLite;1193;800;1993;600731;301318;902049
2022.03_13-10-2022;Рязанская область;21_45_days;SputnikV;2978;1310;4288;600731;301318;902049
2022.03_13-10-2022;Рязанская область;45_75_days;AllVaccines;17015;7751;24766;600731;301318;902049
2022.03_13-10-2022;Рязанская область;45_75_days;CoviVac;251;75;326;600731;301318;902049
2022.03_13-10-2022;Рязанская область;45_75_days;EpiVacCorona;343;130;473;600731;301318;902049
2022.03_13-10-2022;Рязанская область;45_75_days;SputnikLite;8138;4309;12447;600731;301318;902049
2022.03_13-10-2022;Рязанская область;45_75_days;SputnikV;8283;3237;11520;600731;301318;902049
2022.03_13-10-2022;Рязанская область;75_90_days;AllVaccines;16229;7696;23925;600731;301318;902049
2022.03_13-10-2022;Рязанская область;75_90_days;CoviVac;185;40;225;600731;301318;902049
2022.03_13-10-2022;Рязанская область;75_90_days;EpiVacCorona;341;138;479;600731;301318;902049
2022.03_13-10-2022;Рязанская область;75_90_days;SputnikLite;11735;6485;18220;600731;301318;902049
2022.03_13-10-2022;Рязанская область;75_90_days;SputnikV;3968;1033;5001;600731;301318;902049
2022.03_13-10-2022;Рязанская область;90_105_days;AllVaccines;12221;6608;18829;600731;301318;902049
2022.03_13-10-2022;Рязанская область;90_105_days;CoviVac;191;54;245;600731;301318;902049
2022.03_13-10-2022;Рязанская область;90_105_days;EpiVacCorona;513;195;708;600731;301318;902049
2022.03_13-10-2022;Рязанская область;90_105_days;SputnikLite;4550;3811;8361;600731;301318;902049
2022.03_13-10-2022;Рязанская область;90_105_days;SputnikV;6967;2548;9515;600731;301318;902049
2022.03_13-10-2022;Самарская область;105_165_days;AllVaccines;357764;188799;546563;1769846;769791;2539637
2022.03_13-10-2022;Самарская область;105_165_days;CoviVac;2263;790;3053;1769846;769791;2539637
2022.03_13-10-2022;Самарская область;105_165_days;EpiVacCorona;5256;3598;8854;1769846;769791;2539637
2022.03_13-10-2022;Самарская область;105_165_days;SputnikLite;67664;55633;123297;1769846;769791;2539637
2022.03_13-10-2022;Самарская область;105_165_days;SputnikV;282581;128778;411359;1769846;769791;2539637
2022.03_13-10-2022;Самарская область;165_195_days;AllVaccines;103330;45348;148678;1769846;769791;2539637
2022.03_13-10-2022;Самарская область;165_195_days;CoviVac;837;262;1099;1769846;769791;2539637
2022.03_13-10-2022;Самарская область;165_195_days;EpiVacCorona;437;693;1130;1769846;769791;2539637
2022.03_13-10-2022;Самарская область;165_195_days;SputnikLite;64743;31426;96169;1769846;769791;2539637
2022.03_13-10-2022;Самарская область;165_195_days;SputnikV;37313;12967;50280;1769846;769791;2539637
2022.03_13-10-2022;Самарская область;21_45_days;AllVaccines;24391;15631;40022;1769846;769791;2539637
2022.03_13-10-2022;Самарская область;21_45_days;CoviVac;308;215;523;1769846;769791;2539637
2022.03_13-10-2022;Самарская область;21_45_days;EpiVacCorona;1140;1352;2492;1769846;769791;2539637
2022.03_13-10-2022;Самарская область;21_45_days;SputnikLite;8758;3915;12673;1769846;769791;2539637
2022.03_13-10-2022;Самарская область;21_45_days;SputnikV;14185;10149;24334;1769846;769791;2539637
2022.03_13-10-2022;Самарская область;45_75_days;AllVaccines;51562;26773;78335;1769846;769791;2539637
2022.03_13-10-2022;Самарская область;45_75_days;CoviVac;678;215;893;1769846;769791;2539637
2022.03_13-10-2022;Самарская область;45_75_days;EpiVacCorona;1420;1502;2922;1769846;769791;2539637
2022.03_13-10-2022;Самарская область;45_75_days;SputnikLite;20730;8015;28745;1769846;769791;2539637
2022.03_13-10-2022;Самарская область;45_75_days;SputnikV;28734;17041;45775;1769846;769791;2539637
2022.03_13-10-2022;Самарская область;75_90_days;AllVaccines;34742;18772;53514;1769846;769791;2539637
2022.03_13-10-2022;Самарская область;75_90_days;CoviVac;267;98;365;1769846;769791;2539637
2022.03_13-10-2022;Самарская область;75_90_days;EpiVacCorona;460;434;894;1769846;769791;2539637
2022.03_13-10-2022;Самарская область;75_90_days;SputnikLite;26335;14231;40566;1769846;769791;2539637
2022.03_13-10-2022;Самарская область;75_90_days;SputnikV;7680;4009;11689;1769846;769791;2539637
2022.03_13-10-2022;Самарская область;90_105_days;AllVaccines;28113;17551;45664;1769846;769791;2539637
2022.03_13-10-2022;Самарская область;90_105_days;CoviVac;242;111;353;1769846;769791;2539637
2022.03_13-10-2022;Самарская область;90_105_days;EpiVacCorona;552;760;1312;1769846;769791;2539637
2022.03_13-10-2022;Самарская область;90_105_days;SputnikLite;12354;9125;21479;1769846;769791;2539637
2022.03_13-10-2022;Самарская область;90_105_days;SputnikV;14965;7555;22520;1769846;769791;2539637
2022.03_13-10-2022;Саратовская область;105_165_days;AllVaccines;273467;118308;391775;1348454;599954;1948408
2022.03_13-10-2022;Саратовская область;105_165_days;CoviVac;2112;410;2522;1348454;599954;1948408
2022.03_13-10-2022;Саратовская область;105_165_days;EpiVacCorona;11906;4624;16530;1348454;599954;1948408
2022.03_13-10-2022;Саратовская область;105_165_days;SputnikLite;56553;36496;93049;1348454;599954;1948408
2022.03_13-10-2022;Саратовская область;105_165_days;SputnikV;202896;76778;279674;1348454;599954;1948408
2022.03_13-10-2022;Саратовская область;165_195_days;AllVaccines;63876;29923;93799;1348454;599954;1948408
2022.03_13-10-2022;Саратовская область;165_195_days;CoviVac;862;195;1057;1348454;599954;1948408
2022.03_13-10-2022;Саратовская область;165_195_days;EpiVacCorona;487;252;739;1348454;599954;1948408
2022.03_13-10-2022;Саратовская область;165_195_days;SputnikLite;42336;17712;60048;1348454;599954;1948408
2022.03_13-10-2022;Саратовская область;165_195_days;SputnikV;20191;11764;31955;1348454;599954;1948408
2022.03_13-10-2022;Саратовская область;21_45_days;AllVaccines;13894;8697;22591;1348454;599954;1948408
2022.03_13-10-2022;Саратовская область;21_45_days;CoviVac;304;190;494;1348454;599954;1948408
2022.03_13-10-2022;Саратовская область;21_45_days;EpiVacCorona;1719;1391;3110;1348454;599954;1948408
2022.03_13-10-2022;Саратовская область;21_45_days;SputnikLite;4557;2458;7015;1348454;599954;1948408
2022.03_13-10-2022;Саратовская область;21_45_days;SputnikV;7314;4658;11972;1348454;599954;1948408
2022.03_13-10-2022;Саратовская область;45_75_days;AllVaccines;42384;22764;65148;1348454;599954;1948408
2022.03_13-10-2022;Саратовская область;45_75_days;CoviVac;729;220;949;1348454;599954;1948408
2022.03_13-10-2022;Саратовская область;45_75_days;EpiVacCorona;2912;2065;4977;1348454;599954;1948408
2022.03_13-10-2022;Саратовская область;45_75_days;SputnikLite;21021;9639;30660;1348454;599954;1948408
2022.03_13-10-2022;Саратовская область;45_75_days;SputnikV;17722;10840;28562;1348454;599954;1948408
2022.03_13-10-2022;Саратовская область;75_90_days;AllVaccines;29297;14386;43683;1348454;599954;1948408
2022.03_13-10-2022;Саратовская область;75_90_days;CoviVac;314;67;381;1348454;599954;1948408
2022.03_13-10-2022;Саратовская область;75_90_days;EpiVacCorona;1146;640;1786;1348454;599954;1948408
2022.03_13-10-2022;Саратовская область;75_90_days;SputnikLite;22903;11191;34094;1348454;599954;1948408
2022.03_13-10-2022;Саратовская область;75_90_days;SputnikV;4934;2488;7422;1348454;599954;1948408
2022.03_13-10-2022;Саратовская область;90_105_days;AllVaccines;20137;11227;31364;1348454;599954;1948408
2022.03_13-10-2022;Саратовская область;90_105_days;CoviVac;379;126;505;1348454;599954;1948408
2022.03_13-10-2022;Саратовская область;90_105_days;EpiVacCorona;1100;575;1675;1348454;599954;1948408
2022.03_13-10-2022;Саратовская область;90_105_days;SputnikLite;8708;5821;14529;1348454;599954;1948408
2022.03_13-10-2022;Саратовская область;90_105_days;SputnikV;9950;4705;14655;1348454;599954;1948408
2022.03_13-10-2022;Сахалинская область;105_165_days;AllVaccines;41915;19670;61585;276677;101794;378471
2022.03_13-10-2022;Сахалинская область;105_165_days;CoviVac;511;83;594;276677;101794;378471
2022.03_13-10-2022;Сахалинская область;105_165_days;EpiVacCorona;3979;1117;5096;276677;101794;378471
2022.03_13-10-2022;Сахалинская область;105_165_days;SputnikLite;18080;13425;31505;276677;101794;378471
2022.03_13-10-2022;Сахалинская область;105_165_days;SputnikV;19345;5045;24390;276677;101794;378471
2022.03_13-10-2022;Сахалинская область;165_195_days;AllVaccines;7352;5903;13255;276677;101794;378471
2022.03_13-10-2022;Сахалинская область;165_195_days;CoviVac;8;4;12;276677;101794;378471
2022.03_13-10-2022;Сахалинская область;165_195_days;EpiVacCorona;73;28;101;276677;101794;378471
2022.03_13-10-2022;Сахалинская область;165_195_days;SputnikLite;4111;5010;9121;276677;101794;378471
2022.03_13-10-2022;Сахалинская область;165_195_days;SputnikV;3160;861;4021;276677;101794;378471
2022.03_13-10-2022;Сахалинская область;21_45_days;AllVaccines;5721;1708;7429;276677;101794;378471
2022.03_13-10-2022;Сахалинская область;21_45_days;CoviVac;59;22;81;276677;101794;378471
2022.03_13-10-2022;Сахалинская область;21_45_days;EpiVacCorona;283;60;343;276677;101794;378471
2022.03_13-10-2022;Сахалинская область;21_45_days;SputnikLite;2892;957;3849;276677;101794;378471
2022.03_13-10-2022;Сахалинская область;21_45_days;SputnikV;2487;669;3156;276677;101794;378471
2022.03_13-10-2022;Сахалинская область;45_75_days;AllVaccines;10074;3245;13319;276677;101794;378471
2022.03_13-10-2022;Сахалинская область;45_75_days;CoviVac;183;43;226;276677;101794;378471
2022.03_13-10-2022;Сахалинская область;45_75_days;EpiVacCorona;543;83;626;276677;101794;378471
2022.03_13-10-2022;Сахалинская область;45_75_days;SputnikLite;6674;2252;8926;276677;101794;378471
2022.03_13-10-2022;Сахалинская область;45_75_days;SputnikV;2674;867;3541;276677;101794;378471
2022.03_13-10-2022;Сахалинская область;75_90_days;AllVaccines;11337;4263;15600;276677;101794;378471
2022.03_13-10-2022;Сахалинская область;75_90_days;CoviVac;75;22;97;276677;101794;378471
2022.03_13-10-2022;Сахалинская область;75_90_days;EpiVacCorona;186;36;222;276677;101794;378471
2022.03_13-10-2022;Сахалинская область;75_90_days;SputnikLite;9688;3876;13564;276677;101794;378471
2022.03_13-10-2022;Сахалинская область;75_90_days;SputnikV;1388;329;1717;276677;101794;378471
2022.03_13-10-2022;Сахалинская область;90_105_days;AllVaccines;5741;2038;7779;276677;101794;378471
2022.03_13-10-2022;Сахалинская область;90_105_days;CoviVac;138;31;169;276677;101794;378471
2022.03_13-10-2022;Сахалинская область;90_105_days;EpiVacCorona;181;65;246;276677;101794;378471
2022.03_13-10-2022;Сахалинская область;90_105_days;SputnikLite;3570;1442;5012;276677;101794;378471
2022.03_13-10-2022;Сахалинская область;90_105_days;SputnikV;1852;500;2352;276677;101794;378471
2022.03_13-10-2022;Свердловская область;105_165_days;AllVaccines;598063;234492;832555;2364046;987486;3351532
2022.03_13-10-2022;Свердловская область;105_165_days;CoviVac;4439;887;5326;2364046;987486;3351532
2022.03_13-10-2022;Свердловская область;105_165_days;EpiVacCorona;13461;5810;19271;2364046;987486;3351532
2022.03_13-10-2022;Свердловская область;105_165_days;SputnikLite;121190;74336;195526;2364046;987486;3351532
2022.03_13-10-2022;Свердловская область;105_165_days;SputnikV;458973;153459;612432;2364046;987486;3351532
2022.03_13-10-2022;Свердловская область;165_195_days;AllVaccines;169463;53697;223160;2364046;987486;3351532
2022.03_13-10-2022;Свердловская область;165_195_days;CoviVac;2598;624;3222;2364046;987486;3351532
2022.03_13-10-2022;Свердловская область;165_195_days;EpiVacCorona;767;348;1115;2364046;987486;3351532
2022.03_13-10-2022;Свердловская область;165_195_days;SputnikLite;117861;35445;153306;2364046;987486;3351532
2022.03_13-10-2022;Свердловская область;165_195_days;SputnikV;48237;17280;65517;2364046;987486;3351532
2022.03_13-10-2022;Свердловская область;21_45_days;AllVaccines;32705;16118;48823;2364046;987486;3351532
2022.03_13-10-2022;Свердловская область;21_45_days;CoviVac;182;39;221;2364046;987486;3351532
2022.03_13-10-2022;Свердловская область;21_45_days;EpiVacCorona;1633;897;2530;2364046;987486;3351532
2022.03_13-10-2022;Свердловская область;21_45_days;SputnikLite;7889;3525;11414;2364046;987486;3351532
2022.03_13-10-2022;Свердловская область;21_45_days;SputnikV;23001;11657;34658;2364046;987486;3351532
2022.03_13-10-2022;Свердловская область;45_75_days;AllVaccines;81352;38376;119728;2364046;987486;3351532
2022.03_13-10-2022;Свердловская область;45_75_days;CoviVac;707;186;893;2364046;987486;3351532
2022.03_13-10-2022;Свердловская область;45_75_days;EpiVacCorona;6253;3026;9279;2364046;987486;3351532
2022.03_13-10-2022;Свердловская область;45_75_days;SputnikLite;36348;15558;51906;2364046;987486;3351532
2022.03_13-10-2022;Свердловская область;45_75_days;SputnikV;38044;19606;57650;2364046;987486;3351532
2022.03_13-10-2022;Свердловская область;75_90_days;AllVaccines;59171;27463;86634;2364046;987486;3351532
2022.03_13-10-2022;Свердловская область;75_90_days;CoviVac;230;60;290;2364046;987486;3351532
2022.03_13-10-2022;Свердловская область;75_90_days;EpiVacCorona;1633;996;2629;2364046;987486;3351532
2022.03_13-10-2022;Свердловская область;75_90_days;SputnikLite;43011;20848;63859;2364046;987486;3351532
2022.03_13-10-2022;Свердловская область;75_90_days;SputnikV;14297;5559;19856;2364046;987486;3351532
2022.03_13-10-2022;Свердловская область;90_105_days;AllVaccines;41600;26538;68138;2364046;987486;3351532
2022.03_13-10-2022;Свердловская область;90_105_days;CoviVac;161;50;211;2364046;987486;3351532
2022.03_13-10-2022;Свердловская область;90_105_days;EpiVacCorona;1767;1285;3052;2364046;987486;3351532
2022.03_13-10-2022;Свердловская область;90_105_days;SputnikLite;16071;12310;28381;2364046;987486;3351532
2022.03_13-10-2022;Свердловская область;90_105_days;SputnikV;23601;12893;36494;2364046;987486;3351532
2022.03_13-10-2022;Смоленская область;105_165_days;AllVaccines;68403;41772;110175;521379;238479;759858
2022.03_13-10-2022;Смоленская область;105_165_days;CoviVac;469;120;589;521379;238479;759858
2022.03_13-10-2022;Смоленская область;105_165_days;EpiVacCorona;1838;964;2802;521379;238479;759858
2022.03_13-10-2022;Смоленская область;105_165_days;SputnikLite;22899;20696;43595;521379;238479;759858
2022.03_13-10-2022;Смоленская область;105_165_days;SputnikV;43197;19992;63189;521379;238479;759858
2022.03_13-10-2022;Смоленская область;165_195_days;AllVaccines;24490;12172;36662;521379;238479;759858
2022.03_13-10-2022;Смоленская область;165_195_days;CoviVac;45;8;53;521379;238479;759858
2022.03_13-10-2022;Смоленская область;165_195_days;EpiVacCorona;152;63;215;521379;238479;759858
2022.03_13-10-2022;Смоленская область;165_195_days;SputnikLite;18039;9267;27306;521379;238479;759858
2022.03_13-10-2022;Смоленская область;165_195_days;SputnikV;6254;2834;9088;521379;238479;759858
2022.03_13-10-2022;Смоленская область;21_45_days;AllVaccines;6055;3129;9184;521379;238479;759858
2022.03_13-10-2022;Смоленская область;21_45_days;CoviVac;131;63;194;521379;238479;759858
2022.03_13-10-2022;Смоленская область;21_45_days;EpiVacCorona;467;249;716;521379;238479;759858
2022.03_13-10-2022;Смоленская область;21_45_days;SputnikLite;987;535;1522;521379;238479;759858
2022.03_13-10-2022;Смоленская область;21_45_days;SputnikV;4470;2282;6752;521379;238479;759858
2022.03_13-10-2022;Смоленская область;45_75_days;AllVaccines;14135;7575;21710;521379;238479;759858
2022.03_13-10-2022;Смоленская область;45_75_days;CoviVac;273;93;366;521379;238479;759858
2022.03_13-10-2022;Смоленская область;45_75_days;EpiVacCorona;1108;683;1791;521379;238479;759858
2022.03_13-10-2022;Смоленская область;45_75_days;SputnikLite;5594;2613;8207;521379;238479;759858
2022.03_13-10-2022;Смоленская область;45_75_days;SputnikV;7160;4186;11346;521379;238479;759858
2022.03_13-10-2022;Смоленская область;75_90_days;AllVaccines;10025;5384;15409;521379;238479;759858
2022.03_13-10-2022;Смоленская область;75_90_days;CoviVac;82;18;100;521379;238479;759858
2022.03_13-10-2022;Смоленская область;75_90_days;EpiVacCorona;588;350;938;521379;238479;759858
2022.03_13-10-2022;Смоленская область;75_90_days;SputnikLite;7387;4259;11646;521379;238479;759858
2022.03_13-10-2022;Смоленская область;75_90_days;SputnikV;1968;757;2725;521379;238479;759858
2022.03_13-10-2022;Смоленская область;90_105_days;AllVaccines;7234;5086;12320;521379;238479;759858
2022.03_13-10-2022;Смоленская область;90_105_days;CoviVac;97;19;116;521379;238479;759858
2022.03_13-10-2022;Смоленская область;90_105_days;EpiVacCorona;418;294;712;521379;238479;759858
2022.03_13-10-2022;Смоленская область;90_105_days;SputnikLite;2997;2754;5751;521379;238479;759858
2022.03_13-10-2022;Смоленская область;90_105_days;SputnikV;3722;2019;5741;521379;238479;759858
2022.03_13-10-2022;Ставропольский край;105_165_days;AllVaccines;284242;104362;388604;1590669;616030;2206699
2022.03_13-10-2022;Ставропольский край;105_165_days;CoviVac;2413;707;3120;1590669;616030;2206699
2022.03_13-10-2022;Ставропольский край;105_165_days;EpiVacCorona;7229;2980;10209;1590669;616030;2206699
2022.03_13-10-2022;Ставропольский край;105_165_days;SputnikLite;71239;37938;109177;1590669;616030;2206699
2022.03_13-10-2022;Ставропольский край;105_165_days;SputnikV;203361;62737;266098;1590669;616030;2206699
2022.03_13-10-2022;Ставропольский край;165_195_days;AllVaccines;54650;30909;85559;1590669;616030;2206699
2022.03_13-10-2022;Ставропольский край;165_195_days;CoviVac;467;170;637;1590669;616030;2206699
2022.03_13-10-2022;Ставропольский край;165_195_days;EpiVacCorona;283;171;454;1590669;616030;2206699
2022.03_13-10-2022;Ставропольский край;165_195_days;SputnikLite;37157;20159;57316;1590669;616030;2206699
2022.03_13-10-2022;Ставропольский край;165_195_days;SputnikV;16743;10409;27152;1590669;616030;2206699
2022.03_13-10-2022;Ставропольский край;21_45_days;AllVaccines;14109;10865;24974;1590669;616030;2206699
2022.03_13-10-2022;Ставропольский край;21_45_days;CoviVac;604;453;1057;1590669;616030;2206699
2022.03_13-10-2022;Ставропольский край;21_45_days;EpiVacCorona;1240;666;1906;1590669;616030;2206699
2022.03_13-10-2022;Ставропольский край;21_45_days;SputnikLite;2085;1309;3394;1590669;616030;2206699
2022.03_13-10-2022;Ставропольский край;21_45_days;SputnikV;10180;8437;18617;1590669;616030;2206699
2022.03_13-10-2022;Ставропольский край;45_75_days;AllVaccines;36690;19219;55909;1590669;616030;2206699
2022.03_13-10-2022;Ставропольский край;45_75_days;CoviVac;550;477;1027;1590669;616030;2206699
2022.03_13-10-2022;Ставропольский край;45_75_days;EpiVacCorona;5154;3670;8824;1590669;616030;2206699
2022.03_13-10-2022;Ставропольский край;45_75_days;SputnikLite;16956;6808;23764;1590669;616030;2206699
2022.03_13-10-2022;Ставропольский край;45_75_days;SputnikV;14030;8264;22294;1590669;616030;2206699
2022.03_13-10-2022;Ставропольский край;75_90_days;AllVaccines;27640;14041;41681;1590669;616030;2206699
2022.03_13-10-2022;Ставропольский край;75_90_days;CoviVac;139;66;205;1590669;616030;2206699
2022.03_13-10-2022;Ставропольский край;75_90_days;EpiVacCorona;1701;937;2638;1590669;616030;2206699
2022.03_13-10-2022;Ставропольский край;75_90_days;SputnikLite;19818;11321;31139;1590669;616030;2206699
2022.03_13-10-2022;Ставропольский край;75_90_days;SputnikV;5982;1717;7699;1590669;616030;2206699
2022.03_13-10-2022;Ставропольский край;90_105_days;AllVaccines;26051;10724;36775;1590669;616030;2206699
2022.03_13-10-2022;Ставропольский край;90_105_days;CoviVac;296;97;393;1590669;616030;2206699
2022.03_13-10-2022;Ставропольский край;90_105_days;EpiVacCorona;1761;598;2359;1590669;616030;2206699
2022.03_13-10-2022;Ставропольский край;90_105_days;SputnikLite;9236;5814;15050;1590669;616030;2206699
2022.03_13-10-2022;Ставропольский край;90_105_days;SputnikV;14758;4215;18973;1590669;616030;2206699
2022.03_13-10-2022;Тамбовская область;105_165_days;AllVaccines;75993;53665;129658;545785;279936;825721
2022.03_13-10-2022;Тамбовская область;105_165_days;CoviVac;1964;413;2377;545785;279936;825721
2022.03_13-10-2022;Тамбовская область;105_165_days;EpiVacCorona;1632;1111;2743;545785;279936;825721
2022.03_13-10-2022;Тамбовская область;105_165_days;SputnikLite;40834;24112;64946;545785;279936;825721
2022.03_13-10-2022;Тамбовская область;105_165_days;SputnikV;31563;28029;59592;545785;279936;825721
2022.03_13-10-2022;Тамбовская область;165_195_days;AllVaccines;30616;17309;47925;545785;279936;825721
2022.03_13-10-2022;Тамбовская область;165_195_days;CoviVac;62;6;68;545785;279936;825721
2022.03_13-10-2022;Тамбовская область;165_195_days;EpiVacCorona;88;198;286;545785;279936;825721
2022.03_13-10-2022;Тамбовская область;165_195_days;SputnikLite;24646;11620;36266;545785;279936;825721
2022.03_13-10-2022;Тамбовская область;165_195_days;SputnikV;5820;5485;11305;545785;279936;825721
2022.03_13-10-2022;Тамбовская область;21_45_days;AllVaccines;11117;7419;18536;545785;279936;825721
2022.03_13-10-2022;Тамбовская область;21_45_days;CoviVac;374;43;417;545785;279936;825721
2022.03_13-10-2022;Тамбовская область;21_45_days;EpiVacCorona;728;571;1299;545785;279936;825721
2022.03_13-10-2022;Тамбовская область;21_45_days;SputnikLite;1137;783;1920;545785;279936;825721
2022.03_13-10-2022;Тамбовская область;21_45_days;SputnikV;8878;6022;14900;545785;279936;825721
2022.03_13-10-2022;Тамбовская область;45_75_days;AllVaccines;25179;15471;40650;545785;279936;825721
2022.03_13-10-2022;Тамбовская область;45_75_days;CoviVac;509;80;589;545785;279936;825721
2022.03_13-10-2022;Тамбовская область;45_75_days;EpiVacCorona;3653;2845;6498;545785;279936;825721
2022.03_13-10-2022;Тамбовская область;45_75_days;SputnikLite;10972;3351;14323;545785;279936;825721
2022.03_13-10-2022;Тамбовская область;45_75_days;SputnikV;10045;9195;19240;545785;279936;825721
2022.03_13-10-2022;Тамбовская область;75_90_days;AllVaccines;16352;7855;24207;545785;279936;825721
2022.03_13-10-2022;Тамбовская область;75_90_days;CoviVac;201;30;231;545785;279936;825721
2022.03_13-10-2022;Тамбовская область;75_90_days;EpiVacCorona;1283;922;2205;545785;279936;825721
2022.03_13-10-2022;Тамбовская область;75_90_days;SputnikLite;11994;4019;16013;545785;279936;825721
2022.03_13-10-2022;Тамбовская область;75_90_days;SputnikV;2874;2884;5758;545785;279936;825721
2022.03_13-10-2022;Тамбовская область;90_105_days;AllVaccines;8995;5759;14754;545785;279936;825721
2022.03_13-10-2022;Тамбовская область;90_105_days;CoviVac;198;29;227;545785;279936;825721
2022.03_13-10-2022;Тамбовская область;90_105_days;EpiVacCorona;412;221;633;545785;279936;825721
2022.03_13-10-2022;Тамбовская область;90_105_days;SputnikLite;4870;2504;7374;545785;279936;825721
2022.03_13-10-2022;Тамбовская область;90_105_days;SputnikV;3515;3005;6520;545785;279936;825721
2022.03_13-10-2022;Тверская область;105_165_days;AllVaccines;91992;59253;151245;681519;330234;1011753
2022.03_13-10-2022;Тверская область;105_165_days;CoviVac;1937;529;2466;681519;330234;1011753
2022.03_13-10-2022;Тверская область;105_165_days;EpiVacCorona;5563;3174;8737;681519;330234;1011753
2022.03_13-10-2022;Тверская область;105_165_days;SputnikLite;28839;27369;56208;681519;330234;1011753
2022.03_13-10-2022;Тверская область;105_165_days;SputnikV;55653;28181;83834;681519;330234;1011753
2022.03_13-10-2022;Тверская область;165_195_days;AllVaccines;26506;20755;47261;681519;330234;1011753
2022.03_13-10-2022;Тверская область;165_195_days;CoviVac;182;51;233;681519;330234;1011753
2022.03_13-10-2022;Тверская область;165_195_days;EpiVacCorona;280;163;443;681519;330234;1011753
2022.03_13-10-2022;Тверская область;165_195_days;SputnikLite;18270;15985;34255;681519;330234;1011753
2022.03_13-10-2022;Тверская область;165_195_days;SputnikV;7774;4556;12330;681519;330234;1011753
2022.03_13-10-2022;Тверская область;21_45_days;AllVaccines;6915;5214;12129;681519;330234;1011753
2022.03_13-10-2022;Тверская область;21_45_days;CoviVac;201;46;247;681519;330234;1011753
2022.03_13-10-2022;Тверская область;21_45_days;EpiVacCorona;253;180;433;681519;330234;1011753
2022.03_13-10-2022;Тверская область;21_45_days;SputnikLite;3320;2915;6235;681519;330234;1011753
2022.03_13-10-2022;Тверская область;21_45_days;SputnikV;3141;2073;5214;681519;330234;1011753
2022.03_13-10-2022;Тверская область;45_75_days;AllVaccines;21157;12065;33222;681519;330234;1011753
2022.03_13-10-2022;Тверская область;45_75_days;CoviVac;538;140;678;681519;330234;1011753
2022.03_13-10-2022;Тверская область;45_75_days;EpiVacCorona;937;752;1689;681519;330234;1011753
2022.03_13-10-2022;Тверская область;45_75_days;SputnikLite;12140;6524;18664;681519;330234;1011753
2022.03_13-10-2022;Тверская область;45_75_days;SputnikV;7542;4649;12191;681519;330234;1011753
2022.03_13-10-2022;Тверская область;75_90_days;AllVaccines;14398;6964;21362;681519;330234;1011753
2022.03_13-10-2022;Тверская область;75_90_days;CoviVac;306;60;366;681519;330234;1011753
2022.03_13-10-2022;Тверская область;75_90_days;EpiVacCorona;341;225;566;681519;330234;1011753
2022.03_13-10-2022;Тверская область;75_90_days;SputnikLite;12071;5933;18004;681519;330234;1011753
2022.03_13-10-2022;Тверская область;75_90_days;SputnikV;1680;746;2426;681519;330234;1011753
2022.03_13-10-2022;Тверская область;90_105_days;AllVaccines;8197;5542;13739;681519;330234;1011753
2022.03_13-10-2022;Тверская область;90_105_days;CoviVac;194;42;236;681519;330234;1011753
2022.03_13-10-2022;Тверская область;90_105_days;EpiVacCorona;602;346;948;681519;330234;1011753
2022.03_13-10-2022;Тверская область;90_105_days;SputnikLite;4344;3624;7968;681519;330234;1011753
2022.03_13-10-2022;Тверская область;90_105_days;SputnikV;3057;1530;4587;681519;330234;1011753
2022.03_13-10-2022;Томская область;105_165_days;AllVaccines;137607;47505;185112;621613;222482;844095
2022.03_13-10-2022;Томская область;105_165_days;CoviVac;3294;438;3732;621613;222482;844095
2022.03_13-10-2022;Томская область;105_165_days;EpiVacCorona;2005;669;2674;621613;222482;844095
2022.03_13-10-2022;Томская область;105_165_days;SputnikLite;39554;24716;64270;621613;222482;844095
2022.03_13-10-2022;Томская область;105_165_days;SputnikV;92754;21682;114436;621613;222482;844095
2022.03_13-10-2022;Томская область;165_195_days;AllVaccines;25409;13063;38472;621613;222482;844095
2022.03_13-10-2022;Томская область;165_195_days;CoviVac;46;8;54;621613;222482;844095
2022.03_13-10-2022;Томская область;165_195_days;EpiVacCorona;117;41;158;621613;222482;844095
2022.03_13-10-2022;Томская область;165_195_days;SputnikLite;19069;10621;29690;621613;222482;844095
2022.03_13-10-2022;Томская область;165_195_days;SputnikV;6177;2393;8570;621613;222482;844095
2022.03_13-10-2022;Томская область;21_45_days;AllVaccines;7465;3640;11105;621613;222482;844095
2022.03_13-10-2022;Томская область;21_45_days;CoviVac;144;9;153;621613;222482;844095
2022.03_13-10-2022;Томская область;21_45_days;EpiVacCorona;383;138;521;621613;222482;844095
2022.03_13-10-2022;Томская область;21_45_days;SputnikLite;2946;1581;4527;621613;222482;844095
2022.03_13-10-2022;Томская область;21_45_days;SputnikV;3992;1912;5904;621613;222482;844095
2022.03_13-10-2022;Томская область;45_75_days;AllVaccines;23437;10916;34353;621613;222482;844095
2022.03_13-10-2022;Томская область;45_75_days;CoviVac;301;36;337;621613;222482;844095
2022.03_13-10-2022;Томская область;45_75_days;EpiVacCorona;1409;579;1988;621613;222482;844095
2022.03_13-10-2022;Томская область;45_75_days;SputnikLite;12863;5662;18525;621613;222482;844095
2022.03_13-10-2022;Томская область;45_75_days;SputnikV;8864;4639;13503;621613;222482;844095
2022.03_13-10-2022;Томская область;75_90_days;AllVaccines;15316;6253;21569;621613;222482;844095
2022.03_13-10-2022;Томская область;75_90_days;CoviVac;135;24;159;621613;222482;844095
2022.03_13-10-2022;Томская область;75_90_days;EpiVacCorona;511;159;670;621613;222482;844095
2022.03_13-10-2022;Томская область;75_90_days;SputnikLite;11368;5319;16687;621613;222482;844095
2022.03_13-10-2022;Томская область;75_90_days;SputnikV;3302;751;4053;621613;222482;844095
2022.03_13-10-2022;Томская область;90_105_days;AllVaccines;11280;5492;16772;621613;222482;844095
2022.03_13-10-2022;Томская область;90_105_days;CoviVac;189;32;221;621613;222482;844095
2022.03_13-10-2022;Томская область;90_105_days;EpiVacCorona;693;331;1024;621613;222482;844095
2022.03_13-10-2022;Томская область;90_105_days;SputnikLite;5102;3511;8613;621613;222482;844095
2022.03_13-10-2022;Томская область;90_105_days;SputnikV;5296;1618;6914;621613;222482;844095
2022.03_13-10-2022;Тульская область;105_165_days;AllVaccines;116587;72235;188822;804510;401385;1205895
2022.03_13-10-2022;Тульская область;105_165_days;CoviVac;1790;662;2452;804510;401385;1205895
2022.03_13-10-2022;Тульская область;105_165_days;EpiVacCorona;5248;4403;9651;804510;401385;1205895
2022.03_13-10-2022;Тульская область;105_165_days;SputnikLite;43989;30295;74284;804510;401385;1205895
2022.03_13-10-2022;Тульская область;105_165_days;SputnikV;65560;36875;102435;804510;401385;1205895
2022.03_13-10-2022;Тульская область;165_195_days;AllVaccines;28638;19557;48195;804510;401385;1205895
2022.03_13-10-2022;Тульская область;165_195_days;CoviVac;334;136;470;804510;401385;1205895
2022.03_13-10-2022;Тульская область;165_195_days;EpiVacCorona;444;398;842;804510;401385;1205895
2022.03_13-10-2022;Тульская область;165_195_days;SputnikLite;19156;13169;32325;804510;401385;1205895
2022.03_13-10-2022;Тульская область;165_195_days;SputnikV;8704;5854;14558;804510;401385;1205895
2022.03_13-10-2022;Тульская область;21_45_days;AllVaccines;13698;5849;19547;804510;401385;1205895
2022.03_13-10-2022;Тульская область;21_45_days;CoviVac;174;22;196;804510;401385;1205895
2022.03_13-10-2022;Тульская область;21_45_days;EpiVacCorona;1065;516;1581;804510;401385;1205895
2022.03_13-10-2022;Тульская область;21_45_days;SputnikLite;1293;570;1863;804510;401385;1205895
2022.03_13-10-2022;Тульская область;21_45_days;SputnikV;11166;4741;15907;804510;401385;1205895
2022.03_13-10-2022;Тульская область;45_75_days;AllVaccines;30716;13540;44256;804510;401385;1205895
2022.03_13-10-2022;Тульская область;45_75_days;CoviVac;457;141;598;804510;401385;1205895
2022.03_13-10-2022;Тульская область;45_75_days;EpiVacCorona;1848;1114;2962;804510;401385;1205895
2022.03_13-10-2022;Тульская область;45_75_days;SputnikLite;15067;5320;20387;804510;401385;1205895
2022.03_13-10-2022;Тульская область;45_75_days;SputnikV;13344;6965;20309;804510;401385;1205895
2022.03_13-10-2022;Тульская область;75_90_days;AllVaccines;25253;10469;35722;804510;401385;1205895
2022.03_13-10-2022;Тульская область;75_90_days;CoviVac;138;54;192;804510;401385;1205895
2022.03_13-10-2022;Тульская область;75_90_days;EpiVacCorona;442;393;835;804510;401385;1205895
2022.03_13-10-2022;Тульская область;75_90_days;SputnikLite;22349;8772;31121;804510;401385;1205895
2022.03_13-10-2022;Тульская область;75_90_days;SputnikV;2324;1250;3574;804510;401385;1205895
2022.03_13-10-2022;Тульская область;90_105_days;AllVaccines;10258;7143;17401;804510;401385;1205895
2022.03_13-10-2022;Тульская область;90_105_days;CoviVac;133;55;188;804510;401385;1205895
2022.03_13-10-2022;Тульская область;90_105_days;EpiVacCorona;420;495;915;804510;401385;1205895
2022.03_13-10-2022;Тульская область;90_105_days;SputnikLite;5131;3803;8934;804510;401385;1205895
2022.03_13-10-2022;Тульская область;90_105_days;SputnikV;4574;2790;7364;804510;401385;1205895
2022.03_13-10-2022;Тюменская область;105_165_days;AllVaccines;200199;76823;277022;870789;301209;1171998
2022.03_13-10-2022;Тюменская область;105_165_days;CoviVac;1598;299;1897;870789;301209;1171998
2022.03_13-10-2022;Тюменская область;105_165_days;EpiVacCorona;1549;453;2002;870789;301209;1171998
2022.03_13-10-2022;Тюменская область;105_165_days;SputnikLite;60174;39243;99417;870789;301209;1171998
2022.03_13-10-2022;Тюменская область;105_165_days;SputnikV;136878;36828;173706;870789;301209;1171998
2022.03_13-10-2022;Тюменская область;165_195_days;AllVaccines;64903;20406;85309;870789;301209;1171998
2022.03_13-10-2022;Тюменская область;165_195_days;CoviVac;103;23;126;870789;301209;1171998
2022.03_13-10-2022;Тюменская область;165_195_days;EpiVacCorona;203;134;337;870789;301209;1171998
2022.03_13-10-2022;Тюменская область;165_195_days;SputnikLite;53456;16802;70258;870789;301209;1171998
2022.03_13-10-2022;Тюменская область;165_195_days;SputnikV;11141;3447;14588;870789;301209;1171998
2022.03_13-10-2022;Тюменская область;21_45_days;AllVaccines;10795;4447;15242;870789;301209;1171998
2022.03_13-10-2022;Тюменская область;21_45_days;CoviVac;101;29;130;870789;301209;1171998
2022.03_13-10-2022;Тюменская область;21_45_days;EpiVacCorona;443;195;638;870789;301209;1171998
2022.03_13-10-2022;Тюменская область;21_45_days;SputnikLite;3392;1079;4471;870789;301209;1171998
2022.03_13-10-2022;Тюменская область;21_45_days;SputnikV;6859;3144;10003;870789;301209;1171998
2022.03_13-10-2022;Тюменская область;45_75_days;AllVaccines;37221;14697;51918;870789;301209;1171998
2022.03_13-10-2022;Тюменская область;45_75_days;CoviVac;262;67;329;870789;301209;1171998
2022.03_13-10-2022;Тюменская область;45_75_days;EpiVacCorona;759;384;1143;870789;301209;1171998
2022.03_13-10-2022;Тюменская область;45_75_days;SputnikLite;22995;8846;31841;870789;301209;1171998
2022.03_13-10-2022;Тюменская область;45_75_days;SputnikV;13205;5400;18605;870789;301209;1171998
2022.03_13-10-2022;Тюменская область;75_90_days;AllVaccines;33062;12497;45559;870789;301209;1171998
2022.03_13-10-2022;Тюменская область;75_90_days;CoviVac;86;17;103;870789;301209;1171998
2022.03_13-10-2022;Тюменская область;75_90_days;EpiVacCorona;73;31;104;870789;301209;1171998
2022.03_13-10-2022;Тюменская область;75_90_days;SputnikLite;28626;11222;39848;870789;301209;1171998
2022.03_13-10-2022;Тюменская область;75_90_days;SputnikV;4277;1227;5504;870789;301209;1171998
2022.03_13-10-2022;Тюменская область;90_105_days;AllVaccines;20058;10061;30119;870789;301209;1171998
2022.03_13-10-2022;Тюменская область;90_105_days;CoviVac;84;28;112;870789;301209;1171998
2022.03_13-10-2022;Тюменская область;90_105_days;EpiVacCorona;55;50;105;870789;301209;1171998
2022.03_13-10-2022;Тюменская область;90_105_days;SputnikLite;12628;7441;20069;870789;301209;1171998
2022.03_13-10-2022;Тюменская область;90_105_days;SputnikV;7291;2542;9833;870789;301209;1171998
2022.03_13-10-2022;Удмуртская Республика;105_165_days;AllVaccines;169063;70702;239765;818861;336450;1155311
2022.03_13-10-2022;Удмуртская Республика;105_165_days;CoviVac;3449;511;3960;818861;336450;1155311
2022.03_13-10-2022;Удмуртская Республика;105_165_days;EpiVacCorona;8432;4182;12614;818861;336450;1155311
2022.03_13-10-2022;Удмуртская Республика;105_165_days;SputnikLite;25339;24061;49400;818861;336450;1155311
2022.03_13-10-2022;Удмуртская Республика;105_165_days;SputnikV;131843;41948;173791;818861;336450;1155311
2022.03_13-10-2022;Удмуртская Республика;165_195_days;AllVaccines;64274;20447;84721;818861;336450;1155311
2022.03_13-10-2022;Удмуртская Республика;165_195_days;CoviVac;48;4;52;818861;336450;1155311
2022.03_13-10-2022;Удмуртская Республика;165_195_days;EpiVacCorona;1985;1351;3336;818861;336450;1155311
2022.03_13-10-2022;Удмуртская Республика;165_195_days;SputnikLite;49210;13290;62500;818861;336450;1155311
2022.03_13-10-2022;Удмуртская Республика;165_195_days;SputnikV;13031;5802;18833;818861;336450;1155311
2022.03_13-10-2022;Удмуртская Республика;21_45_days;AllVaccines;9702;5500;15202;818861;336450;1155311
2022.03_13-10-2022;Удмуртская Республика;21_45_days;CoviVac;274;61;335;818861;336450;1155311
2022.03_13-10-2022;Удмуртская Республика;21_45_days;EpiVacCorona;680;451;1131;818861;336450;1155311
2022.03_13-10-2022;Удмуртская Республика;21_45_days;SputnikLite;2187;1436;3623;818861;336450;1155311
2022.03_13-10-2022;Удмуртская Республика;21_45_days;SputnikV;6561;3552;10113;818861;336450;1155311
2022.03_13-10-2022;Удмуртская Республика;45_75_days;AllVaccines;24947;14787;39734;818861;336450;1155311
2022.03_13-10-2022;Удмуртская Республика;45_75_days;CoviVac;332;69;401;818861;336450;1155311
2022.03_13-10-2022;Удмуртская Республика;45_75_days;EpiVacCorona;1327;1122;2449;818861;336450;1155311
2022.03_13-10-2022;Удмуртская Республика;45_75_days;SputnikLite;11557;6461;18018;818861;336450;1155311
2022.03_13-10-2022;Удмуртская Республика;45_75_days;SputnikV;11731;7135;18866;818861;336450;1155311
2022.03_13-10-2022;Удмуртская Республика;75_90_days;AllVaccines;15602;8566;24168;818861;336450;1155311
2022.03_13-10-2022;Удмуртская Республика;75_90_days;CoviVac;185;38;223;818861;336450;1155311
2022.03_13-10-2022;Удмуртская Республика;75_90_days;EpiVacCorona;563;433;996;818861;336450;1155311
2022.03_13-10-2022;Удмуртская Республика;75_90_days;SputnikLite;10985;6786;17771;818861;336450;1155311
2022.03_13-10-2022;Удмуртская Республика;75_90_days;SputnikV;3869;1309;5178;818861;336450;1155311
2022.03_13-10-2022;Удмуртская Республика;90_105_days;AllVaccines;11946;8382;20328;818861;336450;1155311
2022.03_13-10-2022;Удмуртская Республика;90_105_days;CoviVac;236;48;284;818861;336450;1155311
2022.03_13-10-2022;Удмуртская Республика;90_105_days;EpiVacCorona;499;478;977;818861;336450;1155311
2022.03_13-10-2022;Удмуртская Республика;90_105_days;SputnikLite;5534;5373;10907;818861;336450;1155311
2022.03_13-10-2022;Удмуртская Республика;90_105_days;SputnikV;5677;2483;8160;818861;336450;1155311
2022.03_13-10-2022;Ульяновская область;105_165_days;AllVaccines;127037;65902;192939;672149;320065;992214
2022.03_13-10-2022;Ульяновская область;105_165_days;CoviVac;2378;547;2925;672149;320065;992214
2022.03_13-10-2022;Ульяновская область;105_165_days;EpiVacCorona;3681;1568;5249;672149;320065;992214
2022.03_13-10-2022;Ульяновская область;105_165_days;SputnikLite;27936;27010;54946;672149;320065;992214
2022.03_13-10-2022;Ульяновская область;105_165_days;SputnikV;93042;36777;129819;672149;320065;992214
2022.03_13-10-2022;Ульяновская область;165_195_days;AllVaccines;35719;20545;56264;672149;320065;992214
2022.03_13-10-2022;Ульяновская область;165_195_days;CoviVac;13;3;16;672149;320065;992214
2022.03_13-10-2022;Ульяновская область;165_195_days;EpiVacCorona;273;89;362;672149;320065;992214
2022.03_13-10-2022;Ульяновская область;165_195_days;SputnikLite;23542;16199;39741;672149;320065;992214
2022.03_13-10-2022;Ульяновская область;165_195_days;SputnikV;11891;4254;16145;672149;320065;992214
2022.03_13-10-2022;Ульяновская область;21_45_days;AllVaccines;5633;2868;8501;672149;320065;992214
2022.03_13-10-2022;Ульяновская область;21_45_days;CoviVac;81;27;108;672149;320065;992214
2022.03_13-10-2022;Ульяновская область;21_45_days;EpiVacCorona;414;211;625;672149;320065;992214
2022.03_13-10-2022;Ульяновская область;21_45_days;SputnikLite;1198;598;1796;672149;320065;992214
2022.03_13-10-2022;Ульяновская область;21_45_days;SputnikV;3940;2032;5972;672149;320065;992214
2022.03_13-10-2022;Ульяновская область;45_75_days;AllVaccines;17284;8977;26261;672149;320065;992214
2022.03_13-10-2022;Ульяновская область;45_75_days;CoviVac;217;62;279;672149;320065;992214
2022.03_13-10-2022;Ульяновская область;45_75_days;EpiVacCorona;1046;651;1697;672149;320065;992214
2022.03_13-10-2022;Ульяновская область;45_75_days;SputnikLite;8619;4004;12623;672149;320065;992214
2022.03_13-10-2022;Ульяновская область;45_75_days;SputnikV;7402;4260;11662;672149;320065;992214
2022.03_13-10-2022;Ульяновская область;75_90_days;AllVaccines;14534;7264;21798;672149;320065;992214
2022.03_13-10-2022;Ульяновская область;75_90_days;CoviVac;96;26;122;672149;320065;992214
2022.03_13-10-2022;Ульяновская область;75_90_days;EpiVacCorona;305;175;480;672149;320065;992214
2022.03_13-10-2022;Ульяновская область;75_90_days;SputnikLite;11846;6210;18056;672149;320065;992214
2022.03_13-10-2022;Ульяновская область;75_90_days;SputnikV;2287;853;3140;672149;320065;992214
2022.03_13-10-2022;Ульяновская область;90_105_days;AllVaccines;9755;5851;15606;672149;320065;992214
2022.03_13-10-2022;Ульяновская область;90_105_days;CoviVac;98;26;124;672149;320065;992214
2022.03_13-10-2022;Ульяновская область;90_105_days;EpiVacCorona;391;287;678;672149;320065;992214
2022.03_13-10-2022;Ульяновская область;90_105_days;SputnikLite;4485;3485;7970;672149;320065;992214
2022.03_13-10-2022;Ульяновская область;90_105_days;SputnikV;4781;2053;6834;672149;320065;992214
2022.03_13-10-2022;Хабаровский край;105_165_days;AllVaccines;122048;44563;166611;757169;265178;1022347
2022.03_13-10-2022;Хабаровский край;105_165_days;CoviVac;2533;525;3058;757169;265178;1022347
2022.03_13-10-2022;Хабаровский край;105_165_days;EpiVacCorona;5658;1788;7446;757169;265178;1022347
2022.03_13-10-2022;Хабаровский край;105_165_days;SputnikLite;48456;20391;68847;757169;265178;1022347
2022.03_13-10-2022;Хабаровский край;105_165_days;SputnikV;65401;21859;87260;757169;265178;1022347
2022.03_13-10-2022;Хабаровский край;165_195_days;AllVaccines;22223;11098;33321;757169;265178;1022347
2022.03_13-10-2022;Хабаровский край;165_195_days;CoviVac;15;6;21;757169;265178;1022347
2022.03_13-10-2022;Хабаровский край;165_195_days;EpiVacCorona;1;0;1;757169;265178;1022347
2022.03_13-10-2022;Хабаровский край;165_195_days;SputnikLite;14245;8086;22331;757169;265178;1022347
2022.03_13-10-2022;Хабаровский край;165_195_days;SputnikV;7962;3006;10968;757169;265178;1022347
2022.03_13-10-2022;Хабаровский край;21_45_days;AllVaccines;6981;3211;10192;757169;265178;1022347
2022.03_13-10-2022;Хабаровский край;21_45_days;CoviVac;171;81;252;757169;265178;1022347
2022.03_13-10-2022;Хабаровский край;21_45_days;EpiVacCorona;458;233;691;757169;265178;1022347
2022.03_13-10-2022;Хабаровский край;21_45_days;SputnikLite;1602;677;2279;757169;265178;1022347
2022.03_13-10-2022;Хабаровский край;21_45_days;SputnikV;4750;2220;6970;757169;265178;1022347
2022.03_13-10-2022;Хабаровский край;45_75_days;AllVaccines;26866;12374;39240;757169;265178;1022347
2022.03_13-10-2022;Хабаровский край;45_75_days;CoviVac;403;83;486;757169;265178;1022347
2022.03_13-10-2022;Хабаровский край;45_75_days;EpiVacCorona;1860;809;2669;757169;265178;1022347
2022.03_13-10-2022;Хабаровский край;45_75_days;SputnikLite;12348;4955;17303;757169;265178;1022347
2022.03_13-10-2022;Хабаровский край;45_75_days;SputnikV;12255;6527;18782;757169;265178;1022347
2022.03_13-10-2022;Хабаровский край;75_90_days;AllVaccines;16924;7544;24468;757169;265178;1022347
2022.03_13-10-2022;Хабаровский край;75_90_days;CoviVac;201;41;242;757169;265178;1022347
2022.03_13-10-2022;Хабаровский край;75_90_days;EpiVacCorona;727;285;1012;757169;265178;1022347
2022.03_13-10-2022;Хабаровский край;75_90_days;SputnikLite;11086;5571;16657;757169;265178;1022347
2022.03_13-10-2022;Хабаровский край;75_90_days;SputnikV;4910;1647;6557;757169;265178;1022347
2022.03_13-10-2022;Хабаровский край;90_105_days;AllVaccines;14271;6653;20924;757169;265178;1022347
2022.03_13-10-2022;Хабаровский край;90_105_days;CoviVac;236;38;274;757169;265178;1022347
2022.03_13-10-2022;Хабаровский край;90_105_days;EpiVacCorona;1236;478;1714;757169;265178;1022347
2022.03_13-10-2022;Хабаровский край;90_105_days;SputnikLite;4410;2792;7202;757169;265178;1022347
2022.03_13-10-2022;Хабаровский край;90_105_days;SputnikV;8389;3345;11734;757169;265178;1022347
2022.03_13-10-2022;Ханты-Мансийский автономный округ - Югра;105_165_days;AllVaccines;226934;52320;279254;1019471;240107;1259578
2022.03_13-10-2022;Ханты-Мансийский автономный округ - Югра;105_165_days;CoviVac;1601;280;1881;1019471;240107;1259578
2022.03_13-10-2022;Ханты-Мансийский автономный округ - Югра;105_165_days;EpiVacCorona;2796;940;3736;1019471;240107;1259578
2022.03_13-10-2022;Ханты-Мансийский автономный округ - Югра;105_165_days;SputnikLite;65134;22075;87209;1019471;240107;1259578
2022.03_13-10-2022;Ханты-Мансийский автономный округ - Югра;105_165_days;SputnikV;157403;29025;186428;1019471;240107;1259578
2022.03_13-10-2022;Ханты-Мансийский автономный округ - Югра;165_195_days;AllVaccines;60413;13003;73416;1019471;240107;1259578
2022.03_13-10-2022;Ханты-Мансийский автономный округ - Югра;165_195_days;CoviVac;378;73;451;1019471;240107;1259578
2022.03_13-10-2022;Ханты-Мансийский автономный округ - Югра;165_195_days;EpiVacCorona;160;29;189;1019471;240107;1259578
2022.03_13-10-2022;Ханты-Мансийский автономный округ - Югра;165_195_days;SputnikLite;43888;9947;53835;1019471;240107;1259578
2022.03_13-10-2022;Ханты-Мансийский автономный округ - Югра;165_195_days;SputnikV;15987;2954;18941;1019471;240107;1259578
2022.03_13-10-2022;Ханты-Мансийский автономный округ - Югра;21_45_days;AllVaccines;16626;3170;19796;1019471;240107;1259578
2022.03_13-10-2022;Ханты-Мансийский автономный округ - Югра;21_45_days;CoviVac;185;24;209;1019471;240107;1259578
2022.03_13-10-2022;Ханты-Мансийский автономный округ - Югра;21_45_days;EpiVacCorona;254;59;313;1019471;240107;1259578
2022.03_13-10-2022;Ханты-Мансийский автономный округ - Югра;21_45_days;SputnikLite;6088;1209;7297;1019471;240107;1259578
2022.03_13-10-2022;Ханты-Мансийский автономный округ - Югра;21_45_days;SputnikV;10099;1878;11977;1019471;240107;1259578
2022.03_13-10-2022;Ханты-Мансийский автономный округ - Югра;45_75_days;AllVaccines;45638;8896;54534;1019471;240107;1259578
2022.03_13-10-2022;Ханты-Мансийский автономный округ - Югра;45_75_days;CoviVac;259;50;309;1019471;240107;1259578
2022.03_13-10-2022;Ханты-Мансийский автономный округ - Югра;45_75_days;EpiVacCorona;504;147;651;1019471;240107;1259578
2022.03_13-10-2022;Ханты-Мансийский автономный округ - Югра;45_75_days;SputnikLite;28437;4887;33324;1019471;240107;1259578
2022.03_13-10-2022;Ханты-Мансийский автономный округ - Югра;45_75_days;SputnikV;16438;3812;20250;1019471;240107;1259578
2022.03_13-10-2022;Ханты-Мансийский автономный округ - Югра;75_90_days;AllVaccines;33155;7457;40612;1019471;240107;1259578
2022.03_13-10-2022;Ханты-Мансийский автономный округ - Югра;75_90_days;CoviVac;126;32;158;1019471;240107;1259578
2022.03_13-10-2022;Ханты-Мансийский автономный округ - Югра;75_90_days;EpiVacCorona;327;66;393;1019471;240107;1259578
2022.03_13-10-2022;Ханты-Мансийский автономный округ - Югра;75_90_days;SputnikLite;26998;6299;33297;1019471;240107;1259578
2022.03_13-10-2022;Ханты-Мансийский автономный округ - Югра;75_90_days;SputnikV;5704;1060;6764;1019471;240107;1259578
2022.03_13-10-2022;Ханты-Мансийский автономный округ - Югра;90_105_days;AllVaccines;19219;5360;24579;1019471;240107;1259578
2022.03_13-10-2022;Ханты-Мансийский автономный округ - Югра;90_105_days;CoviVac;121;30;151;1019471;240107;1259578
2022.03_13-10-2022;Ханты-Мансийский автономный округ - Югра;90_105_days;EpiVacCorona;315;136;451;1019471;240107;1259578
2022.03_13-10-2022;Ханты-Мансийский автономный округ - Югра;90_105_days;SputnikLite;10897;3326;14223;1019471;240107;1259578
2022.03_13-10-2022;Ханты-Мансийский автономный округ - Югра;90_105_days;SputnikV;7886;1868;9754;1019471;240107;1259578
2022.03_13-10-2022;Челябинская область;105_165_days;AllVaccines;480183;188456;668639;1901705;795956;2697661
2022.03_13-10-2022;Челябинская область;105_165_days;CoviVac;4452;929;5381;1901705;795956;2697661
2022.03_13-10-2022;Челябинская область;105_165_days;EpiVacCorona;15806;6519;22325;1901705;795956;2697661
2022.03_13-10-2022;Челябинская область;105_165_days;SputnikLite;95070;52812;147882;1901705;795956;2697661
2022.03_13-10-2022;Челябинская область;105_165_days;SputnikV;364855;128196;493051;1901705;795956;2697661
2022.03_13-10-2022;Челябинская область;165_195_days;AllVaccines;113199;39714;152913;1901705;795956;2697661
2022.03_13-10-2022;Челябинская область;165_195_days;CoviVac;1699;539;2238;1901705;795956;2697661
2022.03_13-10-2022;Челябинская область;165_195_days;EpiVacCorona;701;384;1085;1901705;795956;2697661
2022.03_13-10-2022;Челябинская область;165_195_days;SputnikLite;75357;23984;99341;1901705;795956;2697661
2022.03_13-10-2022;Челябинская область;165_195_days;SputnikV;35442;14807;50249;1901705;795956;2697661
2022.03_13-10-2022;Челябинская область;21_45_days;AllVaccines;24715;12789;37504;1901705;795956;2697661
2022.03_13-10-2022;Челябинская область;21_45_days;CoviVac;205;38;243;1901705;795956;2697661
2022.03_13-10-2022;Челябинская область;21_45_days;EpiVacCorona;1057;1289;2346;1901705;795956;2697661
2022.03_13-10-2022;Челябинская область;21_45_days;SputnikLite;10772;5527;16299;1901705;795956;2697661
2022.03_13-10-2022;Челябинская область;21_45_days;SputnikV;12681;5935;18616;1901705;795956;2697661
2022.03_13-10-2022;Челябинская область;45_75_days;AllVaccines;59297;29827;89124;1901705;795956;2697661
2022.03_13-10-2022;Челябинская область;45_75_days;CoviVac;443;103;546;1901705;795956;2697661
2022.03_13-10-2022;Челябинская область;45_75_days;EpiVacCorona;3720;2884;6604;1901705;795956;2697661
2022.03_13-10-2022;Челябинская область;45_75_days;SputnikLite;32218;12749;44967;1901705;795956;2697661
2022.03_13-10-2022;Челябинская область;45_75_days;SputnikV;22916;14091;37007;1901705;795956;2697661
2022.03_13-10-2022;Челябинская область;75_90_days;AllVaccines;43777;21980;65757;1901705;795956;2697661
2022.03_13-10-2022;Челябинская область;75_90_days;CoviVac;179;69;248;1901705;795956;2697661
2022.03_13-10-2022;Челябинская область;75_90_days;EpiVacCorona;978;809;1787;1901705;795956;2697661
2022.03_13-10-2022;Челябинская область;75_90_days;SputnikLite;36157;18355;54512;1901705;795956;2697661
2022.03_13-10-2022;Челябинская область;75_90_days;SputnikV;6463;2747;9210;1901705;795956;2697661
2022.03_13-10-2022;Челябинская область;90_105_days;AllVaccines;28272;17425;45697;1901705;795956;2697661
2022.03_13-10-2022;Челябинская область;90_105_days;CoviVac;239;88;327;1901705;795956;2697661
2022.03_13-10-2022;Челябинская область;90_105_days;EpiVacCorona;980;742;1722;1901705;795956;2697661
2022.03_13-10-2022;Челябинская область;90_105_days;SputnikLite;14099;10001;24100;1901705;795956;2697661
2022.03_13-10-2022;Челябинская область;90_105_days;SputnikV;12954;6594;19548;1901705;795956;2697661
2022.03_13-10-2022;Чеченская Республика;105_165_days;AllVaccines;43219;6019;49238;809759;137234;946993
2022.03_13-10-2022;Чеченская Республика;105_165_days;CoviVac;528;96;624;809759;137234;946993
2022.03_13-10-2022;Чеченская Республика;105_165_days;EpiVacCorona;4078;652;4730;809759;137234;946993
2022.03_13-10-2022;Чеченская Республика;105_165_days;SputnikLite;17528;1587;19115;809759;137234;946993
2022.03_13-10-2022;Чеченская Республика;105_165_days;SputnikV;21085;3684;24769;809759;137234;946993
2022.03_13-10-2022;Чеченская Республика;165_195_days;AllVaccines;33720;6686;40406;809759;137234;946993
2022.03_13-10-2022;Чеченская Республика;165_195_days;CoviVac;470;108;578;809759;137234;946993
2022.03_13-10-2022;Чеченская Республика;165_195_days;EpiVacCorona;930;215;1145;809759;137234;946993
2022.03_13-10-2022;Чеченская Республика;165_195_days;SputnikLite;7978;770;8748;809759;137234;946993
2022.03_13-10-2022;Чеченская Республика;165_195_days;SputnikV;24342;5593;29935;809759;137234;946993
2022.03_13-10-2022;Чеченская Республика;21_45_days;AllVaccines;13259;2613;15872;809759;137234;946993
2022.03_13-10-2022;Чеченская Республика;21_45_days;CoviVac;3260;621;3881;809759;137234;946993
2022.03_13-10-2022;Чеченская Республика;21_45_days;EpiVacCorona;257;29;286;809759;137234;946993
2022.03_13-10-2022;Чеченская Республика;21_45_days;SputnikLite;2388;595;2983;809759;137234;946993
2022.03_13-10-2022;Чеченская Республика;21_45_days;SputnikV;7354;1368;8722;809759;137234;946993
2022.03_13-10-2022;Чеченская Республика;45_75_days;AllVaccines;23769;3011;26780;809759;137234;946993
2022.03_13-10-2022;Чеченская Республика;45_75_days;CoviVac;218;22;240;809759;137234;946993
2022.03_13-10-2022;Чеченская Республика;45_75_days;EpiVacCorona;674;100;774;809759;137234;946993
2022.03_13-10-2022;Чеченская Республика;45_75_days;SputnikLite;17795;2180;19975;809759;137234;946993
2022.03_13-10-2022;Чеченская Республика;45_75_days;SputnikV;5082;709;5791;809759;137234;946993
2022.03_13-10-2022;Чеченская Республика;75_90_days;AllVaccines;13028;1892;14920;809759;137234;946993
2022.03_13-10-2022;Чеченская Республика;75_90_days;CoviVac;15;8;23;809759;137234;946993
2022.03_13-10-2022;Чеченская Республика;75_90_days;EpiVacCorona;282;63;345;809759;137234;946993
2022.03_13-10-2022;Чеченская Республика;75_90_days;SputnikLite;11748;1659;13407;809759;137234;946993
2022.03_13-10-2022;Чеченская Республика;75_90_days;SputnikV;983;162;1145;809759;137234;946993
2022.03_13-10-2022;Чеченская Республика;90_105_days;AllVaccines;5236;597;5833;809759;137234;946993
2022.03_13-10-2022;Чеченская Республика;90_105_days;CoviVac;6;1;7;809759;137234;946993
2022.03_13-10-2022;Чеченская Республика;90_105_days;EpiVacCorona;257;42;299;809759;137234;946993
2022.03_13-10-2022;Чеченская Республика;90_105_days;SputnikLite;4141;441;4582;809759;137234;946993
2022.03_13-10-2022;Чеченская Республика;90_105_days;SputnikV;832;113;945;809759;137234;946993
2022.03_13-10-2022;Чувашская Республика;105_165_days;AllVaccines;135731;60703;196434;674689;275580;950269
2022.03_13-10-2022;Чувашская Республика;105_165_days;CoviVac;2004;280;2284;674689;275580;950269
2022.03_13-10-2022;Чувашская Республика;105_165_days;EpiVacCorona;3753;1125;4878;674689;275580;950269
2022.03_13-10-2022;Чувашская Республика;105_165_days;SputnikLite;22682;22391;45073;674689;275580;950269
2022.03_13-10-2022;Чувашская Республика;105_165_days;SputnikV;107292;36907;144199;674689;275580;950269
2022.03_13-10-2022;Чувашская Республика;165_195_days;AllVaccines;43889;12709;56598;674689;275580;950269
2022.03_13-10-2022;Чувашская Республика;165_195_days;CoviVac;283;63;346;674689;275580;950269
2022.03_13-10-2022;Чувашская Республика;165_195_days;EpiVacCorona;248;99;347;674689;275580;950269
2022.03_13-10-2022;Чувашская Республика;165_195_days;SputnikLite;34221;9590;43811;674689;275580;950269
2022.03_13-10-2022;Чувашская Республика;165_195_days;SputnikV;9137;2957;12094;674689;275580;950269
2022.03_13-10-2022;Чувашская Республика;21_45_days;AllVaccines;7862;4461;12323;674689;275580;950269
2022.03_13-10-2022;Чувашская Республика;21_45_days;CoviVac;148;22;170;674689;275580;950269
2022.03_13-10-2022;Чувашская Республика;21_45_days;EpiVacCorona;645;476;1121;674689;275580;950269
2022.03_13-10-2022;Чувашская Республика;21_45_days;SputnikLite;2526;1183;3709;674689;275580;950269
2022.03_13-10-2022;Чувашская Республика;21_45_days;SputnikV;4543;2780;7323;674689;275580;950269
2022.03_13-10-2022;Чувашская Республика;45_75_days;AllVaccines;26745;12919;39664;674689;275580;950269
2022.03_13-10-2022;Чувашская Республика;45_75_days;CoviVac;447;80;527;674689;275580;950269
2022.03_13-10-2022;Чувашская Республика;45_75_days;EpiVacCorona;1580;724;2304;674689;275580;950269
2022.03_13-10-2022;Чувашская Республика;45_75_days;SputnikLite;13356;6129;19485;674689;275580;950269
2022.03_13-10-2022;Чувашская Республика;45_75_days;SputnikV;11362;5986;17348;674689;275580;950269
2022.03_13-10-2022;Чувашская Республика;75_90_days;AllVaccines;14759;6301;21060;674689;275580;950269
2022.03_13-10-2022;Чувашская Республика;75_90_days;CoviVac;200;33;233;674689;275580;950269
2022.03_13-10-2022;Чувашская Республика;75_90_days;EpiVacCorona;472;248;720;674689;275580;950269
2022.03_13-10-2022;Чувашская Республика;75_90_days;SputnikLite;10058;4587;14645;674689;275580;950269
2022.03_13-10-2022;Чувашская Республика;75_90_days;SputnikV;4029;1433;5462;674689;275580;950269
2022.03_13-10-2022;Чувашская Республика;90_105_days;AllVaccines;13577;6643;20220;674689;275580;950269
2022.03_13-10-2022;Чувашская Республика;90_105_days;CoviVac;252;53;305;674689;275580;950269
2022.03_13-10-2022;Чувашская Республика;90_105_days;EpiVacCorona;327;214;541;674689;275580;950269
2022.03_13-10-2022;Чувашская Республика;90_105_days;SputnikLite;6297;3712;10009;674689;275580;950269
2022.03_13-10-2022;Чувашская Республика;90_105_days;SputnikV;6701;2664;9365;674689;275580;950269
2022.03_13-10-2022;Чукотский автономный округ;105_165_days;AllVaccines;7114;1220;8334;30806;6299;37105
2022.03_13-10-2022;Чукотский автономный округ;105_165_days;CoviVac;598;44;642;30806;6299;37105
2022.03_13-10-2022;Чукотский автономный округ;105_165_days;EpiVacCorona;567;80;647;30806;6299;37105
2022.03_13-10-2022;Чукотский автономный округ;105_165_days;SputnikLite;4997;967;5964;30806;6299;37105
2022.03_13-10-2022;Чукотский автономный округ;105_165_days;SputnikV;952;129;1081;30806;6299;37105
2022.03_13-10-2022;Чукотский автономный округ;165_195_days;AllVaccines;4543;731;5274;30806;6299;37105
2022.03_13-10-2022;Чукотский автономный округ;165_195_days;CoviVac;153;23;176;30806;6299;37105
2022.03_13-10-2022;Чукотский автономный округ;165_195_days;EpiVacCorona;2;1;3;30806;6299;37105
2022.03_13-10-2022;Чукотский автономный округ;165_195_days;SputnikLite;4203;661;4864;30806;6299;37105
2022.03_13-10-2022;Чукотский автономный округ;165_195_days;SputnikV;185;46;231;30806;6299;37105
2022.03_13-10-2022;Чукотский автономный округ;21_45_days;AllVaccines;841;136;977;30806;6299;37105
2022.03_13-10-2022;Чукотский автономный округ;21_45_days;CoviVac;14;1;15;30806;6299;37105
2022.03_13-10-2022;Чукотский автономный округ;21_45_days;EpiVacCorona;30;3;33;30806;6299;37105
2022.03_13-10-2022;Чукотский автономный округ;21_45_days;SputnikLite;545;90;635;30806;6299;37105
2022.03_13-10-2022;Чукотский автономный округ;21_45_days;SputnikV;252;42;294;30806;6299;37105
2022.03_13-10-2022;Чукотский автономный округ;45_75_days;AllVaccines;1528;215;1743;30806;6299;37105
2022.03_13-10-2022;Чукотский автономный округ;45_75_days;CoviVac;61;6;67;30806;6299;37105
2022.03_13-10-2022;Чукотский автономный округ;45_75_days;EpiVacCorona;92;19;111;30806;6299;37105
2022.03_13-10-2022;Чукотский автономный округ;45_75_days;SputnikLite;1039;125;1164;30806;6299;37105
2022.03_13-10-2022;Чукотский автономный округ;45_75_days;SputnikV;336;65;401;30806;6299;37105
2022.03_13-10-2022;Чукотский автономный округ;75_90_days;AllVaccines;1009;142;1151;30806;6299;37105
2022.03_13-10-2022;Чукотский автономный округ;75_90_days;CoviVac;30;5;35;30806;6299;37105
2022.03_13-10-2022;Чукотский автономный округ;75_90_days;EpiVacCorona;42;9;51;30806;6299;37105
2022.03_13-10-2022;Чукотский автономный округ;75_90_days;SputnikLite;889;120;1009;30806;6299;37105
2022.03_13-10-2022;Чукотский автономный округ;75_90_days;SputnikV;48;8;56;30806;6299;37105
2022.03_13-10-2022;Чукотский автономный округ;90_105_days;AllVaccines;632;96;728;30806;6299;37105
2022.03_13-10-2022;Чукотский автономный округ;90_105_days;CoviVac;28;3;31;30806;6299;37105
2022.03_13-10-2022;Чукотский автономный округ;90_105_days;EpiVacCorona;41;1;42;30806;6299;37105
2022.03_13-10-2022;Чукотский автономный округ;90_105_days;SputnikLite;441;68;509;30806;6299;37105
2022.03_13-10-2022;Чукотский автономный округ;90_105_days;SputnikV;122;24;146;30806;6299;37105
2022.03_13-10-2022;Ямало-Ненецкий автономный округ;105_165_days;AllVaccines;69774;8695;78469;346064;56429;402493
2022.03_13-10-2022;Ямало-Ненецкий автономный округ;105_165_days;CoviVac;858;105;963;346064;56429;402493
2022.03_13-10-2022;Ямало-Ненецкий автономный округ;105_165_days;EpiVacCorona;346;42;388;346064;56429;402493
2022.03_13-10-2022;Ямало-Ненецкий автономный округ;105_165_days;SputnikLite;30405;5272;35677;346064;56429;402493
2022.03_13-10-2022;Ямало-Ненецкий автономный округ;105_165_days;SputnikV;38165;3276;41441;346064;56429;402493
2022.03_13-10-2022;Ямало-Ненецкий автономный округ;165_195_days;AllVaccines;24350;3054;27404;346064;56429;402493
2022.03_13-10-2022;Ямало-Ненецкий автономный округ;165_195_days;CoviVac;27;3;30;346064;56429;402493
2022.03_13-10-2022;Ямало-Ненецкий автономный округ;165_195_days;EpiVacCorona;130;13;143;346064;56429;402493
2022.03_13-10-2022;Ямало-Ненецкий автономный округ;165_195_days;SputnikLite;20728;2645;23373;346064;56429;402493
2022.03_13-10-2022;Ямало-Ненецкий автономный округ;165_195_days;SputnikV;3465;393;3858;346064;56429;402493
2022.03_13-10-2022;Ямало-Ненецкий автономный округ;21_45_days;AllVaccines;5832;732;6564;346064;56429;402493
2022.03_13-10-2022;Ямало-Ненецкий автономный округ;21_45_days;CoviVac;46;7;53;346064;56429;402493
2022.03_13-10-2022;Ямало-Ненецкий автономный округ;21_45_days;EpiVacCorona;145;20;165;346064;56429;402493
2022.03_13-10-2022;Ямало-Ненецкий автономный округ;21_45_days;SputnikLite;3562;460;4022;346064;56429;402493
2022.03_13-10-2022;Ямало-Ненецкий автономный округ;21_45_days;SputnikV;2079;245;2324;346064;56429;402493
2022.03_13-10-2022;Ямало-Ненецкий автономный округ;45_75_days;AllVaccines;14087;1809;15896;346064;56429;402493
2022.03_13-10-2022;Ямало-Ненецкий автономный округ;45_75_days;CoviVac;111;9;120;346064;56429;402493
2022.03_13-10-2022;Ямало-Ненецкий автономный округ;45_75_days;EpiVacCorona;254;35;289;346064;56429;402493
2022.03_13-10-2022;Ямало-Ненецкий автономный округ;45_75_days;SputnikLite;9255;1092;10347;346064;56429;402493
2022.03_13-10-2022;Ямало-Ненецкий автономный округ;45_75_days;SputnikV;4467;673;5140;346064;56429;402493
2022.03_13-10-2022;Ямало-Ненецкий автономный округ;75_90_days;AllVaccines;11681;1421;13102;346064;56429;402493
2022.03_13-10-2022;Ямало-Ненецкий автономный округ;75_90_days;CoviVac;73;7;80;346064;56429;402493
2022.03_13-10-2022;Ямало-Ненецкий автономный округ;75_90_days;EpiVacCorona;74;4;78;346064;56429;402493
2022.03_13-10-2022;Ямало-Ненецкий автономный округ;75_90_days;SputnikLite;10059;1259;11318;346064;56429;402493
2022.03_13-10-2022;Ямало-Ненецкий автономный округ;75_90_days;SputnikV;1475;151;1626;346064;56429;402493
2022.03_13-10-2022;Ямало-Ненецкий автономный округ;90_105_days;AllVaccines;5947;780;6727;346064;56429;402493
2022.03_13-10-2022;Ямало-Ненецкий автономный округ;90_105_days;CoviVac;64;19;83;346064;56429;402493
2022.03_13-10-2022;Ямало-Ненецкий автономный округ;90_105_days;EpiVacCorona;48;7;55;346064;56429;402493
2022.03_13-10-2022;Ямало-Ненецкий автономный округ;90_105_days;SputnikLite;3688;520;4208;346064;56429;402493
2022.03_13-10-2022;Ямало-Ненецкий автономный округ;90_105_days;SputnikV;2147;234;2381;346064;56429;402493
2022.03_13-10-2022;Ярославская область;105_165_days;AllVaccines;101230;55955;157185;682586;317712;1000298
2022.03_13-10-2022;Ярославская область;105_165_days;CoviVac;1420;222;1642;682586;317712;1000298
2022.03_13-10-2022;Ярославская область;105_165_days;EpiVacCorona;1802;854;2656;682586;317712;1000298
2022.03_13-10-2022;Ярославская область;105_165_days;SputnikLite;48623;28830;77453;682586;317712;1000298
2022.03_13-10-2022;Ярославская область;105_165_days;SputnikV;49385;26049;75434;682586;317712;1000298
2022.03_13-10-2022;Ярославская область;165_195_days;AllVaccines;33533;16969;50502;682586;317712;1000298
2022.03_13-10-2022;Ярославская область;165_195_days;CoviVac;49;11;60;682586;317712;1000298
2022.03_13-10-2022;Ярославская область;165_195_days;EpiVacCorona;181;86;267;682586;317712;1000298
2022.03_13-10-2022;Ярославская область;165_195_days;SputnikLite;23424;11555;34979;682586;317712;1000298
2022.03_13-10-2022;Ярославская область;165_195_days;SputnikV;9879;5317;15196;682586;317712;1000298
2022.03_13-10-2022;Ярославская область;21_45_days;AllVaccines;6445;3135;9580;682586;317712;1000298
2022.03_13-10-2022;Ярославская область;21_45_days;CoviVac;231;56;287;682586;317712;1000298
2022.03_13-10-2022;Ярославская область;21_45_days;EpiVacCorona;256;106;362;682586;317712;1000298
2022.03_13-10-2022;Ярославская область;21_45_days;SputnikLite;1792;851;2643;682586;317712;1000298
2022.03_13-10-2022;Ярославская область;21_45_days;SputnikV;4166;2122;6288;682586;317712;1000298
2022.03_13-10-2022;Ярославская область;45_75_days;AllVaccines;17037;8377;25414;682586;317712;1000298
2022.03_13-10-2022;Ярославская область;45_75_days;CoviVac;462;87;549;682586;317712;1000298
2022.03_13-10-2022;Ярославская область;45_75_days;EpiVacCorona;770;333;1103;682586;317712;1000298
2022.03_13-10-2022;Ярославская область;45_75_days;SputnikLite;8243;3691;11934;682586;317712;1000298
2022.03_13-10-2022;Ярославская область;45_75_days;SputnikV;7562;4266;11828;682586;317712;1000298
2022.03_13-10-2022;Ярославская область;75_90_days;AllVaccines;13576;6924;20500;682586;317712;1000298
2022.03_13-10-2022;Ярославская область;75_90_days;CoviVac;207;62;269;682586;317712;1000298
2022.03_13-10-2022;Ярославская область;75_90_days;EpiVacCorona;198;81;279;682586;317712;1000298
2022.03_13-10-2022;Ярославская область;75_90_days;SputnikLite;10708;5743;16451;682586;317712;1000298
2022.03_13-10-2022;Ярославская область;75_90_days;SputnikV;2463;1038;3501;682586;317712;1000298
2022.03_13-10-2022;Ярославская область;90_105_days;AllVaccines;10525;6684;17209;682586;317712;1000298
2022.03_13-10-2022;Ярославская область;90_105_days;CoviVac;232;70;302;682586;317712;1000298
2022.03_13-10-2022;Ярославская область;90_105_days;EpiVacCorona;273;144;417;682586;317712;1000298
2022.03_13-10-2022;Ярославская область;90_105_days;SputnikLite;5092;3835;8927;682586;317712;1000298
2022.03_13-10-2022;Ярославская область;90_105_days;SputnikV;4928;2635;7563;682586;317712;1000298
2022.03_13-10-2022;г. Москва;105_165_days;AllVaccines;762422;501179;1263601;7299088;3167729;10466817
2022.03_13-10-2022;г. Москва;105_165_days;CoviVac;32320;4788;37108;7299088;3167729;10466817
2022.03_13-10-2022;г. Москва;105_165_days;EpiVacCorona;2515;1712;4227;7299088;3167729;10466817
2022.03_13-10-2022;г. Москва;105_165_days;SputnikLite;255493;206172;461665;7299088;3167729;10466817
2022.03_13-10-2022;г. Москва;105_165_days;SputnikV;472094;288507;760601;7299088;3167729;10466817
2022.03_13-10-2022;г. Москва;165_195_days;AllVaccines;221693;170835;392528;7299088;3167729;10466817
2022.03_13-10-2022;г. Москва;165_195_days;CoviVac;4156;870;5026;7299088;3167729;10466817
2022.03_13-10-2022;г. Москва;165_195_days;EpiVacCorona;1334;1019;2353;7299088;3167729;10466817
2022.03_13-10-2022;г. Москва;165_195_days;SputnikLite;117344;108652;225996;7299088;3167729;10466817
2022.03_13-10-2022;г. Москва;165_195_days;SputnikV;98859;60294;159153;7299088;3167729;10466817
2022.03_13-10-2022;г. Москва;21_45_days;AllVaccines;51891;23183;75074;7299088;3167729;10466817
2022.03_13-10-2022;г. Москва;21_45_days;CoviVac;1196;108;1304;7299088;3167729;10466817
2022.03_13-10-2022;г. Москва;21_45_days;EpiVacCorona;35;28;63;7299088;3167729;10466817
2022.03_13-10-2022;г. Москва;21_45_days;SputnikLite;12172;4329;16501;7299088;3167729;10466817
2022.03_13-10-2022;г. Москва;21_45_days;SputnikV;38488;18718;57206;7299088;3167729;10466817
2022.03_13-10-2022;г. Москва;45_75_days;AllVaccines;224958;83925;308883;7299088;3167729;10466817
2022.03_13-10-2022;г. Москва;45_75_days;CoviVac;3797;311;4108;7299088;3167729;10466817
2022.03_13-10-2022;г. Москва;45_75_days;EpiVacCorona;272;106;378;7299088;3167729;10466817
2022.03_13-10-2022;г. Москва;45_75_days;SputnikLite;119223;46172;165395;7299088;3167729;10466817
2022.03_13-10-2022;г. Москва;45_75_days;SputnikV;101666;37336;139002;7299088;3167729;10466817
2022.03_13-10-2022;г. Москва;75_90_days;AllVaccines;165799;61398;227197;7299088;3167729;10466817
2022.03_13-10-2022;г. Москва;75_90_days;CoviVac;1823;206;2029;7299088;3167729;10466817
2022.03_13-10-2022;г. Москва;75_90_days;EpiVacCorona;82;40;122;7299088;3167729;10466817
2022.03_13-10-2022;г. Москва;75_90_days;SputnikLite;134459;51068;185527;7299088;3167729;10466817
2022.03_13-10-2022;г. Москва;75_90_days;SputnikV;29435;10084;39519;7299088;3167729;10466817
2022.03_13-10-2022;г. Москва;90_105_days;AllVaccines;97091;45951;143042;7299088;3167729;10466817
2022.03_13-10-2022;г. Москва;90_105_days;CoviVac;1740;238;1978;7299088;3167729;10466817
2022.03_13-10-2022;г. Москва;90_105_days;EpiVacCorona;97;52;149;7299088;3167729;10466817
2022.03_13-10-2022;г. Москва;90_105_days;SputnikLite;55485;26974;82459;7299088;3167729;10466817
2022.03_13-10-2022;г. Москва;90_105_days;SputnikV;39769;18687;58456;7299088;3167729;10466817
2022.03_13-10-2022;г. Санкт-Петербург;105_165_days;AllVaccines;720578;265790;986368;3114778;1306302;4421080
2022.03_13-10-2022;г. Санкт-Петербург;105_165_days;CoviVac;6212;482;6694;3114778;1306302;4421080
2022.03_13-10-2022;г. Санкт-Петербург;105_165_days;EpiVacCorona;7509;3381;10890;3114778;1306302;4421080
2022.03_13-10-2022;г. Санкт-Петербург;105_165_days;SputnikLite;252733;119787;372520;3114778;1306302;4421080
2022.03_13-10-2022;г. Санкт-Петербург;105_165_days;SputnikV;454124;142140;596264;3114778;1306302;4421080
2022.03_13-10-2022;г. Санкт-Петербург;165_195_days;AllVaccines;187100;69616;256716;3114778;1306302;4421080
2022.03_13-10-2022;г. Санкт-Петербург;165_195_days;CoviVac;4347;298;4645;3114778;1306302;4421080
2022.03_13-10-2022;г. Санкт-Петербург;165_195_days;EpiVacCorona;106;55;161;3114778;1306302;4421080
2022.03_13-10-2022;г. Санкт-Петербург;165_195_days;SputnikLite;122287;44430;166717;3114778;1306302;4421080
2022.03_13-10-2022;г. Санкт-Петербург;165_195_days;SputnikV;60360;24833;85193;3114778;1306302;4421080
2022.03_13-10-2022;г. Санкт-Петербург;21_45_days;AllVaccines;32989;15058;48047;3114778;1306302;4421080
2022.03_13-10-2022;г. Санкт-Петербург;21_45_days;CoviVac;533;39;572;3114778;1306302;4421080
2022.03_13-10-2022;г. Санкт-Петербург;21_45_days;EpiVacCorona;371;172;543;3114778;1306302;4421080
2022.03_13-10-2022;г. Санкт-Петербург;21_45_days;SputnikLite;10829;6600;17429;3114778;1306302;4421080
2022.03_13-10-2022;г. Санкт-Петербург;21_45_days;SputnikV;21256;8247;29503;3114778;1306302;4421080
2022.03_13-10-2022;г. Санкт-Петербург;45_75_days;AllVaccines;112554;37411;149965;3114778;1306302;4421080
2022.03_13-10-2022;г. Санкт-Петербург;45_75_days;CoviVac;1940;85;2025;3114778;1306302;4421080
2022.03_13-10-2022;г. Санкт-Петербург;45_75_days;EpiVacCorona;2158;890;3048;3114778;1306302;4421080
2022.03_13-10-2022;г. Санкт-Петербург;45_75_days;SputnikLite;42385;17187;59572;3114778;1306302;4421080
2022.03_13-10-2022;г. Санкт-Петербург;45_75_days;SputnikV;66071;19249;85320;3114778;1306302;4421080
2022.03_13-10-2022;г. Санкт-Петербург;75_90_days;AllVaccines;78283;30866;109149;3114778;1306302;4421080
2022.03_13-10-2022;г. Санкт-Петербург;75_90_days;CoviVac;470;37;507;3114778;1306302;4421080
2022.03_13-10-2022;г. Санкт-Петербург;75_90_days;EpiVacCorona;676;245;921;3114778;1306302;4421080
2022.03_13-10-2022;г. Санкт-Петербург;75_90_days;SputnikLite;50490;23502;73992;3114778;1306302;4421080
2022.03_13-10-2022;г. Санкт-Петербург;75_90_days;SputnikV;26647;7082;33729;3114778;1306302;4421080
2022.03_13-10-2022;г. Санкт-Петербург;90_105_days;AllVaccines;83375;32893;116268;3114778;1306302;4421080
2022.03_13-10-2022;г. Санкт-Петербург;90_105_days;CoviVac;439;44;483;3114778;1306302;4421080
2022.03_13-10-2022;г. Санкт-Петербург;90_105_days;EpiVacCorona;729;365;1094;3114778;1306302;4421080
2022.03_13-10-2022;г. Санкт-Петербург;90_105_days;SputnikLite;35400;16253;51653;3114778;1306302;4421080
2022.03_13-10-2022;г. Санкт-Петербург;90_105_days;SputnikV;46807;16231;63038;3114778;1306302;4421080
2022.03_13-10-2022;г. Севастополь;105_165_days;AllVaccines;69330;26341;95671;293051;116400;409451
2022.03_13-10-2022;г. Севастополь;105_165_days;CoviVac;641;183;824;293051;116400;409451
2022.03_13-10-2022;г. Севастополь;105_165_days;EpiVacCorona;1294;485;1779;293051;116400;409451
2022.03_13-10-2022;г. Севастополь;105_165_days;SputnikLite;16523;14441;30964;293051;116400;409451
2022.03_13-10-2022;г. Севастополь;105_165_days;SputnikV;50872;11232;62104;293051;116400;409451
2022.03_13-10-2022;г. Севастополь;165_195_days;AllVaccines;17926;7652;25578;293051;116400;409451
2022.03_13-10-2022;г. Севастополь;165_195_days;CoviVac;52;12;64;293051;116400;409451
2022.03_13-10-2022;г. Севастополь;165_195_days;EpiVacCorona;185;75;260;293051;116400;409451
2022.03_13-10-2022;г. Севастополь;165_195_days;SputnikLite;11234;6018;17252;293051;116400;409451
2022.03_13-10-2022;г. Севастополь;165_195_days;SputnikV;6455;1547;8002;293051;116400;409451
2022.03_13-10-2022;г. Севастополь;21_45_days;AllVaccines;2367;1505;3872;293051;116400;409451
2022.03_13-10-2022;г. Севастополь;21_45_days;CoviVac;23;10;33;293051;116400;409451
2022.03_13-10-2022;г. Севастополь;21_45_days;EpiVacCorona;23;38;61;293051;116400;409451
2022.03_13-10-2022;г. Севастополь;21_45_days;SputnikLite;1184;772;1956;293051;116400;409451
2022.03_13-10-2022;г. Севастополь;21_45_days;SputnikV;1137;685;1822;293051;116400;409451
2022.03_13-10-2022;г. Севастополь;45_75_days;AllVaccines;7194;3702;10896;293051;116400;409451
2022.03_13-10-2022;г. Севастополь;45_75_days;CoviVac;99;42;141;293051;116400;409451
2022.03_13-10-2022;г. Севастополь;45_75_days;EpiVacCorona;93;127;220;293051;116400;409451
2022.03_13-10-2022;г. Севастополь;45_75_days;SputnikLite;3631;1992;5623;293051;116400;409451
2022.03_13-10-2022;г. Севастополь;45_75_days;SputnikV;3371;1541;4912;293051;116400;409451
2022.03_13-10-2022;г. Севастополь;75_90_days;AllVaccines;7539;3574;11113;293051;116400;409451
2022.03_13-10-2022;г. Севастополь;75_90_days;CoviVac;33;33;66;293051;116400;409451
2022.03_13-10-2022;г. Севастополь;75_90_days;EpiVacCorona;57;31;88;293051;116400;409451
2022.03_13-10-2022;г. Севастополь;75_90_days;SputnikLite;5848;3166;9014;293051;116400;409451
2022.03_13-10-2022;г. Севастополь;75_90_days;SputnikV;1601;344;1945;293051;116400;409451
2022.03_13-10-2022;г. Севастополь;90_105_days;AllVaccines;4917;2932;7849;293051;116400;409451
2022.03_13-10-2022;г. Севастополь;90_105_days;CoviVac;56;23;79;293051;116400;409451
2022.03_13-10-2022;г. Севастополь;90_105_days;EpiVacCorona;74;55;129;293051;116400;409451
2022.03_13-10-2022;г. Севастополь;90_105_days;SputnikLite;2486;2279;4765;293051;116400;409451
2022.03_13-10-2022;г. Севастополь;90_105_days;SputnikV;2301;575;2876;293051;116400;409451
2022.04_13-10-2022;Алтайский край;105_165_days;AllVaccines;159808;96234;256042;1240936;570412;1811348
2022.04_13-10-2022;Алтайский край;105_165_days;CoviVac;1780;406;2186;1240936;570412;1811348
2022.04_13-10-2022;Алтайский край;105_165_days;EpiVacCorona;7195;3386;10581;1240936;570412;1811348
2022.04_13-10-2022;Алтайский край;105_165_days;SputnikLite;64384;43626;108010;1240936;570412;1811348
2022.04_13-10-2022;Алтайский край;105_165_days;SputnikV;86449;48816;135265;1240936;570412;1811348
2022.04_13-10-2022;Алтайский край;165_195_days;AllVaccines;92588;54350;146938;1240936;570412;1811348
2022.04_13-10-2022;Алтайский край;165_195_days;CoviVac;2011;438;2449;1240936;570412;1811348
2022.04_13-10-2022;Алтайский край;165_195_days;EpiVacCorona;7592;3850;11442;1240936;570412;1811348
2022.04_13-10-2022;Алтайский край;165_195_days;SputnikLite;34854;22201;57055;1240936;570412;1811348
2022.04_13-10-2022;Алтайский край;165_195_days;SputnikV;48131;27861;75992;1240936;570412;1811348
2022.04_13-10-2022;Алтайский край;21_45_days;AllVaccines;7221;5463;12684;1240936;570412;1811348
2022.04_13-10-2022;Алтайский край;21_45_days;CoviVac;594;207;801;1240936;570412;1811348
2022.04_13-10-2022;Алтайский край;21_45_days;EpiVacCorona;836;648;1484;1240936;570412;1811348
2022.04_13-10-2022;Алтайский край;21_45_days;SputnikLite;780;439;1219;1240936;570412;1811348
2022.04_13-10-2022;Алтайский край;21_45_days;SputnikV;5011;4169;9180;1240936;570412;1811348
2022.04_13-10-2022;Алтайский край;45_75_days;AllVaccines;13669;7644;21313;1240936;570412;1811348
2022.04_13-10-2022;Алтайский край;45_75_days;CoviVac;706;292;998;1240936;570412;1811348
2022.04_13-10-2022;Алтайский край;45_75_days;EpiVacCorona;1409;820;2229;1240936;570412;1811348
2022.04_13-10-2022;Алтайский край;45_75_days;SputnikLite;2555;1211;3766;1240936;570412;1811348
2022.04_13-10-2022;Алтайский край;45_75_days;SputnikV;8999;5321;14320;1240936;570412;1811348
2022.04_13-10-2022;Алтайский край;75_90_days;AllVaccines;28431;14645;43076;1240936;570412;1811348
2022.04_13-10-2022;Алтайский край;75_90_days;CoviVac;209;67;276;1240936;570412;1811348
2022.04_13-10-2022;Алтайский край;75_90_days;EpiVacCorona;923;505;1428;1240936;570412;1811348
2022.04_13-10-2022;Алтайский край;75_90_days;SputnikLite;16189;6792;22981;1240936;570412;1811348
2022.04_13-10-2022;Алтайский край;75_90_days;SputnikV;11110;7281;18391;1240936;570412;1811348
2022.04_13-10-2022;Алтайский край;90_105_days;AllVaccines;26380;15522;41902;1240936;570412;1811348
2022.04_13-10-2022;Алтайский край;90_105_days;CoviVac;261;93;354;1240936;570412;1811348
2022.04_13-10-2022;Алтайский край;90_105_days;EpiVacCorona;1203;854;2057;1240936;570412;1811348
2022.04_13-10-2022;Алтайский край;90_105_days;SputnikLite;14916;6943;21859;1240936;570412;1811348
2022.04_13-10-2022;Алтайский край;90_105_days;SputnikV;10000;7632;17632;1240936;570412;1811348
2022.04_13-10-2022;Амурская область;105_165_days;AllVaccines;68849;22635;91484;444961;159780;604741
2022.04_13-10-2022;Амурская область;105_165_days;CoviVac;625;168;793;444961;159780;604741
2022.04_13-10-2022;Амурская область;105_165_days;EpiVacCorona;4963;1703;6666;444961;159780;604741
2022.04_13-10-2022;Амурская область;105_165_days;SputnikLite;23481;10649;34130;444961;159780;604741
2022.04_13-10-2022;Амурская область;105_165_days;SputnikV;39780;10115;49895;444961;159780;604741
2022.04_13-10-2022;Амурская область;165_195_days;AllVaccines;45348;18483;63831;444961;159780;604741
2022.04_13-10-2022;Амурская область;165_195_days;CoviVac;1229;337;1566;444961;159780;604741
2022.04_13-10-2022;Амурская область;165_195_days;EpiVacCorona;3315;1436;4751;444961;159780;604741
2022.04_13-10-2022;Амурская область;165_195_days;SputnikLite;16469;8784;25253;444961;159780;604741
2022.04_13-10-2022;Амурская область;165_195_days;SputnikV;24335;7926;32261;444961;159780;604741
2022.04_13-10-2022;Амурская область;21_45_days;AllVaccines;3905;1510;5415;444961;159780;604741
2022.04_13-10-2022;Амурская область;21_45_days;CoviVac;54;8;62;444961;159780;604741
2022.04_13-10-2022;Амурская область;21_45_days;EpiVacCorona;422;168;590;444961;159780;604741
2022.04_13-10-2022;Амурская область;21_45_days;SputnikLite;1637;553;2190;444961;159780;604741
2022.04_13-10-2022;Амурская область;21_45_days;SputnikV;1792;781;2573;444961;159780;604741
2022.04_13-10-2022;Амурская область;45_75_days;AllVaccines;9754;2693;12447;444961;159780;604741
2022.04_13-10-2022;Амурская область;45_75_days;CoviVac;106;17;123;444961;159780;604741
2022.04_13-10-2022;Амурская область;45_75_days;EpiVacCorona;560;269;829;444961;159780;604741
2022.04_13-10-2022;Амурская область;45_75_days;SputnikLite;5418;1319;6737;444961;159780;604741
2022.04_13-10-2022;Амурская область;45_75_days;SputnikV;3670;1088;4758;444961;159780;604741
2022.04_13-10-2022;Амурская область;75_90_days;AllVaccines;9333;2940;12273;444961;159780;604741
2022.04_13-10-2022;Амурская область;75_90_days;CoviVac;155;32;187;444961;159780;604741
2022.04_13-10-2022;Амурская область;75_90_days;EpiVacCorona;585;221;806;444961;159780;604741
2022.04_13-10-2022;Амурская область;75_90_days;SputnikLite;4133;1237;5370;444961;159780;604741
2022.04_13-10-2022;Амурская область;75_90_days;SputnikV;4460;1450;5910;444961;159780;604741
2022.04_13-10-2022;Амурская область;90_105_days;AllVaccines;13874;4095;17969;444961;159780;604741
2022.04_13-10-2022;Амурская область;90_105_days;CoviVac;158;28;186;444961;159780;604741
2022.04_13-10-2022;Амурская область;90_105_days;EpiVacCorona;729;284;1013;444961;159780;604741
2022.04_13-10-2022;Амурская область;90_105_days;SputnikLite;8413;2332;10745;444961;159780;604741
2022.04_13-10-2022;Амурская область;90_105_days;SputnikV;4574;1451;6025;444961;159780;604741
2022.04_13-10-2022;Архангельская область;105_165_days;AllVaccines;66965;45505;112470;595439;264499;859938
2022.04_13-10-2022;Архангельская область;105_165_days;CoviVac;989;127;1116;595439;264499;859938
2022.04_13-10-2022;Архангельская область;105_165_days;EpiVacCorona;3282;1739;5021;595439;264499;859938
2022.04_13-10-2022;Архангельская область;105_165_days;SputnikLite;26106;22095;48201;595439;264499;859938
2022.04_13-10-2022;Архангельская область;105_165_days;SputnikV;36588;21544;58132;595439;264499;859938
2022.04_13-10-2022;Архангельская область;165_195_days;AllVaccines;53264;26914;80178;595439;264499;859938
2022.04_13-10-2022;Архангельская область;165_195_days;CoviVac;1011;192;1203;595439;264499;859938
2022.04_13-10-2022;Архангельская область;165_195_days;EpiVacCorona;3462;1359;4821;595439;264499;859938
2022.04_13-10-2022;Архангельская область;165_195_days;SputnikLite;19532;12197;31729;595439;264499;859938
2022.04_13-10-2022;Архангельская область;165_195_days;SputnikV;29259;13166;42425;595439;264499;859938
2022.04_13-10-2022;Архангельская область;21_45_days;AllVaccines;4642;3727;8369;595439;264499;859938
2022.04_13-10-2022;Архангельская область;21_45_days;CoviVac;151;90;241;595439;264499;859938
2022.04_13-10-2022;Архангельская область;21_45_days;EpiVacCorona;323;263;586;595439;264499;859938
2022.04_13-10-2022;Архангельская область;21_45_days;SputnikLite;726;599;1325;595439;264499;859938
2022.04_13-10-2022;Архангельская область;21_45_days;SputnikV;3442;2775;6217;595439;264499;859938
2022.04_13-10-2022;Архангельская область;45_75_days;AllVaccines;8158;5447;13605;595439;264499;859938
2022.04_13-10-2022;Архангельская область;45_75_days;CoviVac;176;33;209;595439;264499;859938
2022.04_13-10-2022;Архангельская область;45_75_days;EpiVacCorona;533;598;1131;595439;264499;859938
2022.04_13-10-2022;Архангельская область;45_75_days;SputnikLite;1132;820;1952;595439;264499;859938
2022.04_13-10-2022;Архангельская область;45_75_days;SputnikV;6317;3996;10313;595439;264499;859938
2022.04_13-10-2022;Архангельская область;75_90_days;AllVaccines;6789;3857;10646;595439;264499;859938
2022.04_13-10-2022;Архангельская область;75_90_days;CoviVac;125;25;150;595439;264499;859938
2022.04_13-10-2022;Архангельская область;75_90_days;EpiVacCorona;285;185;470;595439;264499;859938
2022.04_13-10-2022;Архангельская область;75_90_days;SputnikLite;1911;852;2763;595439;264499;859938
2022.04_13-10-2022;Архангельская область;75_90_days;SputnikV;4468;2795;7263;595439;264499;859938
2022.04_13-10-2022;Архангельская область;90_105_days;AllVaccines;7444;4257;11701;595439;264499;859938
2022.04_13-10-2022;Архангельская область;90_105_days;CoviVac;117;16;133;595439;264499;859938
2022.04_13-10-2022;Архангельская область;90_105_days;EpiVacCorona;303;235;538;595439;264499;859938
2022.04_13-10-2022;Архангельская область;90_105_days;SputnikLite;3351;1846;5197;595439;264499;859938
2022.04_13-10-2022;Архангельская область;90_105_days;SputnikV;3673;2160;5833;595439;264499;859938
2022.04_13-10-2022;Астраханская область;105_165_days;AllVaccines;66728;24116;90844;550968;219749;770717
2022.04_13-10-2022;Астраханская область;105_165_days;CoviVac;971;318;1289;550968;219749;770717
2022.04_13-10-2022;Астраханская область;105_165_days;EpiVacCorona;3176;1104;4280;550968;219749;770717
2022.04_13-10-2022;Астраханская область;105_165_days;SputnikLite;26335;11615;37950;550968;219749;770717
2022.04_13-10-2022;Астраханская область;105_165_days;SputnikV;36246;11079;47325;550968;219749;770717
2022.04_13-10-2022;Астраханская область;165_195_days;AllVaccines;47028;17728;64756;550968;219749;770717
2022.04_13-10-2022;Астраханская область;165_195_days;CoviVac;517;224;741;550968;219749;770717
2022.04_13-10-2022;Астраханская область;165_195_days;EpiVacCorona;2100;747;2847;550968;219749;770717
2022.04_13-10-2022;Астраханская область;165_195_days;SputnikLite;17539;8672;26211;550968;219749;770717
2022.04_13-10-2022;Астраханская область;165_195_days;SputnikV;26872;8085;34957;550968;219749;770717
2022.04_13-10-2022;Астраханская область;21_45_days;AllVaccines;4391;2147;6538;550968;219749;770717
2022.04_13-10-2022;Астраханская область;21_45_days;CoviVac;64;20;84;550968;219749;770717
2022.04_13-10-2022;Астраханская область;21_45_days;EpiVacCorona;115;80;195;550968;219749;770717
2022.04_13-10-2022;Астраханская область;21_45_days;SputnikLite;2627;1096;3723;550968;219749;770717
2022.04_13-10-2022;Астраханская область;21_45_days;SputnikV;1585;951;2536;550968;219749;770717
2022.04_13-10-2022;Астраханская область;45_75_days;AllVaccines;10470;3934;14404;550968;219749;770717
2022.04_13-10-2022;Астраханская область;45_75_days;CoviVac;112;25;137;550968;219749;770717
2022.04_13-10-2022;Астраханская область;45_75_days;EpiVacCorona;217;61;278;550968;219749;770717
2022.04_13-10-2022;Астраханская область;45_75_days;SputnikLite;4985;2013;6998;550968;219749;770717
2022.04_13-10-2022;Астраханская область;45_75_days;SputnikV;5156;1835;6991;550968;219749;770717
2022.04_13-10-2022;Астраханская область;75_90_days;AllVaccines;9190;3470;12660;550968;219749;770717
2022.04_13-10-2022;Астраханская область;75_90_days;CoviVac;147;108;255;550968;219749;770717
2022.04_13-10-2022;Астраханская область;75_90_days;EpiVacCorona;407;162;569;550968;219749;770717
2022.04_13-10-2022;Астраханская область;75_90_days;SputnikLite;4288;1342;5630;550968;219749;770717
2022.04_13-10-2022;Астраханская область;75_90_days;SputnikV;4348;1858;6206;550968;219749;770717
2022.04_13-10-2022;Астраханская область;90_105_days;AllVaccines;11443;4467;15910;550968;219749;770717
2022.04_13-10-2022;Астраханская область;90_105_days;CoviVac;107;49;156;550968;219749;770717
2022.04_13-10-2022;Астраханская область;90_105_days;EpiVacCorona;81;36;117;550968;219749;770717
2022.04_13-10-2022;Астраханская область;90_105_days;SputnikLite;6619;2061;8680;550968;219749;770717
2022.04_13-10-2022;Астраханская область;90_105_days;SputnikV;4636;2321;6957;550968;219749;770717
2022.04_13-10-2022;Белгородская область;105_165_days;AllVaccines;154181;64479;218660;867731;383871;1251602
2022.04_13-10-2022;Белгородская область;105_165_days;CoviVac;856;314;1170;867731;383871;1251602
2022.04_13-10-2022;Белгородская область;105_165_days;EpiVacCorona;1329;629;1958;867731;383871;1251602
2022.04_13-10-2022;Белгородская область;105_165_days;SputnikLite;80076;39292;119368;867731;383871;1251602
2022.04_13-10-2022;Белгородская область;105_165_days;SputnikV;71920;24244;96164;867731;383871;1251602
2022.04_13-10-2022;Белгородская область;165_195_days;AllVaccines;93762;48807;142569;867731;383871;1251602
2022.04_13-10-2022;Белгородская область;165_195_days;CoviVac;994;378;1372;867731;383871;1251602
2022.04_13-10-2022;Белгородская область;165_195_days;EpiVacCorona;1417;677;2094;867731;383871;1251602
2022.04_13-10-2022;Белгородская область;165_195_days;SputnikLite;43913;27341;71254;867731;383871;1251602
2022.04_13-10-2022;Белгородская область;165_195_days;SputnikV;47438;20411;67849;867731;383871;1251602
2022.04_13-10-2022;Белгородская область;21_45_days;AllVaccines;4364;3019;7383;867731;383871;1251602
2022.04_13-10-2022;Белгородская область;21_45_days;CoviVac;91;67;158;867731;383871;1251602
2022.04_13-10-2022;Белгородская область;21_45_days;EpiVacCorona;315;252;567;867731;383871;1251602
2022.04_13-10-2022;Белгородская область;21_45_days;SputnikLite;705;412;1117;867731;383871;1251602
2022.04_13-10-2022;Белгородская область;21_45_days;SputnikV;3253;2288;5541;867731;383871;1251602
2022.04_13-10-2022;Белгородская область;45_75_days;AllVaccines;9178;4262;13440;867731;383871;1251602
2022.04_13-10-2022;Белгородская область;45_75_days;CoviVac;213;69;282;867731;383871;1251602
2022.04_13-10-2022;Белгородская область;45_75_days;EpiVacCorona;380;198;578;867731;383871;1251602
2022.04_13-10-2022;Белгородская область;45_75_days;SputnikLite;4715;2326;7041;867731;383871;1251602
2022.04_13-10-2022;Белгородская область;45_75_days;SputnikV;3870;1669;5539;867731;383871;1251602
2022.04_13-10-2022;Белгородская область;75_90_days;AllVaccines;13620;5319;18939;867731;383871;1251602
2022.04_13-10-2022;Белгородская область;75_90_days;CoviVac;163;37;200;867731;383871;1251602
2022.04_13-10-2022;Белгородская область;75_90_days;EpiVacCorona;228;74;302;867731;383871;1251602
2022.04_13-10-2022;Белгородская область;75_90_days;SputnikLite;8626;3559;12185;867731;383871;1251602
2022.04_13-10-2022;Белгородская область;75_90_days;SputnikV;4603;1649;6252;867731;383871;1251602
2022.04_13-10-2022;Белгородская область;90_105_days;AllVaccines;23617;8123;31740;867731;383871;1251602
2022.04_13-10-2022;Белгородская область;90_105_days;CoviVac;164;65;229;867731;383871;1251602
2022.04_13-10-2022;Белгородская область;90_105_days;EpiVacCorona;217;107;324;867731;383871;1251602
2022.04_13-10-2022;Белгородская область;90_105_days;SputnikLite;16821;5657;22478;867731;383871;1251602
2022.04_13-10-2022;Белгородская область;90_105_days;SputnikV;6415;2294;8709;867731;383871;1251602
2022.04_13-10-2022;Брянская область;105_165_days;AllVaccines;77001;45871;122872;659625;298625;958250
2022.04_13-10-2022;Брянская область;105_165_days;CoviVac;1487;418;1905;659625;298625;958250
2022.04_13-10-2022;Брянская область;105_165_days;EpiVacCorona;4913;2472;7385;659625;298625;958250
2022.04_13-10-2022;Брянская область;105_165_days;SputnikLite;31826;22575;54401;659625;298625;958250
2022.04_13-10-2022;Брянская область;105_165_days;SputnikV;38775;20406;59181;659625;298625;958250
2022.04_13-10-2022;Брянская область;165_195_days;AllVaccines;50790;31485;82275;659625;298625;958250
2022.04_13-10-2022;Брянская область;165_195_days;CoviVac;1247;355;1602;659625;298625;958250
2022.04_13-10-2022;Брянская область;165_195_days;EpiVacCorona;4117;1792;5909;659625;298625;958250
2022.04_13-10-2022;Брянская область;165_195_days;SputnikLite;15552;12081;27633;659625;298625;958250
2022.04_13-10-2022;Брянская область;165_195_days;SputnikV;29874;17257;47131;659625;298625;958250
2022.04_13-10-2022;Брянская область;21_45_days;AllVaccines;2554;1882;4436;659625;298625;958250
2022.04_13-10-2022;Брянская область;21_45_days;CoviVac;126;61;187;659625;298625;958250
2022.04_13-10-2022;Брянская область;21_45_days;EpiVacCorona;105;40;145;659625;298625;958250
2022.04_13-10-2022;Брянская область;21_45_days;SputnikLite;886;776;1662;659625;298625;958250
2022.04_13-10-2022;Брянская область;21_45_days;SputnikV;1437;1005;2442;659625;298625;958250
2022.04_13-10-2022;Брянская область;45_75_days;AllVaccines;5821;3404;9225;659625;298625;958250
2022.04_13-10-2022;Брянская область;45_75_days;CoviVac;130;40;170;659625;298625;958250
2022.04_13-10-2022;Брянская область;45_75_days;EpiVacCorona;178;99;277;659625;298625;958250
2022.04_13-10-2022;Брянская область;45_75_days;SputnikLite;2002;1361;3363;659625;298625;958250
2022.04_13-10-2022;Брянская область;45_75_days;SputnikV;3511;1904;5415;659625;298625;958250
2022.04_13-10-2022;Брянская область;75_90_days;AllVaccines;7192;3941;11133;659625;298625;958250
2022.04_13-10-2022;Брянская область;75_90_days;CoviVac;109;42;151;659625;298625;958250
2022.04_13-10-2022;Брянская область;75_90_days;EpiVacCorona;228;105;333;659625;298625;958250
2022.04_13-10-2022;Брянская область;75_90_days;SputnikLite;2679;1457;4136;659625;298625;958250
2022.04_13-10-2022;Брянская область;75_90_days;SputnikV;4176;2337;6513;659625;298625;958250
2022.04_13-10-2022;Брянская область;90_105_days;AllVaccines;10875;6182;17057;659625;298625;958250
2022.04_13-10-2022;Брянская область;90_105_days;CoviVac;236;55;291;659625;298625;958250
2022.04_13-10-2022;Брянская область;90_105_days;EpiVacCorona;284;160;444;659625;298625;958250
2022.04_13-10-2022;Брянская область;90_105_days;SputnikLite;6405;3412;9817;659625;298625;958250
2022.04_13-10-2022;Брянская область;90_105_days;SputnikV;3950;2555;6505;659625;298625;958250
2022.04_13-10-2022;Владимирская область;105_165_days;AllVaccines;82212;44061;126273;739166;354521;1093687
2022.04_13-10-2022;Владимирская область;105_165_days;CoviVac;938;288;1226;739166;354521;1093687
2022.04_13-10-2022;Владимирская область;105_165_days;EpiVacCorona;5149;3131;8280;739166;354521;1093687
2022.04_13-10-2022;Владимирская область;105_165_days;SputnikLite;28672;20958;49630;739166;354521;1093687
2022.04_13-10-2022;Владимирская область;105_165_days;SputnikV;47453;19684;67137;739166;354521;1093687
2022.04_13-10-2022;Владимирская область;165_195_days;AllVaccines;68070;35360;103430;739166;354521;1093687
2022.04_13-10-2022;Владимирская область;165_195_days;CoviVac;1688;381;2069;739166;354521;1093687
2022.04_13-10-2022;Владимирская область;165_195_days;EpiVacCorona;3341;1660;5001;739166;354521;1093687
2022.04_13-10-2022;Владимирская область;165_195_days;SputnikLite;30635;18915;49550;739166;354521;1093687
2022.04_13-10-2022;Владимирская область;165_195_days;SputnikV;32406;14404;46810;739166;354521;1093687
2022.04_13-10-2022;Владимирская область;21_45_days;AllVaccines;2160;1922;4082;739166;354521;1093687
2022.04_13-10-2022;Владимирская область;21_45_days;CoviVac;102;38;140;739166;354521;1093687
2022.04_13-10-2022;Владимирская область;21_45_days;EpiVacCorona;111;118;229;739166;354521;1093687
2022.04_13-10-2022;Владимирская область;21_45_days;SputnikLite;390;372;762;739166;354521;1093687
2022.04_13-10-2022;Владимирская область;21_45_days;SputnikV;1557;1394;2951;739166;354521;1093687
2022.04_13-10-2022;Владимирская область;45_75_days;AllVaccines;4857;2905;7762;739166;354521;1093687
2022.04_13-10-2022;Владимирская область;45_75_days;CoviVac;133;70;203;739166;354521;1093687
2022.04_13-10-2022;Владимирская область;45_75_days;EpiVacCorona;252;182;434;739166;354521;1093687
2022.04_13-10-2022;Владимирская область;45_75_days;SputnikLite;1189;885;2074;739166;354521;1093687
2022.04_13-10-2022;Владимирская область;45_75_days;SputnikV;3283;1768;5051;739166;354521;1093687
2022.04_13-10-2022;Владимирская область;75_90_days;AllVaccines;6092;3360;9452;739166;354521;1093687
2022.04_13-10-2022;Владимирская область;75_90_days;CoviVac;91;21;112;739166;354521;1093687
2022.04_13-10-2022;Владимирская область;75_90_days;EpiVacCorona;251;92;343;739166;354521;1093687
2022.04_13-10-2022;Владимирская область;75_90_days;SputnikLite;2625;1487;4112;739166;354521;1093687
2022.04_13-10-2022;Владимирская область;75_90_days;SputnikV;3125;1760;4885;739166;354521;1093687
2022.04_13-10-2022;Владимирская область;90_105_days;AllVaccines;7954;4913;12867;739166;354521;1093687
2022.04_13-10-2022;Владимирская область;90_105_days;CoviVac;138;54;192;739166;354521;1093687
2022.04_13-10-2022;Владимирская область;90_105_days;EpiVacCorona;198;190;388;739166;354521;1093687
2022.04_13-10-2022;Владимирская область;90_105_days;SputnikLite;4133;2250;6383;739166;354521;1093687
2022.04_13-10-2022;Владимирская область;90_105_days;SputnikV;3485;2419;5904;739166;354521;1093687
2022.04_13-10-2022;Волгоградская область;105_165_days;AllVaccines;187049;106065;293114;1387837;615020;2002857
2022.04_13-10-2022;Волгоградская область;105_165_days;CoviVac;1277;421;1698;1387837;615020;2002857
2022.04_13-10-2022;Волгоградская область;105_165_days;EpiVacCorona;4375;3833;8208;1387837;615020;2002857
2022.04_13-10-2022;Волгоградская область;105_165_days;SputnikLite;82053;48253;130306;1387837;615020;2002857
2022.04_13-10-2022;Волгоградская область;105_165_days;SputnikV;99344;53558;152902;1387837;615020;2002857
2022.04_13-10-2022;Волгоградская область;165_195_days;AllVaccines;128621;67851;196472;1387837;615020;2002857
2022.04_13-10-2022;Волгоградская область;165_195_days;CoviVac;636;189;825;1387837;615020;2002857
2022.04_13-10-2022;Волгоградская область;165_195_days;EpiVacCorona;3618;1581;5199;1387837;615020;2002857
2022.04_13-10-2022;Волгоградская область;165_195_days;SputnikLite;27028;17598;44626;1387837;615020;2002857
2022.04_13-10-2022;Волгоградская область;165_195_days;SputnikV;97339;48483;145822;1387837;615020;2002857
2022.04_13-10-2022;Волгоградская область;21_45_days;AllVaccines;9995;7226;17221;1387837;615020;2002857
2022.04_13-10-2022;Волгоградская область;21_45_days;CoviVac;768;345;1113;1387837;615020;2002857
2022.04_13-10-2022;Волгоградская область;21_45_days;EpiVacCorona;1051;642;1693;1387837;615020;2002857
2022.04_13-10-2022;Волгоградская область;21_45_days;SputnikLite;1824;1287;3111;1387837;615020;2002857
2022.04_13-10-2022;Волгоградская область;21_45_days;SputnikV;6352;4952;11304;1387837;615020;2002857
2022.04_13-10-2022;Волгоградская область;45_75_days;AllVaccines;18260;9679;27939;1387837;615020;2002857
2022.04_13-10-2022;Волгоградская область;45_75_days;CoviVac;480;138;618;1387837;615020;2002857
2022.04_13-10-2022;Волгоградская область;45_75_days;EpiVacCorona;1409;647;2056;1387837;615020;2002857
2022.04_13-10-2022;Волгоградская область;45_75_days;SputnikLite;6450;3087;9537;1387837;615020;2002857
2022.04_13-10-2022;Волгоградская область;45_75_days;SputnikV;9921;5807;15728;1387837;615020;2002857
2022.04_13-10-2022;Волгоградская область;75_90_days;AllVaccines;23922;11114;35036;1387837;615020;2002857
2022.04_13-10-2022;Волгоградская область;75_90_days;CoviVac;308;81;389;1387837;615020;2002857
2022.04_13-10-2022;Волгоградская область;75_90_days;EpiVacCorona;925;412;1337;1387837;615020;2002857
2022.04_13-10-2022;Волгоградская область;75_90_days;SputnikLite;11534;4429;15963;1387837;615020;2002857
2022.04_13-10-2022;Волгоградская область;75_90_days;SputnikV;11155;6192;17347;1387837;615020;2002857
2022.04_13-10-2022;Волгоградская область;90_105_days;AllVaccines;27303;13284;40587;1387837;615020;2002857
2022.04_13-10-2022;Волгоградская область;90_105_days;CoviVac;523;138;661;1387837;615020;2002857
2022.04_13-10-2022;Волгоградская область;90_105_days;EpiVacCorona;1181;539;1720;1387837;615020;2002857
2022.04_13-10-2022;Волгоградская область;90_105_days;SputnikLite;16500;7036;23536;1387837;615020;2002857
2022.04_13-10-2022;Волгоградская область;90_105_days;SputnikV;9099;5571;14670;1387837;615020;2002857
2022.04_13-10-2022;Вологодская область;105_165_days;AllVaccines;95761;46149;141910;628100;275171;903271
2022.04_13-10-2022;Вологодская область;105_165_days;CoviVac;2503;452;2955;628100;275171;903271
2022.04_13-10-2022;Вологодская область;105_165_days;EpiVacCorona;4043;1590;5633;628100;275171;903271
2022.04_13-10-2022;Вологодская область;105_165_days;SputnikLite;25988;19599;45587;628100;275171;903271
2022.04_13-10-2022;Вологодская область;105_165_days;SputnikV;63227;24508;87735;628100;275171;903271
2022.04_13-10-2022;Вологодская область;165_195_days;AllVaccines;46999;27228;74227;628100;275171;903271
2022.04_13-10-2022;Вологодская область;165_195_days;CoviVac;1581;256;1837;628100;275171;903271
2022.04_13-10-2022;Вологодская область;165_195_days;EpiVacCorona;1883;872;2755;628100;275171;903271
2022.04_13-10-2022;Вологодская область;165_195_days;SputnikLite;13952;8644;22596;628100;275171;903271
2022.04_13-10-2022;Вологодская область;165_195_days;SputnikV;29583;17456;47039;628100;275171;903271
2022.04_13-10-2022;Вологодская область;21_45_days;AllVaccines;3184;2454;5638;628100;275171;903271
2022.04_13-10-2022;Вологодская область;21_45_days;CoviVac;55;15;70;628100;275171;903271
2022.04_13-10-2022;Вологодская область;21_45_days;EpiVacCorona;134;92;226;628100;275171;903271
2022.04_13-10-2022;Вологодская область;21_45_days;SputnikLite;436;302;738;628100;275171;903271
2022.04_13-10-2022;Вологодская область;21_45_days;SputnikV;2559;2045;4604;628100;275171;903271
2022.04_13-10-2022;Вологодская область;45_75_days;AllVaccines;6911;3989;10900;628100;275171;903271
2022.04_13-10-2022;Вологодская область;45_75_days;CoviVac;121;17;138;628100;275171;903271
2022.04_13-10-2022;Вологодская область;45_75_days;EpiVacCorona;230;134;364;628100;275171;903271
2022.04_13-10-2022;Вологодская область;45_75_days;SputnikLite;1498;567;2065;628100;275171;903271
2022.04_13-10-2022;Вологодская область;45_75_days;SputnikV;5062;3271;8333;628100;275171;903271
2022.04_13-10-2022;Вологодская область;75_90_days;AllVaccines;7040;3467;10507;628100;275171;903271
2022.04_13-10-2022;Вологодская область;75_90_days;CoviVac;176;37;213;628100;275171;903271
2022.04_13-10-2022;Вологодская область;75_90_days;EpiVacCorona;259;150;409;628100;275171;903271
2022.04_13-10-2022;Вологодская область;75_90_days;SputnikLite;1641;674;2315;628100;275171;903271
2022.04_13-10-2022;Вологодская область;75_90_days;SputnikV;4964;2606;7570;628100;275171;903271
2022.04_13-10-2022;Вологодская область;90_105_days;AllVaccines;8197;4022;12219;628100;275171;903271
2022.04_13-10-2022;Вологодская область;90_105_days;CoviVac;204;79;283;628100;275171;903271
2022.04_13-10-2022;Вологодская область;90_105_days;EpiVacCorona;394;185;579;628100;275171;903271
2022.04_13-10-2022;Вологодская область;90_105_days;SputnikLite;3041;1289;4330;628100;275171;903271
2022.04_13-10-2022;Вологодская область;90_105_days;SputnikV;4558;2469;7027;628100;275171;903271
2022.04_13-10-2022;Воронежская область;105_165_days;AllVaccines;157994;79491;237485;1293123;602333;1895456
2022.04_13-10-2022;Воронежская область;105_165_days;CoviVac;1152;386;1538;1293123;602333;1895456
2022.04_13-10-2022;Воронежская область;105_165_days;EpiVacCorona;6558;3766;10324;1293123;602333;1895456
2022.04_13-10-2022;Воронежская область;105_165_days;SputnikLite;58796;39796;98592;1293123;602333;1895456
2022.04_13-10-2022;Воронежская область;105_165_days;SputnikV;91488;35543;127031;1293123;602333;1895456
2022.04_13-10-2022;Воронежская область;165_195_days;AllVaccines;168733;63095;231828;1293123;602333;1895456
2022.04_13-10-2022;Воронежская область;165_195_days;CoviVac;995;300;1295;1293123;602333;1895456
2022.04_13-10-2022;Воронежская область;165_195_days;EpiVacCorona;5702;2137;7839;1293123;602333;1895456
2022.04_13-10-2022;Воронежская область;165_195_days;SputnikLite;32914;25498;58412;1293123;602333;1895456
2022.04_13-10-2022;Воронежская область;165_195_days;SputnikV;129122;35160;164282;1293123;602333;1895456
2022.04_13-10-2022;Воронежская область;21_45_days;AllVaccines;9350;8083;17433;1293123;602333;1895456
2022.04_13-10-2022;Воронежская область;21_45_days;CoviVac;390;166;556;1293123;602333;1895456
2022.04_13-10-2022;Воронежская область;21_45_days;EpiVacCorona;1270;1539;2809;1293123;602333;1895456
2022.04_13-10-2022;Воронежская область;21_45_days;SputnikLite;1444;1095;2539;1293123;602333;1895456
2022.04_13-10-2022;Воронежская область;21_45_days;SputnikV;6246;5283;11529;1293123;602333;1895456
2022.04_13-10-2022;Воронежская область;45_75_days;AllVaccines;14047;9409;23456;1293123;602333;1895456
2022.04_13-10-2022;Воронежская область;45_75_days;CoviVac;357;216;573;1293123;602333;1895456
2022.04_13-10-2022;Воронежская область;45_75_days;EpiVacCorona;1158;915;2073;1293123;602333;1895456
2022.04_13-10-2022;Воронежская область;45_75_days;SputnikLite;3863;2747;6610;1293123;602333;1895456
2022.04_13-10-2022;Воронежская область;45_75_days;SputnikV;8669;5531;14200;1293123;602333;1895456
2022.04_13-10-2022;Воронежская область;75_90_days;AllVaccines;15372;8734;24106;1293123;602333;1895456
2022.04_13-10-2022;Воронежская область;75_90_days;CoviVac;171;50;221;1293123;602333;1895456
2022.04_13-10-2022;Воронежская область;75_90_days;EpiVacCorona;612;356;968;1293123;602333;1895456
2022.04_13-10-2022;Воронежская область;75_90_days;SputnikLite;6789;3211;10000;1293123;602333;1895456
2022.04_13-10-2022;Воронежская область;75_90_days;SputnikV;7800;5117;12917;1293123;602333;1895456
2022.04_13-10-2022;Воронежская область;90_105_days;AllVaccines;20939;11026;31965;1293123;602333;1895456
2022.04_13-10-2022;Воронежская область;90_105_days;CoviVac;296;99;395;1293123;602333;1895456
2022.04_13-10-2022;Воронежская область;90_105_days;EpiVacCorona;408;263;671;1293123;602333;1895456
2022.04_13-10-2022;Воронежская область;90_105_days;SputnikLite;12854;5557;18411;1293123;602333;1895456
2022.04_13-10-2022;Воронежская область;90_105_days;SputnikV;7381;5107;12488;1293123;602333;1895456
2022.04_13-10-2022;Еврейская автономная область;105_165_days;AllVaccines;17271;5277;22548;88207;31969;120176
2022.04_13-10-2022;Еврейская автономная область;105_165_days;CoviVac;668;124;792;88207;31969;120176
2022.04_13-10-2022;Еврейская автономная область;105_165_days;EpiVacCorona;1619;400;2019;88207;31969;120176
2022.04_13-10-2022;Еврейская автономная область;105_165_days;SputnikLite;4565;2362;6927;88207;31969;120176
2022.04_13-10-2022;Еврейская автономная область;105_165_days;SputnikV;10419;2391;12810;88207;31969;120176
2022.04_13-10-2022;Еврейская автономная область;165_195_days;AllVaccines;6949;2249;9198;88207;31969;120176
2022.04_13-10-2022;Еврейская автономная область;165_195_days;CoviVac;6;1;7;88207;31969;120176
2022.04_13-10-2022;Еврейская автономная область;165_195_days;EpiVacCorona;1121;157;1278;88207;31969;120176
2022.04_13-10-2022;Еврейская автономная область;165_195_days;SputnikLite;2034;1092;3126;88207;31969;120176
2022.04_13-10-2022;Еврейская автономная область;165_195_days;SputnikV;3788;999;4787;88207;31969;120176
2022.04_13-10-2022;Еврейская автономная область;21_45_days;AllVaccines;549;229;778;88207;31969;120176
2022.04_13-10-2022;Еврейская автономная область;21_45_days;CoviVac;100;13;113;88207;31969;120176
2022.04_13-10-2022;Еврейская автономная область;21_45_days;EpiVacCorona;129;56;185;88207;31969;120176
2022.04_13-10-2022;Еврейская автономная область;21_45_days;SputnikLite;2;2;4;88207;31969;120176
2022.04_13-10-2022;Еврейская автономная область;21_45_days;SputnikV;318;158;476;88207;31969;120176
2022.04_13-10-2022;Еврейская автономная область;45_75_days;AllVaccines;880;275;1155;88207;31969;120176
2022.04_13-10-2022;Еврейская автономная область;45_75_days;CoviVac;33;2;35;88207;31969;120176
2022.04_13-10-2022;Еврейская автономная область;45_75_days;EpiVacCorona;296;85;381;88207;31969;120176
2022.04_13-10-2022;Еврейская автономная область;45_75_days;SputnikLite;161;77;238;88207;31969;120176
2022.04_13-10-2022;Еврейская автономная область;45_75_days;SputnikV;390;111;501;88207;31969;120176
2022.04_13-10-2022;Еврейская автономная область;75_90_days;AllVaccines;2043;602;2645;88207;31969;120176
2022.04_13-10-2022;Еврейская автономная область;75_90_days;CoviVac;98;11;109;88207;31969;120176
2022.04_13-10-2022;Еврейская автономная область;75_90_days;EpiVacCorona;206;70;276;88207;31969;120176
2022.04_13-10-2022;Еврейская автономная область;75_90_days;SputnikLite;993;285;1278;88207;31969;120176
2022.04_13-10-2022;Еврейская автономная область;75_90_days;SputnikV;746;236;982;88207;31969;120176
2022.04_13-10-2022;Еврейская автономная область;90_105_days;AllVaccines;2884;1135;4019;88207;31969;120176
2022.04_13-10-2022;Еврейская автономная область;90_105_days;CoviVac;176;34;210;88207;31969;120176
2022.04_13-10-2022;Еврейская автономная область;90_105_days;EpiVacCorona;317;194;511;88207;31969;120176
2022.04_13-10-2022;Еврейская автономная область;90_105_days;SputnikLite;1807;718;2525;88207;31969;120176
2022.04_13-10-2022;Еврейская автономная область;90_105_days;SputnikV;584;189;773;88207;31969;120176
2022.04_13-10-2022;Забайкальский край;105_165_days;AllVaccines;94109;33890;127999;596322;191826;788148
2022.04_13-10-2022;Забайкальский край;105_165_days;CoviVac;873;86;959;596322;191826;788148
2022.04_13-10-2022;Забайкальский край;105_165_days;EpiVacCorona;7101;2331;9432;596322;191826;788148
2022.04_13-10-2022;Забайкальский край;105_165_days;SputnikLite;35418;13829;49247;596322;191826;788148
2022.04_13-10-2022;Забайкальский край;105_165_days;SputnikV;50717;17644;68361;596322;191826;788148
2022.04_13-10-2022;Забайкальский край;165_195_days;AllVaccines;57415;24646;82061;596322;191826;788148
2022.04_13-10-2022;Забайкальский край;165_195_days;CoviVac;763;75;838;596322;191826;788148
2022.04_13-10-2022;Забайкальский край;165_195_days;EpiVacCorona;1842;670;2512;596322;191826;788148
2022.04_13-10-2022;Забайкальский край;165_195_days;SputnikLite;26556;11713;38269;596322;191826;788148
2022.04_13-10-2022;Забайкальский край;165_195_days;SputnikV;28254;12188;40442;596322;191826;788148
2022.04_13-10-2022;Забайкальский край;21_45_days;AllVaccines;7687;3080;10767;596322;191826;788148
2022.04_13-10-2022;Забайкальский край;21_45_days;CoviVac;788;146;934;596322;191826;788148
2022.04_13-10-2022;Забайкальский край;21_45_days;EpiVacCorona;991;346;1337;596322;191826;788148
2022.04_13-10-2022;Забайкальский край;21_45_days;SputnikLite;692;227;919;596322;191826;788148
2022.04_13-10-2022;Забайкальский край;21_45_days;SputnikV;5216;2361;7577;596322;191826;788148
2022.04_13-10-2022;Забайкальский край;45_75_days;AllVaccines;16503;5150;21653;596322;191826;788148
2022.04_13-10-2022;Забайкальский край;45_75_days;CoviVac;706;95;801;596322;191826;788148
2022.04_13-10-2022;Забайкальский край;45_75_days;EpiVacCorona;2430;627;3057;596322;191826;788148
2022.04_13-10-2022;Забайкальский край;45_75_days;SputnikLite;1667;343;2010;596322;191826;788148
2022.04_13-10-2022;Забайкальский край;45_75_days;SputnikV;11700;4085;15785;596322;191826;788148
2022.04_13-10-2022;Забайкальский край;75_90_days;AllVaccines;13302;3778;17080;596322;191826;788148
2022.04_13-10-2022;Забайкальский край;75_90_days;CoviVac;492;53;545;596322;191826;788148
2022.04_13-10-2022;Забайкальский край;75_90_days;EpiVacCorona;1616;547;2163;596322;191826;788148
2022.04_13-10-2022;Забайкальский край;75_90_days;SputnikLite;2505;387;2892;596322;191826;788148
2022.04_13-10-2022;Забайкальский край;75_90_days;SputnikV;8689;2791;11480;596322;191826;788148
2022.04_13-10-2022;Забайкальский край;90_105_days;AllVaccines;15039;4408;19447;596322;191826;788148
2022.04_13-10-2022;Забайкальский край;90_105_days;CoviVac;332;76;408;596322;191826;788148
2022.04_13-10-2022;Забайкальский край;90_105_days;EpiVacCorona;1450;475;1925;596322;191826;788148
2022.04_13-10-2022;Забайкальский край;90_105_days;SputnikLite;6033;1003;7036;596322;191826;788148
2022.04_13-10-2022;Забайкальский край;90_105_days;SputnikV;7224;2854;10078;596322;191826;788148
2022.04_13-10-2022;Ивановская область;105_165_days;AllVaccines;37236;25934;63170;549803;255947;805750
2022.04_13-10-2022;Ивановская область;105_165_days;CoviVac;523;85;608;549803;255947;805750
2022.04_13-10-2022;Ивановская область;105_165_days;EpiVacCorona;1826;1383;3209;549803;255947;805750
2022.04_13-10-2022;Ивановская область;105_165_days;SputnikLite;19114;13364;32478;549803;255947;805750
2022.04_13-10-2022;Ивановская область;105_165_days;SputnikV;15773;11102;26875;549803;255947;805750
2022.04_13-10-2022;Ивановская область;165_195_days;AllVaccines;31468;25039;56507;549803;255947;805750
2022.04_13-10-2022;Ивановская область;165_195_days;CoviVac;324;68;392;549803;255947;805750
2022.04_13-10-2022;Ивановская область;165_195_days;EpiVacCorona;575;442;1017;549803;255947;805750
2022.04_13-10-2022;Ивановская область;165_195_days;SputnikLite;15427;13526;28953;549803;255947;805750
2022.04_13-10-2022;Ивановская область;165_195_days;SputnikV;15142;11003;26145;549803;255947;805750
2022.04_13-10-2022;Ивановская область;21_45_days;AllVaccines;1659;1706;3365;549803;255947;805750
2022.04_13-10-2022;Ивановская область;21_45_days;CoviVac;75;29;104;549803;255947;805750
2022.04_13-10-2022;Ивановская область;21_45_days;EpiVacCorona;69;78;147;549803;255947;805750
2022.04_13-10-2022;Ивановская область;21_45_days;SputnikLite;530;631;1161;549803;255947;805750
2022.04_13-10-2022;Ивановская область;21_45_days;SputnikV;985;968;1953;549803;255947;805750
2022.04_13-10-2022;Ивановская область;45_75_days;AllVaccines;4600;2970;7570;549803;255947;805750
2022.04_13-10-2022;Ивановская область;45_75_days;CoviVac;127;16;143;549803;255947;805750
2022.04_13-10-2022;Ивановская область;45_75_days;EpiVacCorona;202;114;316;549803;255947;805750
2022.04_13-10-2022;Ивановская область;45_75_days;SputnikLite;1725;1420;3145;549803;255947;805750
2022.04_13-10-2022;Ивановская область;45_75_days;SputnikV;2546;1420;3966;549803;255947;805750
2022.04_13-10-2022;Ивановская область;75_90_days;AllVaccines;5280;2409;7689;549803;255947;805750
2022.04_13-10-2022;Ивановская область;75_90_days;CoviVac;118;22;140;549803;255947;805750
2022.04_13-10-2022;Ивановская область;75_90_days;EpiVacCorona;186;40;226;549803;255947;805750
2022.04_13-10-2022;Ивановская область;75_90_days;SputnikLite;2294;902;3196;549803;255947;805750
2022.04_13-10-2022;Ивановская область;75_90_days;SputnikV;2682;1445;4127;549803;255947;805750
2022.04_13-10-2022;Ивановская область;90_105_days;AllVaccines;7190;3645;10835;549803;255947;805750
2022.04_13-10-2022;Ивановская область;90_105_days;CoviVac;125;17;142;549803;255947;805750
2022.04_13-10-2022;Ивановская область;90_105_days;EpiVacCorona;187;137;324;549803;255947;805750
2022.04_13-10-2022;Ивановская область;90_105_days;SputnikLite;4157;1685;5842;549803;255947;805750
2022.04_13-10-2022;Ивановская область;90_105_days;SputnikV;2721;1806;4527;549803;255947;805750
2022.04_13-10-2022;Иркутская область;105_165_days;AllVaccines;242965;83016;325981;1316761;480655;1797416
2022.04_13-10-2022;Иркутская область;105_165_days;CoviVac;2125;486;2611;1316761;480655;1797416
2022.04_13-10-2022;Иркутская область;105_165_days;EpiVacCorona;4755;1903;6658;1316761;480655;1797416
2022.04_13-10-2022;Иркутская область;105_165_days;SputnikLite;70807;47064;117871;1316761;480655;1797416
2022.04_13-10-2022;Иркутская область;105_165_days;SputnikV;165278;33563;198841;1316761;480655;1797416
2022.04_13-10-2022;Иркутская область;165_195_days;AllVaccines;142074;47533;189607;1316761;480655;1797416
2022.04_13-10-2022;Иркутская область;165_195_days;CoviVac;2364;469;2833;1316761;480655;1797416
2022.04_13-10-2022;Иркутская область;165_195_days;EpiVacCorona;3340;1010;4350;1316761;480655;1797416
2022.04_13-10-2022;Иркутская область;165_195_days;SputnikLite;33127;23692;56819;1316761;480655;1797416
2022.04_13-10-2022;Иркутская область;165_195_days;SputnikV;103243;22362;125605;1316761;480655;1797416
2022.04_13-10-2022;Иркутская область;21_45_days;AllVaccines;6455;3318;9773;1316761;480655;1797416
2022.04_13-10-2022;Иркутская область;21_45_days;CoviVac;207;41;248;1316761;480655;1797416
2022.04_13-10-2022;Иркутская область;21_45_days;EpiVacCorona;475;302;777;1316761;480655;1797416
2022.04_13-10-2022;Иркутская область;21_45_days;SputnikLite;878;370;1248;1316761;480655;1797416
2022.04_13-10-2022;Иркутская область;21_45_days;SputnikV;4895;2605;7500;1316761;480655;1797416
2022.04_13-10-2022;Иркутская область;45_75_days;AllVaccines;14170;5300;19470;1316761;480655;1797416
2022.04_13-10-2022;Иркутская область;45_75_days;CoviVac;329;72;401;1316761;480655;1797416
2022.04_13-10-2022;Иркутская область;45_75_days;EpiVacCorona;607;242;849;1316761;480655;1797416
2022.04_13-10-2022;Иркутская область;45_75_days;SputnikLite;2213;658;2871;1316761;480655;1797416
2022.04_13-10-2022;Иркутская область;45_75_days;SputnikV;11021;4328;15349;1316761;480655;1797416
2022.04_13-10-2022;Иркутская область;75_90_days;AllVaccines;18664;8336;27000;1316761;480655;1797416
2022.04_13-10-2022;Иркутская область;75_90_days;CoviVac;204;129;333;1316761;480655;1797416
2022.04_13-10-2022;Иркутская область;75_90_days;EpiVacCorona;647;760;1407;1316761;480655;1797416
2022.04_13-10-2022;Иркутская область;75_90_days;SputnikLite;6217;2615;8832;1316761;480655;1797416
2022.04_13-10-2022;Иркутская область;75_90_days;SputnikV;11596;4832;16428;1316761;480655;1797416
2022.04_13-10-2022;Иркутская область;90_105_days;AllVaccines;22525;9759;32284;1316761;480655;1797416
2022.04_13-10-2022;Иркутская область;90_105_days;CoviVac;255;99;354;1316761;480655;1797416
2022.04_13-10-2022;Иркутская область;90_105_days;EpiVacCorona;649;331;980;1316761;480655;1797416
2022.04_13-10-2022;Иркутская область;90_105_days;SputnikLite;10929;5289;16218;1316761;480655;1797416
2022.04_13-10-2022;Иркутская область;90_105_days;SputnikV;10692;4040;14732;1316761;480655;1797416
2022.04_13-10-2022;Кабардино-Балкарская Республика;105_165_days;AllVaccines;33685;12313;45998;502388;159241;661629
2022.04_13-10-2022;Кабардино-Балкарская Республика;105_165_days;CoviVac;281;96;377;502388;159241;661629
2022.04_13-10-2022;Кабардино-Балкарская Республика;105_165_days;EpiVacCorona;1758;470;2228;502388;159241;661629
2022.04_13-10-2022;Кабардино-Балкарская Республика;105_165_days;SputnikLite;19714;6931;26645;502388;159241;661629
2022.04_13-10-2022;Кабардино-Балкарская Республика;105_165_days;SputnikV;11932;4816;16748;502388;159241;661629
2022.04_13-10-2022;Кабардино-Балкарская Республика;165_195_days;AllVaccines;32780;9541;42321;502388;159241;661629
2022.04_13-10-2022;Кабардино-Балкарская Республика;165_195_days;CoviVac;158;40;198;502388;159241;661629
2022.04_13-10-2022;Кабардино-Балкарская Республика;165_195_days;EpiVacCorona;581;151;732;502388;159241;661629
2022.04_13-10-2022;Кабардино-Балкарская Республика;165_195_days;SputnikLite;20416;5501;25917;502388;159241;661629
2022.04_13-10-2022;Кабардино-Балкарская Республика;165_195_days;SputnikV;11625;3849;15474;502388;159241;661629
2022.04_13-10-2022;Кабардино-Балкарская Республика;21_45_days;AllVaccines;1816;703;2519;502388;159241;661629
2022.04_13-10-2022;Кабардино-Балкарская Республика;21_45_days;CoviVac;94;41;135;502388;159241;661629
2022.04_13-10-2022;Кабардино-Балкарская Республика;21_45_days;EpiVacCorona;73;15;88;502388;159241;661629
2022.04_13-10-2022;Кабардино-Балкарская Республика;21_45_days;SputnikLite;550;147;697;502388;159241;661629
2022.04_13-10-2022;Кабардино-Балкарская Республика;21_45_days;SputnikV;1099;500;1599;502388;159241;661629
2022.04_13-10-2022;Кабардино-Балкарская Республика;45_75_days;AllVaccines;2932;1324;4256;502388;159241;661629
2022.04_13-10-2022;Кабардино-Балкарская Республика;45_75_days;CoviVac;72;12;84;502388;159241;661629
2022.04_13-10-2022;Кабардино-Балкарская Республика;45_75_days;EpiVacCorona;357;110;467;502388;159241;661629
2022.04_13-10-2022;Кабардино-Балкарская Республика;45_75_days;SputnikLite;713;298;1011;502388;159241;661629
2022.04_13-10-2022;Кабардино-Балкарская Республика;45_75_days;SputnikV;1790;904;2694;502388;159241;661629
2022.04_13-10-2022;Кабардино-Балкарская Республика;75_90_days;AllVaccines;5673;2172;7845;502388;159241;661629
2022.04_13-10-2022;Кабардино-Балкарская Республика;75_90_days;CoviVac;44;8;52;502388;159241;661629
2022.04_13-10-2022;Кабардино-Балкарская Республика;75_90_days;EpiVacCorona;284;107;391;502388;159241;661629
2022.04_13-10-2022;Кабардино-Балкарская Республика;75_90_days;SputnikLite;3060;922;3982;502388;159241;661629
2022.04_13-10-2022;Кабардино-Балкарская Республика;75_90_days;SputnikV;2285;1135;3420;502388;159241;661629
2022.04_13-10-2022;Кабардино-Балкарская Республика;90_105_days;AllVaccines;5508;2329;7837;502388;159241;661629
2022.04_13-10-2022;Кабардино-Балкарская Республика;90_105_days;CoviVac;183;40;223;502388;159241;661629
2022.04_13-10-2022;Кабардино-Балкарская Республика;90_105_days;EpiVacCorona;312;86;398;502388;159241;661629
2022.04_13-10-2022;Кабардино-Балкарская Республика;90_105_days;SputnikLite;2707;911;3618;502388;159241;661629
2022.04_13-10-2022;Кабардино-Балкарская Республика;90_105_days;SputnikV;2306;1292;3598;502388;159241;661629
2022.04_13-10-2022;Калининградская область;105_165_days;AllVaccines;77734;40408;118142;585700;231702;817402
2022.04_13-10-2022;Калининградская область;105_165_days;CoviVac;1393;397;1790;585700;231702;817402
2022.04_13-10-2022;Калининградская область;105_165_days;EpiVacCorona;2338;866;3204;585700;231702;817402
2022.04_13-10-2022;Калининградская область;105_165_days;SputnikLite;26644;20000;46644;585700;231702;817402
2022.04_13-10-2022;Калининградская область;105_165_days;SputnikV;47359;19145;66504;585700;231702;817402
2022.04_13-10-2022;Калининградская область;165_195_days;AllVaccines;59840;28499;88339;585700;231702;817402
2022.04_13-10-2022;Калининградская область;165_195_days;CoviVac;670;146;816;585700;231702;817402
2022.04_13-10-2022;Калининградская область;165_195_days;EpiVacCorona;1874;700;2574;585700;231702;817402
2022.04_13-10-2022;Калининградская область;165_195_days;SputnikLite;11456;10385;21841;585700;231702;817402
2022.04_13-10-2022;Калининградская область;165_195_days;SputnikV;45840;17268;63108;585700;231702;817402
2022.04_13-10-2022;Калининградская область;21_45_days;AllVaccines;3094;2712;5806;585700;231702;817402
2022.04_13-10-2022;Калининградская область;21_45_days;CoviVac;97;44;141;585700;231702;817402
2022.04_13-10-2022;Калининградская область;21_45_days;EpiVacCorona;90;50;140;585700;231702;817402
2022.04_13-10-2022;Калининградская область;21_45_days;SputnikLite;858;832;1690;585700;231702;817402
2022.04_13-10-2022;Калининградская область;21_45_days;SputnikV;2049;1786;3835;585700;231702;817402
2022.04_13-10-2022;Калининградская область;45_75_days;AllVaccines;6004;3553;9557;585700;231702;817402
2022.04_13-10-2022;Калининградская область;45_75_days;CoviVac;113;44;157;585700;231702;817402
2022.04_13-10-2022;Калининградская область;45_75_days;EpiVacCorona;145;89;234;585700;231702;817402
2022.04_13-10-2022;Калининградская область;45_75_days;SputnikLite;1272;958;2230;585700;231702;817402
2022.04_13-10-2022;Калининградская область;45_75_days;SputnikV;4474;2462;6936;585700;231702;817402
2022.04_13-10-2022;Калининградская область;75_90_days;AllVaccines;5676;2530;8206;585700;231702;817402
2022.04_13-10-2022;Калининградская область;75_90_days;CoviVac;96;20;116;585700;231702;817402
2022.04_13-10-2022;Калининградская область;75_90_days;EpiVacCorona;139;70;209;585700;231702;817402
2022.04_13-10-2022;Калининградская область;75_90_days;SputnikLite;1374;588;1962;585700;231702;817402
2022.04_13-10-2022;Калининградская область;75_90_days;SputnikV;4067;1852;5919;585700;231702;817402
2022.04_13-10-2022;Калининградская область;90_105_days;AllVaccines;9797;4879;14676;585700;231702;817402
2022.04_13-10-2022;Калининградская область;90_105_days;CoviVac;130;45;175;585700;231702;817402
2022.04_13-10-2022;Калининградская область;90_105_days;EpiVacCorona;362;165;527;585700;231702;817402
2022.04_13-10-2022;Калининградская область;90_105_days;SputnikLite;4367;2069;6436;585700;231702;817402
2022.04_13-10-2022;Калининградская область;90_105_days;SputnikV;4938;2600;7538;585700;231702;817402
2022.04_13-10-2022;Калужская область;105_165_days;AllVaccines;94486;39492;133978;559789;253023;812812
2022.04_13-10-2022;Калужская область;105_165_days;CoviVac;756;211;967;559789;253023;812812
2022.04_13-10-2022;Калужская область;105_165_days;EpiVacCorona;3363;1347;4710;559789;253023;812812
2022.04_13-10-2022;Калужская область;105_165_days;SputnikLite;24844;18415;43259;559789;253023;812812
2022.04_13-10-2022;Калужская область;105_165_days;SputnikV;65523;19519;85042;559789;253023;812812
2022.04_13-10-2022;Калужская область;165_195_days;AllVaccines;75819;24425;100244;559789;253023;812812
2022.04_13-10-2022;Калужская область;165_195_days;CoviVac;2439;578;3017;559789;253023;812812
2022.04_13-10-2022;Калужская область;165_195_days;EpiVacCorona;3318;1067;4385;559789;253023;812812
2022.04_13-10-2022;Калужская область;165_195_days;SputnikLite;12182;7752;19934;559789;253023;812812
2022.04_13-10-2022;Калужская область;165_195_days;SputnikV;57880;15028;72908;559789;253023;812812
2022.04_13-10-2022;Калужская область;21_45_days;AllVaccines;2554;1735;4289;559789;253023;812812
2022.04_13-10-2022;Калужская область;21_45_days;CoviVac;61;44;105;559789;253023;812812
2022.04_13-10-2022;Калужская область;21_45_days;EpiVacCorona;130;67;197;559789;253023;812812
2022.04_13-10-2022;Калужская область;21_45_days;SputnikLite;541;410;951;559789;253023;812812
2022.04_13-10-2022;Калужская область;21_45_days;SputnikV;1822;1214;3036;559789;253023;812812
2022.04_13-10-2022;Калужская область;45_75_days;AllVaccines;5931;3155;9086;559789;253023;812812
2022.04_13-10-2022;Калужская область;45_75_days;CoviVac;172;57;229;559789;253023;812812
2022.04_13-10-2022;Калужская область;45_75_days;EpiVacCorona;389;172;561;559789;253023;812812
2022.04_13-10-2022;Калужская область;45_75_days;SputnikLite;1271;1070;2341;559789;253023;812812
2022.04_13-10-2022;Калужская область;45_75_days;SputnikV;4099;1856;5955;559789;253023;812812
2022.04_13-10-2022;Калужская область;75_90_days;AllVaccines;5012;2222;7234;559789;253023;812812
2022.04_13-10-2022;Калужская область;75_90_days;CoviVac;85;37;122;559789;253023;812812
2022.04_13-10-2022;Калужская область;75_90_days;EpiVacCorona;175;82;257;559789;253023;812812
2022.04_13-10-2022;Калужская область;75_90_days;SputnikLite;1400;722;2122;559789;253023;812812
2022.04_13-10-2022;Калужская область;75_90_days;SputnikV;3352;1381;4733;559789;253023;812812
2022.04_13-10-2022;Калужская область;90_105_days;AllVaccines;8167;4374;12541;559789;253023;812812
2022.04_13-10-2022;Калужская область;90_105_days;CoviVac;153;54;207;559789;253023;812812
2022.04_13-10-2022;Калужская область;90_105_days;EpiVacCorona;211;112;323;559789;253023;812812
2022.04_13-10-2022;Калужская область;90_105_days;SputnikLite;3686;2160;5846;559789;253023;812812
2022.04_13-10-2022;Калужская область;90_105_days;SputnikV;4117;2048;6165;559789;253023;812812
2022.04_13-10-2022;Камчатский край;105_165_days;AllVaccines;21557;6426;27983;189425;56856;246281
2022.04_13-10-2022;Камчатский край;105_165_days;CoviVac;230;60;290;189425;56856;246281
2022.04_13-10-2022;Камчатский край;105_165_days;EpiVacCorona;618;249;867;189425;56856;246281
2022.04_13-10-2022;Камчатский край;105_165_days;SputnikLite;9844;3770;13614;189425;56856;246281
2022.04_13-10-2022;Камчатский край;105_165_days;SputnikV;10865;2347;13212;189425;56856;246281
2022.04_13-10-2022;Камчатский край;165_195_days;AllVaccines;16757;5272;22029;189425;56856;246281
2022.04_13-10-2022;Камчатский край;165_195_days;CoviVac;221;30;251;189425;56856;246281
2022.04_13-10-2022;Камчатский край;165_195_days;EpiVacCorona;451;123;574;189425;56856;246281
2022.04_13-10-2022;Камчатский край;165_195_days;SputnikLite;9789;3576;13365;189425;56856;246281
2022.04_13-10-2022;Камчатский край;165_195_days;SputnikV;6296;1543;7839;189425;56856;246281
2022.04_13-10-2022;Камчатский край;21_45_days;AllVaccines;1710;456;2166;189425;56856;246281
2022.04_13-10-2022;Камчатский край;21_45_days;CoviVac;20;10;30;189425;56856;246281
2022.04_13-10-2022;Камчатский край;21_45_days;EpiVacCorona;67;17;84;189425;56856;246281
2022.04_13-10-2022;Камчатский край;21_45_days;SputnikLite;447;84;531;189425;56856;246281
2022.04_13-10-2022;Камчатский край;21_45_days;SputnikV;1176;345;1521;189425;56856;246281
2022.04_13-10-2022;Камчатский край;45_75_days;AllVaccines;3111;953;4064;189425;56856;246281
2022.04_13-10-2022;Камчатский край;45_75_days;CoviVac;62;12;74;189425;56856;246281
2022.04_13-10-2022;Камчатский край;45_75_days;EpiVacCorona;326;104;430;189425;56856;246281
2022.04_13-10-2022;Камчатский край;45_75_days;SputnikLite;563;192;755;189425;56856;246281
2022.04_13-10-2022;Камчатский край;45_75_days;SputnikV;2160;645;2805;189425;56856;246281
2022.04_13-10-2022;Камчатский край;75_90_days;AllVaccines;2430;562;2992;189425;56856;246281
2022.04_13-10-2022;Камчатский край;75_90_days;CoviVac;19;3;22;189425;56856;246281
2022.04_13-10-2022;Камчатский край;75_90_days;EpiVacCorona;163;35;198;189425;56856;246281
2022.04_13-10-2022;Камчатский край;75_90_days;SputnikLite;696;139;835;189425;56856;246281
2022.04_13-10-2022;Камчатский край;75_90_days;SputnikV;1552;385;1937;189425;56856;246281
2022.04_13-10-2022;Камчатский край;90_105_days;AllVaccines;2059;646;2705;189425;56856;246281
2022.04_13-10-2022;Камчатский край;90_105_days;CoviVac;26;2;28;189425;56856;246281
2022.04_13-10-2022;Камчатский край;90_105_days;EpiVacCorona;103;48;151;189425;56856;246281
2022.04_13-10-2022;Камчатский край;90_105_days;SputnikLite;931;332;1263;189425;56856;246281
2022.04_13-10-2022;Камчатский край;90_105_days;SputnikV;999;264;1263;189425;56856;246281
2022.04_13-10-2022;Карачаево-Черкесская Республика;105_165_days;AllVaccines;22881;7805;30686;266261;94005;360266
2022.04_13-10-2022;Карачаево-Черкесская Республика;105_165_days;CoviVac;258;85;343;266261;94005;360266
2022.04_13-10-2022;Карачаево-Черкесская Республика;105_165_days;EpiVacCorona;735;206;941;266261;94005;360266
2022.04_13-10-2022;Карачаево-Черкесская Республика;105_165_days;SputnikLite;13677;4717;18394;266261;94005;360266
2022.04_13-10-2022;Карачаево-Черкесская Республика;105_165_days;SputnikV;8211;2797;11008;266261;94005;360266
2022.04_13-10-2022;Карачаево-Черкесская Республика;165_195_days;AllVaccines;15070;5640;20710;266261;94005;360266
2022.04_13-10-2022;Карачаево-Черкесская Республика;165_195_days;CoviVac;38;15;53;266261;94005;360266
2022.04_13-10-2022;Карачаево-Черкесская Республика;165_195_days;EpiVacCorona;94;33;127;266261;94005;360266
2022.04_13-10-2022;Карачаево-Черкесская Республика;165_195_days;SputnikLite;10536;3370;13906;266261;94005;360266
2022.04_13-10-2022;Карачаево-Черкесская Республика;165_195_days;SputnikV;4402;2222;6624;266261;94005;360266
2022.04_13-10-2022;Карачаево-Черкесская Республика;21_45_days;AllVaccines;4772;2273;7045;266261;94005;360266
2022.04_13-10-2022;Карачаево-Черкесская Республика;21_45_days;CoviVac;504;139;643;266261;94005;360266
2022.04_13-10-2022;Карачаево-Черкесская Республика;21_45_days;EpiVacCorona;1114;673;1787;266261;94005;360266
2022.04_13-10-2022;Карачаево-Черкесская Республика;21_45_days;SputnikLite;772;358;1130;266261;94005;360266
2022.04_13-10-2022;Карачаево-Черкесская Республика;21_45_days;SputnikV;2382;1103;3485;266261;94005;360266
2022.04_13-10-2022;Карачаево-Черкесская Республика;45_75_days;AllVaccines;5677;1891;7568;266261;94005;360266
2022.04_13-10-2022;Карачаево-Черкесская Республика;45_75_days;CoviVac;312;106;418;266261;94005;360266
2022.04_13-10-2022;Карачаево-Черкесская Республика;45_75_days;EpiVacCorona;845;242;1087;266261;94005;360266
2022.04_13-10-2022;Карачаево-Черкесская Республика;45_75_days;SputnikLite;1467;556;2023;266261;94005;360266
2022.04_13-10-2022;Карачаево-Черкесская Республика;45_75_days;SputnikV;3053;987;4040;266261;94005;360266
2022.04_13-10-2022;Карачаево-Черкесская Республика;75_90_days;AllVaccines;5118;2128;7246;266261;94005;360266
2022.04_13-10-2022;Карачаево-Черкесская Республика;75_90_days;CoviVac;17;4;21;266261;94005;360266
2022.04_13-10-2022;Карачаево-Черкесская Республика;75_90_days;EpiVacCorona;397;112;509;266261;94005;360266
2022.04_13-10-2022;Карачаево-Черкесская Республика;75_90_days;SputnikLite;947;310;1257;266261;94005;360266
2022.04_13-10-2022;Карачаево-Черкесская Республика;75_90_days;SputnikV;3757;1702;5459;266261;94005;360266
2022.04_13-10-2022;Карачаево-Черкесская Республика;90_105_days;AllVaccines;2373;964;3337;266261;94005;360266
2022.04_13-10-2022;Карачаево-Черкесская Республика;90_105_days;CoviVac;42;25;67;266261;94005;360266
2022.04_13-10-2022;Карачаево-Черкесская Республика;90_105_days;EpiVacCorona;283;61;344;266261;94005;360266
2022.04_13-10-2022;Карачаево-Черкесская Республика;90_105_days;SputnikLite;1076;405;1481;266261;94005;360266
2022.04_13-10-2022;Карачаево-Черкесская Республика;90_105_days;SputnikV;972;473;1445;266261;94005;360266
2022.04_13-10-2022;Кемеровская область;105_165_days;AllVaccines;214932;92024;306956;1453976;610256;2064232
2022.04_13-10-2022;Кемеровская область;105_165_days;CoviVac;2012;437;2449;1453976;610256;2064232
2022.04_13-10-2022;Кемеровская область;105_165_days;EpiVacCorona;10716;5188;15904;1453976;610256;2064232
2022.04_13-10-2022;Кемеровская область;105_165_days;SputnikLite;68443;41148;109591;1453976;610256;2064232
2022.04_13-10-2022;Кемеровская область;105_165_days;SputnikV;133761;45251;179012;1453976;610256;2064232
2022.04_13-10-2022;Кемеровская область;165_195_days;AllVaccines;74497;45084;119581;1453976;610256;2064232
2022.04_13-10-2022;Кемеровская область;165_195_days;CoviVac;1353;242;1595;1453976;610256;2064232
2022.04_13-10-2022;Кемеровская область;165_195_days;EpiVacCorona;3191;1758;4949;1453976;610256;2064232
2022.04_13-10-2022;Кемеровская область;165_195_days;SputnikLite;22699;20591;43290;1453976;610256;2064232
2022.04_13-10-2022;Кемеровская область;165_195_days;SputnikV;47254;22493;69747;1453976;610256;2064232
2022.04_13-10-2022;Кемеровская область;21_45_days;AllVaccines;7627;3328;10955;1453976;610256;2064232
2022.04_13-10-2022;Кемеровская область;21_45_days;CoviVac;299;49;348;1453976;610256;2064232
2022.04_13-10-2022;Кемеровская область;21_45_days;EpiVacCorona;776;308;1084;1453976;610256;2064232
2022.04_13-10-2022;Кемеровская область;21_45_days;SputnikLite;339;193;532;1453976;610256;2064232
2022.04_13-10-2022;Кемеровская область;21_45_days;SputnikV;6213;2778;8991;1453976;610256;2064232
2022.04_13-10-2022;Кемеровская область;45_75_days;AllVaccines;16904;5899;22803;1453976;610256;2064232
2022.04_13-10-2022;Кемеровская область;45_75_days;CoviVac;423;136;559;1453976;610256;2064232
2022.04_13-10-2022;Кемеровская область;45_75_days;EpiVacCorona;1055;497;1552;1453976;610256;2064232
2022.04_13-10-2022;Кемеровская область;45_75_days;SputnikLite;2789;976;3765;1453976;610256;2064232
2022.04_13-10-2022;Кемеровская область;45_75_days;SputnikV;12637;4290;16927;1453976;610256;2064232
2022.04_13-10-2022;Кемеровская область;75_90_days;AllVaccines;33523;12495;46018;1453976;610256;2064232
2022.04_13-10-2022;Кемеровская область;75_90_days;CoviVac;291;73;364;1453976;610256;2064232
2022.04_13-10-2022;Кемеровская область;75_90_days;EpiVacCorona;992;565;1557;1453976;610256;2064232
2022.04_13-10-2022;Кемеровская область;75_90_days;SputnikLite;13731;4672;18403;1453976;610256;2064232
2022.04_13-10-2022;Кемеровская область;75_90_days;SputnikV;18509;7185;25694;1453976;610256;2064232
2022.04_13-10-2022;Кемеровская область;90_105_days;AllVaccines;37627;15289;52916;1453976;610256;2064232
2022.04_13-10-2022;Кемеровская область;90_105_days;CoviVac;392;105;497;1453976;610256;2064232
2022.04_13-10-2022;Кемеровская область;90_105_days;EpiVacCorona;1886;994;2880;1453976;610256;2064232
2022.04_13-10-2022;Кемеровская область;90_105_days;SputnikLite;19693;7505;27198;1453976;610256;2064232
2022.04_13-10-2022;Кемеровская область;90_105_days;SputnikV;15656;6685;22341;1453976;610256;2064232
2022.04_13-10-2022;Кировская область;105_165_days;AllVaccines;101537;62686;164223;663621;334585;998206
2022.04_13-10-2022;Кировская область;105_165_days;CoviVac;1753;289;2042;663621;334585;998206
2022.04_13-10-2022;Кировская область;105_165_days;EpiVacCorona;4863;2142;7005;663621;334585;998206
2022.04_13-10-2022;Кировская область;105_165_days;SputnikLite;44648;29821;74469;663621;334585;998206
2022.04_13-10-2022;Кировская область;105_165_days;SputnikV;50273;30434;80707;663621;334585;998206
2022.04_13-10-2022;Кировская область;165_195_days;AllVaccines;88525;46649;135174;663621;334585;998206
2022.04_13-10-2022;Кировская область;165_195_days;CoviVac;2862;294;3156;663621;334585;998206
2022.04_13-10-2022;Кировская область;165_195_days;EpiVacCorona;3884;1401;5285;663621;334585;998206
2022.04_13-10-2022;Кировская область;165_195_days;SputnikLite;35218;21761;56979;663621;334585;998206
2022.04_13-10-2022;Кировская область;165_195_days;SputnikV;46561;23193;69754;663621;334585;998206
2022.04_13-10-2022;Кировская область;21_45_days;AllVaccines;3429;3350;6779;663621;334585;998206
2022.04_13-10-2022;Кировская область;21_45_days;CoviVac;57;20;77;663621;334585;998206
2022.04_13-10-2022;Кировская область;21_45_days;EpiVacCorona;211;140;351;663621;334585;998206
2022.04_13-10-2022;Кировская область;21_45_days;SputnikLite;1284;956;2240;663621;334585;998206
2022.04_13-10-2022;Кировская область;21_45_days;SputnikV;1877;2234;4111;663621;334585;998206
2022.04_13-10-2022;Кировская область;45_75_days;AllVaccines;6693;5918;12611;663621;334585;998206
2022.04_13-10-2022;Кировская область;45_75_days;CoviVac;73;10;83;663621;334585;998206
2022.04_13-10-2022;Кировская область;45_75_days;EpiVacCorona;167;88;255;663621;334585;998206
2022.04_13-10-2022;Кировская область;45_75_days;SputnikLite;3167;2814;5981;663621;334585;998206
2022.04_13-10-2022;Кировская область;45_75_days;SputnikV;3286;3006;6292;663621;334585;998206
2022.04_13-10-2022;Кировская область;75_90_days;AllVaccines;7710;5342;13052;663621;334585;998206
2022.04_13-10-2022;Кировская область;75_90_days;CoviVac;113;21;134;663621;334585;998206
2022.04_13-10-2022;Кировская область;75_90_days;EpiVacCorona;161;89;250;663621;334585;998206
2022.04_13-10-2022;Кировская область;75_90_days;SputnikLite;3720;2069;5789;663621;334585;998206
2022.04_13-10-2022;Кировская область;75_90_days;SputnikV;3716;3163;6879;663621;334585;998206
2022.04_13-10-2022;Кировская область;90_105_days;AllVaccines;11502;7005;18507;663621;334585;998206
2022.04_13-10-2022;Кировская область;90_105_days;CoviVac;236;31;267;663621;334585;998206
2022.04_13-10-2022;Кировская область;90_105_days;EpiVacCorona;305;171;476;663621;334585;998206
2022.04_13-10-2022;Кировская область;90_105_days;SputnikLite;7507;3689;11196;663621;334585;998206
2022.04_13-10-2022;Кировская область;90_105_days;SputnikV;3454;3114;6568;663621;334585;998206
2022.04_13-10-2022;Костромская область;105_165_days;AllVaccines;39045;20967;60012;339046;160543;499589
2022.04_13-10-2022;Костромская область;105_165_days;CoviVac;517;138;655;339046;160543;499589
2022.04_13-10-2022;Костромская область;105_165_days;EpiVacCorona;4659;1838;6497;339046;160543;499589
2022.04_13-10-2022;Костромская область;105_165_days;SputnikLite;17448;10311;27759;339046;160543;499589
2022.04_13-10-2022;Костромская область;105_165_days;SputnikV;16421;8680;25101;339046;160543;499589
2022.04_13-10-2022;Костромская область;165_195_days;AllVaccines;36653;18500;55153;339046;160543;499589
2022.04_13-10-2022;Костромская область;165_195_days;CoviVac;815;231;1046;339046;160543;499589
2022.04_13-10-2022;Костромская область;165_195_days;EpiVacCorona;1059;521;1580;339046;160543;499589
2022.04_13-10-2022;Костромская область;165_195_days;SputnikLite;22446;10303;32749;339046;160543;499589
2022.04_13-10-2022;Костромская область;165_195_days;SputnikV;12333;7445;19778;339046;160543;499589
2022.04_13-10-2022;Костромская область;21_45_days;AllVaccines;1315;1116;2431;339046;160543;499589
2022.04_13-10-2022;Костромская область;21_45_days;CoviVac;83;26;109;339046;160543;499589
2022.04_13-10-2022;Костромская область;21_45_days;EpiVacCorona;218;178;396;339046;160543;499589
2022.04_13-10-2022;Костромская область;21_45_days;SputnikLite;42;49;91;339046;160543;499589
2022.04_13-10-2022;Костромская область;21_45_days;SputnikV;972;863;1835;339046;160543;499589
2022.04_13-10-2022;Костромская область;45_75_days;AllVaccines;3148;1841;4989;339046;160543;499589
2022.04_13-10-2022;Костромская область;45_75_days;CoviVac;143;35;178;339046;160543;499589
2022.04_13-10-2022;Костромская область;45_75_days;EpiVacCorona;440;251;691;339046;160543;499589
2022.04_13-10-2022;Костромская область;45_75_days;SputnikLite;363;231;594;339046;160543;499589
2022.04_13-10-2022;Костромская область;45_75_days;SputnikV;2202;1324;3526;339046;160543;499589
2022.04_13-10-2022;Костромская область;75_90_days;AllVaccines;4569;2590;7159;339046;160543;499589
2022.04_13-10-2022;Костромская область;75_90_days;CoviVac;110;45;155;339046;160543;499589
2022.04_13-10-2022;Костромская область;75_90_days;EpiVacCorona;367;200;567;339046;160543;499589
2022.04_13-10-2022;Костромская область;75_90_days;SputnikLite;1353;627;1980;339046;160543;499589
2022.04_13-10-2022;Костромская область;75_90_days;SputnikV;2739;1718;4457;339046;160543;499589
2022.04_13-10-2022;Костромская область;90_105_days;AllVaccines;6835;3703;10538;339046;160543;499589
2022.04_13-10-2022;Костромская область;90_105_days;CoviVac;298;115;413;339046;160543;499589
2022.04_13-10-2022;Костромская область;90_105_days;EpiVacCorona;329;179;508;339046;160543;499589
2022.04_13-10-2022;Костромская область;90_105_days;SputnikLite;3900;1880;5780;339046;160543;499589
2022.04_13-10-2022;Костромская область;90_105_days;SputnikV;2308;1529;3837;339046;160543;499589
2022.04_13-10-2022;Краснодарский край;105_165_days;AllVaccines;471109;229748;700857;3157155;1334085;4491240
2022.04_13-10-2022;Краснодарский край;105_165_days;CoviVac;3080;1015;4095;3157155;1334085;4491240
2022.04_13-10-2022;Краснодарский край;105_165_days;EpiVacCorona;8480;4540;13020;3157155;1334085;4491240
2022.04_13-10-2022;Краснодарский край;105_165_days;SputnikLite;115664;83402;199066;3157155;1334085;4491240
2022.04_13-10-2022;Краснодарский край;105_165_days;SputnikV;343885;140791;484676;3157155;1334085;4491240
2022.04_13-10-2022;Краснодарский край;165_195_days;AllVaccines;249655;120742;370397;3157155;1334085;4491240
2022.04_13-10-2022;Краснодарский край;165_195_days;CoviVac;3639;1133;4772;3157155;1334085;4491240
2022.04_13-10-2022;Краснодарский край;165_195_days;EpiVacCorona;4977;2740;7717;3157155;1334085;4491240
2022.04_13-10-2022;Краснодарский край;165_195_days;SputnikLite;39529;41802;81331;3157155;1334085;4491240
2022.04_13-10-2022;Краснодарский край;165_195_days;SputnikV;201510;75067;276577;3157155;1334085;4491240
2022.04_13-10-2022;Краснодарский край;21_45_days;AllVaccines;25281;28307;53588;3157155;1334085;4491240
2022.04_13-10-2022;Краснодарский край;21_45_days;CoviVac;782;460;1242;3157155;1334085;4491240
2022.04_13-10-2022;Краснодарский край;21_45_days;EpiVacCorona;1792;1900;3692;3157155;1334085;4491240
2022.04_13-10-2022;Краснодарский край;21_45_days;SputnikLite;1672;1202;2874;3157155;1334085;4491240
2022.04_13-10-2022;Краснодарский край;21_45_days;SputnikV;21035;24745;45780;3157155;1334085;4491240
2022.04_13-10-2022;Краснодарский край;45_75_days;AllVaccines;59271;59804;119075;3157155;1334085;4491240
2022.04_13-10-2022;Краснодарский край;45_75_days;CoviVac;426;161;587;3157155;1334085;4491240
2022.04_13-10-2022;Краснодарский край;45_75_days;EpiVacCorona;7746;7397;15143;3157155;1334085;4491240
2022.04_13-10-2022;Краснодарский край;45_75_days;SputnikLite;4932;3814;8746;3157155;1334085;4491240
2022.04_13-10-2022;Краснодарский край;45_75_days;SputnikV;46167;48432;94599;3157155;1334085;4491240
2022.04_13-10-2022;Краснодарский край;75_90_days;AllVaccines;46275;31125;77400;3157155;1334085;4491240
2022.04_13-10-2022;Краснодарский край;75_90_days;CoviVac;417;90;507;3157155;1334085;4491240
2022.04_13-10-2022;Краснодарский край;75_90_days;EpiVacCorona;2290;1560;3850;3157155;1334085;4491240
2022.04_13-10-2022;Краснодарский край;75_90_days;SputnikLite;7206;3191;10397;3157155;1334085;4491240
2022.04_13-10-2022;Краснодарский край;75_90_days;SputnikV;36362;26284;62646;3157155;1334085;4491240
2022.04_13-10-2022;Краснодарский край;90_105_days;AllVaccines;55588;32736;88324;3157155;1334085;4491240
2022.04_13-10-2022;Краснодарский край;90_105_days;CoviVac;626;211;837;3157155;1334085;4491240
2022.04_13-10-2022;Краснодарский край;90_105_days;EpiVacCorona;1679;2375;4054;3157155;1334085;4491240
2022.04_13-10-2022;Краснодарский край;90_105_days;SputnikLite;19306;7111;26417;3157155;1334085;4491240
2022.04_13-10-2022;Краснодарский край;90_105_days;SputnikV;33977;23039;57016;3157155;1334085;4491240
2022.04_13-10-2022;Красноярский край;105_165_days;AllVaccines;261167;102489;363656;1637377;585822;2223199
2022.04_13-10-2022;Красноярский край;105_165_days;CoviVac;2849;704;3553;1637377;585822;2223199
2022.04_13-10-2022;Красноярский край;105_165_days;EpiVacCorona;10457;5528;15985;1637377;585822;2223199
2022.04_13-10-2022;Красноярский край;105_165_days;SputnikLite;92009;47689;139698;1637377;585822;2223199
2022.04_13-10-2022;Красноярский край;105_165_days;SputnikV;155852;48568;204420;1637377;585822;2223199
2022.04_13-10-2022;Красноярский край;165_195_days;AllVaccines;117987;50384;168371;1637377;585822;2223199
2022.04_13-10-2022;Красноярский край;165_195_days;CoviVac;2027;466;2493;1637377;585822;2223199
2022.04_13-10-2022;Красноярский край;165_195_days;EpiVacCorona;4765;2535;7300;1637377;585822;2223199
2022.04_13-10-2022;Красноярский край;165_195_days;SputnikLite;42931;19495;62426;1637377;585822;2223199
2022.04_13-10-2022;Красноярский край;165_195_days;SputnikV;68264;27888;96152;1637377;585822;2223199
2022.04_13-10-2022;Красноярский край;21_45_days;AllVaccines;15917;6656;22573;1637377;585822;2223199
2022.04_13-10-2022;Красноярский край;21_45_days;CoviVac;605;244;849;1637377;585822;2223199
2022.04_13-10-2022;Красноярский край;21_45_days;EpiVacCorona;1013;604;1617;1637377;585822;2223199
2022.04_13-10-2022;Красноярский край;21_45_days;SputnikLite;3995;484;4479;1637377;585822;2223199
2022.04_13-10-2022;Красноярский край;21_45_days;SputnikV;10304;5324;15628;1637377;585822;2223199
2022.04_13-10-2022;Красноярский край;45_75_days;AllVaccines;26666;9255;35921;1637377;585822;2223199
2022.04_13-10-2022;Красноярский край;45_75_days;CoviVac;611;353;964;1637377;585822;2223199
2022.04_13-10-2022;Красноярский край;45_75_days;EpiVacCorona;1335;657;1992;1637377;585822;2223199
2022.04_13-10-2022;Красноярский край;45_75_days;SputnikLite;5374;997;6371;1637377;585822;2223199
2022.04_13-10-2022;Красноярский край;45_75_days;SputnikV;19346;7248;26594;1637377;585822;2223199
2022.04_13-10-2022;Красноярский край;75_90_days;AllVaccines;36534;13097;49631;1637377;585822;2223199
2022.04_13-10-2022;Красноярский край;75_90_days;CoviVac;505;192;697;1637377;585822;2223199
2022.04_13-10-2022;Красноярский край;75_90_days;EpiVacCorona;940;558;1498;1637377;585822;2223199
2022.04_13-10-2022;Красноярский край;75_90_days;SputnikLite;16085;4731;20816;1637377;585822;2223199
2022.04_13-10-2022;Красноярский край;75_90_days;SputnikV;19004;7616;26620;1637377;585822;2223199
2022.04_13-10-2022;Красноярский край;90_105_days;AllVaccines;40949;16065;57014;1637377;585822;2223199
2022.04_13-10-2022;Красноярский край;90_105_days;CoviVac;670;282;952;1637377;585822;2223199
2022.04_13-10-2022;Красноярский край;90_105_days;EpiVacCorona;1156;790;1946;1637377;585822;2223199
2022.04_13-10-2022;Красноярский край;90_105_days;SputnikLite;21672;7699;29371;1637377;585822;2223199
2022.04_13-10-2022;Красноярский край;90_105_days;SputnikV;17451;7294;24745;1637377;585822;2223199
2022.04_13-10-2022;Курганская область;105_165_days;AllVaccines;59990;37336;97326;425081;217502;642583
2022.04_13-10-2022;Курганская область;105_165_days;CoviVac;823;287;1110;425081;217502;642583
2022.04_13-10-2022;Курганская область;105_165_days;EpiVacCorona;1924;1328;3252;425081;217502;642583
2022.04_13-10-2022;Курганская область;105_165_days;SputnikLite;26366;21526;47892;425081;217502;642583
2022.04_13-10-2022;Курганская область;105_165_days;SputnikV;30877;14195;45072;425081;217502;642583
2022.04_13-10-2022;Курганская область;165_195_days;AllVaccines;71463;30356;101819;425081;217502;642583
2022.04_13-10-2022;Курганская область;165_195_days;CoviVac;1177;364;1541;425081;217502;642583
2022.04_13-10-2022;Курганская область;165_195_days;EpiVacCorona;759;296;1055;425081;217502;642583
2022.04_13-10-2022;Курганская область;165_195_days;SputnikLite;12571;14035;26606;425081;217502;642583
2022.04_13-10-2022;Курганская область;165_195_days;SputnikV;56956;15661;72617;425081;217502;642583
2022.04_13-10-2022;Курганская область;21_45_days;AllVaccines;2649;2187;4836;425081;217502;642583
2022.04_13-10-2022;Курганская область;21_45_days;CoviVac;48;93;141;425081;217502;642583
2022.04_13-10-2022;Курганская область;21_45_days;EpiVacCorona;316;285;601;425081;217502;642583
2022.04_13-10-2022;Курганская область;21_45_days;SputnikLite;586;295;881;425081;217502;642583
2022.04_13-10-2022;Курганская область;21_45_days;SputnikV;1699;1514;3213;425081;217502;642583
2022.04_13-10-2022;Курганская область;45_75_days;AllVaccines;6197;4159;10356;425081;217502;642583
2022.04_13-10-2022;Курганская область;45_75_days;CoviVac;77;16;93;425081;217502;642583
2022.04_13-10-2022;Курганская область;45_75_days;EpiVacCorona;757;514;1271;425081;217502;642583
2022.04_13-10-2022;Курганская область;45_75_days;SputnikLite;2805;1810;4615;425081;217502;642583
2022.04_13-10-2022;Курганская область;45_75_days;SputnikV;2558;1819;4377;425081;217502;642583
2022.04_13-10-2022;Курганская область;75_90_days;AllVaccines;8056;5074;13130;425081;217502;642583
2022.04_13-10-2022;Курганская область;75_90_days;CoviVac;105;25;130;425081;217502;642583
2022.04_13-10-2022;Курганская область;75_90_days;EpiVacCorona;504;420;924;425081;217502;642583
2022.04_13-10-2022;Курганская область;75_90_days;SputnikLite;3841;2252;6093;425081;217502;642583
2022.04_13-10-2022;Курганская область;75_90_days;SputnikV;3606;2377;5983;425081;217502;642583
2022.04_13-10-2022;Курганская область;90_105_days;AllVaccines;15451;8882;24333;425081;217502;642583
2022.04_13-10-2022;Курганская область;90_105_days;CoviVac;88;25;113;425081;217502;642583
2022.04_13-10-2022;Курганская область;90_105_days;EpiVacCorona;863;578;1441;425081;217502;642583
2022.04_13-10-2022;Курганская область;90_105_days;SputnikLite;11244;6019;17263;425081;217502;642583
2022.04_13-10-2022;Курганская область;90_105_days;SputnikV;3256;2260;5516;425081;217502;642583
2022.04_13-10-2022;Курская область;105_165_days;AllVaccines;77270;38640;115910;604409;285634;890043
2022.04_13-10-2022;Курская область;105_165_days;CoviVac;2118;496;2614;604409;285634;890043
2022.04_13-10-2022;Курская область;105_165_days;EpiVacCorona;4801;2376;7177;604409;285634;890043
2022.04_13-10-2022;Курская область;105_165_days;SputnikLite;37115;19557;56672;604409;285634;890043
2022.04_13-10-2022;Курская область;105_165_days;SputnikV;33236;16211;49447;604409;285634;890043
2022.04_13-10-2022;Курская область;165_195_days;AllVaccines;62558;35510;98068;604409;285634;890043
2022.04_13-10-2022;Курская область;165_195_days;CoviVac;878;195;1073;604409;285634;890043
2022.04_13-10-2022;Курская область;165_195_days;EpiVacCorona;2499;1137;3636;604409;285634;890043
2022.04_13-10-2022;Курская область;165_195_days;SputnikLite;23476;18842;42318;604409;285634;890043
2022.04_13-10-2022;Курская область;165_195_days;SputnikV;35705;15336;51041;604409;285634;890043
2022.04_13-10-2022;Курская область;21_45_days;AllVaccines;6269;3033;9302;604409;285634;890043
2022.04_13-10-2022;Курская область;21_45_days;CoviVac;214;25;239;604409;285634;890043
2022.04_13-10-2022;Курская область;21_45_days;EpiVacCorona;420;212;632;604409;285634;890043
2022.04_13-10-2022;Курская область;21_45_days;SputnikLite;1364;338;1702;604409;285634;890043
2022.04_13-10-2022;Курская область;21_45_days;SputnikV;4271;2458;6729;604409;285634;890043
2022.04_13-10-2022;Курская область;45_75_days;AllVaccines;9703;3536;13239;604409;285634;890043
2022.04_13-10-2022;Курская область;45_75_days;CoviVac;508;104;612;604409;285634;890043
2022.04_13-10-2022;Курская область;45_75_days;EpiVacCorona;650;242;892;604409;285634;890043
2022.04_13-10-2022;Курская область;45_75_days;SputnikLite;2543;700;3243;604409;285634;890043
2022.04_13-10-2022;Курская область;45_75_days;SputnikV;6002;2490;8492;604409;285634;890043
2022.04_13-10-2022;Курская область;75_90_days;AllVaccines;9856;3824;13680;604409;285634;890043
2022.04_13-10-2022;Курская область;75_90_days;CoviVac;197;36;233;604409;285634;890043
2022.04_13-10-2022;Курская область;75_90_days;EpiVacCorona;612;240;852;604409;285634;890043
2022.04_13-10-2022;Курская область;75_90_days;SputnikLite;5437;1844;7281;604409;285634;890043
2022.04_13-10-2022;Курская область;75_90_days;SputnikV;3610;1704;5314;604409;285634;890043
2022.04_13-10-2022;Курская область;90_105_days;AllVaccines;13985;5424;19409;604409;285634;890043
2022.04_13-10-2022;Курская область;90_105_days;CoviVac;305;62;367;604409;285634;890043
2022.04_13-10-2022;Курская область;90_105_days;EpiVacCorona;666;367;1033;604409;285634;890043
2022.04_13-10-2022;Курская область;90_105_days;SputnikLite;9965;3419;13384;604409;285634;890043
2022.04_13-10-2022;Курская область;90_105_days;SputnikV;3049;1576;4625;604409;285634;890043
2022.04_13-10-2022;Ленинградская область;105_165_days;AllVaccines;135169;71022;206191;1100343;462742;1563085
2022.04_13-10-2022;Ленинградская область;105_165_days;CoviVac;1486;231;1717;1100343;462742;1563085
2022.04_13-10-2022;Ленинградская область;105_165_days;EpiVacCorona;3387;2015;5402;1100343;462742;1563085
2022.04_13-10-2022;Ленинградская область;105_165_days;SputnikLite;39296;31676;70972;1100343;462742;1563085
2022.04_13-10-2022;Ленинградская область;105_165_days;SputnikV;91000;37100;128100;1100343;462742;1563085
2022.04_13-10-2022;Ленинградская область;165_195_days;AllVaccines;86763;41307;128070;1100343;462742;1563085
2022.04_13-10-2022;Ленинградская область;165_195_days;CoviVac;1384;212;1596;1100343;462742;1563085
2022.04_13-10-2022;Ленинградская область;165_195_days;EpiVacCorona;1929;883;2812;1100343;462742;1563085
2022.04_13-10-2022;Ленинградская область;165_195_days;SputnikLite;26531;16736;43267;1100343;462742;1563085
2022.04_13-10-2022;Ленинградская область;165_195_days;SputnikV;56919;23476;80395;1100343;462742;1563085
2022.04_13-10-2022;Ленинградская область;21_45_days;AllVaccines;4395;3133;7528;1100343;462742;1563085
2022.04_13-10-2022;Ленинградская область;21_45_days;CoviVac;250;93;343;1100343;462742;1563085
2022.04_13-10-2022;Ленинградская область;21_45_days;EpiVacCorona;151;36;187;1100343;462742;1563085
2022.04_13-10-2022;Ленинградская область;21_45_days;SputnikLite;886;647;1533;1100343;462742;1563085
2022.04_13-10-2022;Ленинградская область;21_45_days;SputnikV;3108;2357;5465;1100343;462742;1563085
2022.04_13-10-2022;Ленинградская область;45_75_days;AllVaccines;10574;5568;16142;1100343;462742;1563085
2022.04_13-10-2022;Ленинградская область;45_75_days;CoviVac;213;25;238;1100343;462742;1563085
2022.04_13-10-2022;Ленинградская область;45_75_days;EpiVacCorona;199;86;285;1100343;462742;1563085
2022.04_13-10-2022;Ленинградская область;45_75_days;SputnikLite;2402;1649;4051;1100343;462742;1563085
2022.04_13-10-2022;Ленинградская область;45_75_days;SputnikV;7760;3808;11568;1100343;462742;1563085
2022.04_13-10-2022;Ленинградская область;75_90_days;AllVaccines;11665;5791;17456;1100343;462742;1563085
2022.04_13-10-2022;Ленинградская область;75_90_days;CoviVac;165;43;208;1100343;462742;1563085
2022.04_13-10-2022;Ленинградская область;75_90_days;EpiVacCorona;260;74;334;1100343;462742;1563085
2022.04_13-10-2022;Ленинградская область;75_90_days;SputnikLite;3588;1915;5503;1100343;462742;1563085
2022.04_13-10-2022;Ленинградская область;75_90_days;SputnikV;7652;3759;11411;1100343;462742;1563085
2022.04_13-10-2022;Ленинградская область;90_105_days;AllVaccines;16810;8241;25051;1100343;462742;1563085
2022.04_13-10-2022;Ленинградская область;90_105_days;CoviVac;177;32;209;1100343;462742;1563085
2022.04_13-10-2022;Ленинградская область;90_105_days;EpiVacCorona;278;195;473;1100343;462742;1563085
2022.04_13-10-2022;Ленинградская область;90_105_days;SputnikLite;6341;3744;10085;1100343;462742;1563085
2022.04_13-10-2022;Ленинградская область;90_105_days;SputnikV;10014;4270;14284;1100343;462742;1563085
2022.04_13-10-2022;Липецкая область;105_165_days;AllVaccines;81598;36238;117836;621641;290878;912519
2022.04_13-10-2022;Липецкая область;105_165_days;CoviVac;554;66;620;621641;290878;912519
2022.04_13-10-2022;Липецкая область;105_165_days;EpiVacCorona;5985;2104;8089;621641;290878;912519
2022.04_13-10-2022;Липецкая область;105_165_days;SputnikLite;25884;18888;44772;621641;290878;912519
2022.04_13-10-2022;Липецкая область;105_165_days;SputnikV;49175;15180;64355;621641;290878;912519
2022.04_13-10-2022;Липецкая область;165_195_days;AllVaccines;104174;36290;140464;621641;290878;912519
2022.04_13-10-2022;Липецкая область;165_195_days;CoviVac;278;39;317;621641;290878;912519
2022.04_13-10-2022;Липецкая область;165_195_days;EpiVacCorona;4402;778;5180;621641;290878;912519
2022.04_13-10-2022;Липецкая область;165_195_days;SputnikLite;23310;19444;42754;621641;290878;912519
2022.04_13-10-2022;Липецкая область;165_195_days;SputnikV;76184;16029;92213;621641;290878;912519
2022.04_13-10-2022;Липецкая область;21_45_days;AllVaccines;8529;5320;13849;621641;290878;912519
2022.04_13-10-2022;Липецкая область;21_45_days;CoviVac;636;77;713;621641;290878;912519
2022.04_13-10-2022;Липецкая область;21_45_days;EpiVacCorona;494;609;1103;621641;290878;912519
2022.04_13-10-2022;Липецкая область;21_45_days;SputnikLite;629;285;914;621641;290878;912519
2022.04_13-10-2022;Липецкая область;21_45_days;SputnikV;6770;4349;11119;621641;290878;912519
2022.04_13-10-2022;Липецкая область;45_75_days;AllVaccines;12759;5294;18053;621641;290878;912519
2022.04_13-10-2022;Липецкая область;45_75_days;CoviVac;654;27;681;621641;290878;912519
2022.04_13-10-2022;Липецкая область;45_75_days;EpiVacCorona;1019;640;1659;621641;290878;912519
2022.04_13-10-2022;Липецкая область;45_75_days;SputnikLite;2312;1079;3391;621641;290878;912519
2022.04_13-10-2022;Липецкая область;45_75_days;SputnikV;8774;3548;12322;621641;290878;912519
2022.04_13-10-2022;Липецкая область;75_90_days;AllVaccines;8982;3727;12709;621641;290878;912519
2022.04_13-10-2022;Липецкая область;75_90_days;CoviVac;248;16;264;621641;290878;912519
2022.04_13-10-2022;Липецкая область;75_90_days;EpiVacCorona;1075;658;1733;621641;290878;912519
2022.04_13-10-2022;Липецкая область;75_90_days;SputnikLite;2511;949;3460;621641;290878;912519
2022.04_13-10-2022;Липецкая область;75_90_days;SputnikV;5148;2104;7252;621641;290878;912519
2022.04_13-10-2022;Липецкая область;90_105_days;AllVaccines;12074;5108;17182;621641;290878;912519
2022.04_13-10-2022;Липецкая область;90_105_days;CoviVac;171;11;182;621641;290878;912519
2022.04_13-10-2022;Липецкая область;90_105_days;EpiVacCorona;459;189;648;621641;290878;912519
2022.04_13-10-2022;Липецкая область;90_105_days;SputnikLite;6721;2810;9531;621641;290878;912519
2022.04_13-10-2022;Липецкая область;90_105_days;SputnikV;4723;2098;6821;621641;290878;912519
2022.04_13-10-2022;Магаданская область;105_165_days;AllVaccines;13375;3601;16976;83196;26810;110006
2022.04_13-10-2022;Магаданская область;105_165_days;CoviVac;194;35;229;83196;26810;110006
2022.04_13-10-2022;Магаданская область;105_165_days;EpiVacCorona;1259;174;1433;83196;26810;110006
2022.04_13-10-2022;Магаданская область;105_165_days;SputnikLite;7025;2393;9418;83196;26810;110006
2022.04_13-10-2022;Магаданская область;105_165_days;SputnikV;4897;999;5896;83196;26810;110006
2022.04_13-10-2022;Магаданская область;165_195_days;AllVaccines;6780;2413;9193;83196;26810;110006
2022.04_13-10-2022;Магаданская область;165_195_days;CoviVac;168;46;214;83196;26810;110006
2022.04_13-10-2022;Магаданская область;165_195_days;EpiVacCorona;443;66;509;83196;26810;110006
2022.04_13-10-2022;Магаданская область;165_195_days;SputnikLite;4132;1779;5911;83196;26810;110006
2022.04_13-10-2022;Магаданская область;165_195_days;SputnikV;2037;522;2559;83196;26810;110006
2022.04_13-10-2022;Магаданская область;21_45_days;AllVaccines;1055;337;1392;83196;26810;110006
2022.04_13-10-2022;Магаданская область;21_45_days;CoviVac;1;0;1;83196;26810;110006
2022.04_13-10-2022;Магаданская область;21_45_days;EpiVacCorona;28;10;38;83196;26810;110006
2022.04_13-10-2022;Магаданская область;21_45_days;SputnikLite;763;250;1013;83196;26810;110006
2022.04_13-10-2022;Магаданская область;21_45_days;SputnikV;263;77;340;83196;26810;110006
2022.04_13-10-2022;Магаданская область;45_75_days;AllVaccines;1806;556;2362;83196;26810;110006
2022.04_13-10-2022;Магаданская область;45_75_days;CoviVac;12;4;16;83196;26810;110006
2022.04_13-10-2022;Магаданская область;45_75_days;EpiVacCorona;79;17;96;83196;26810;110006
2022.04_13-10-2022;Магаданская область;45_75_days;SputnikLite;1047;351;1398;83196;26810;110006
2022.04_13-10-2022;Магаданская область;45_75_days;SputnikV;668;184;852;83196;26810;110006
2022.04_13-10-2022;Магаданская область;75_90_days;AllVaccines;2108;505;2613;83196;26810;110006
2022.04_13-10-2022;Магаданская область;75_90_days;CoviVac;77;5;82;83196;26810;110006
2022.04_13-10-2022;Магаданская область;75_90_days;EpiVacCorona;111;34;145;83196;26810;110006
2022.04_13-10-2022;Магаданская область;75_90_days;SputnikLite;1134;245;1379;83196;26810;110006
2022.04_13-10-2022;Магаданская область;75_90_days;SputnikV;786;221;1007;83196;26810;110006
2022.04_13-10-2022;Магаданская область;90_105_days;AllVaccines;2371;627;2998;83196;26810;110006
2022.04_13-10-2022;Магаданская область;90_105_days;CoviVac;78;14;92;83196;26810;110006
2022.04_13-10-2022;Магаданская область;90_105_days;EpiVacCorona;128;31;159;83196;26810;110006
2022.04_13-10-2022;Магаданская область;90_105_days;SputnikLite;1518;384;1902;83196;26810;110006
2022.04_13-10-2022;Магаданская область;90_105_days;SputnikV;647;198;845;83196;26810;110006
2022.04_13-10-2022;Московская область;105_165_days;AllVaccines;454436;216706;671142;4485323;1674471;6159794
2022.04_13-10-2022;Московская область;105_165_days;CoviVac;4876;1896;6772;4485323;1674471;6159794
2022.04_13-10-2022;Московская область;105_165_days;EpiVacCorona;6548;5332;11880;4485323;1674471;6159794
2022.04_13-10-2022;Московская область;105_165_days;SputnikLite;157683;103009;260692;4485323;1674471;6159794
2022.04_13-10-2022;Московская область;105_165_days;SputnikV;285329;106469;391798;4485323;1674471;6159794
2022.04_13-10-2022;Московская область;165_195_days;AllVaccines;319557;165726;485283;4485323;1674471;6159794
2022.04_13-10-2022;Московская область;165_195_days;CoviVac;3648;1582;5230;4485323;1674471;6159794
2022.04_13-10-2022;Московская область;165_195_days;EpiVacCorona;5203;4306;9509;4485323;1674471;6159794
2022.04_13-10-2022;Московская область;165_195_days;SputnikLite;72292;65260;137552;4485323;1674471;6159794
2022.04_13-10-2022;Московская область;165_195_days;SputnikV;238414;94578;332992;4485323;1674471;6159794
2022.04_13-10-2022;Московская область;21_45_days;AllVaccines;32253;16498;48751;4485323;1674471;6159794
2022.04_13-10-2022;Московская область;21_45_days;CoviVac;402;103;505;4485323;1674471;6159794
2022.04_13-10-2022;Московская область;21_45_days;EpiVacCorona;1212;807;2019;4485323;1674471;6159794
2022.04_13-10-2022;Московская область;21_45_days;SputnikLite;13064;8644;21708;4485323;1674471;6159794
2022.04_13-10-2022;Московская область;21_45_days;SputnikV;17575;6944;24519;4485323;1674471;6159794
2022.04_13-10-2022;Московская область;45_75_days;AllVaccines;71330;29264;100594;4485323;1674471;6159794
2022.04_13-10-2022;Московская область;45_75_days;CoviVac;684;209;893;4485323;1674471;6159794
2022.04_13-10-2022;Московская область;45_75_days;EpiVacCorona;1593;1160;2753;4485323;1674471;6159794
2022.04_13-10-2022;Московская область;45_75_days;SputnikLite;25425;14916;40341;4485323;1674471;6159794
2022.04_13-10-2022;Московская область;45_75_days;SputnikV;43628;12979;56607;4485323;1674471;6159794
2022.04_13-10-2022;Московская область;75_90_days;AllVaccines;72841;25967;98808;4485323;1674471;6159794
2022.04_13-10-2022;Московская область;75_90_days;CoviVac;646;166;812;4485323;1674471;6159794
2022.04_13-10-2022;Московская область;75_90_days;EpiVacCorona;1434;607;2041;4485323;1674471;6159794
2022.04_13-10-2022;Московская область;75_90_days;SputnikLite;29408;13294;42702;4485323;1674471;6159794
2022.04_13-10-2022;Московская область;75_90_days;SputnikV;41353;11900;53253;4485323;1674471;6159794
2022.04_13-10-2022;Московская область;90_105_days;AllVaccines;90726;35098;125824;4485323;1674471;6159794
2022.04_13-10-2022;Московская область;90_105_days;CoviVac;1241;385;1626;4485323;1674471;6159794
2022.04_13-10-2022;Московская область;90_105_days;EpiVacCorona;1340;898;2238;4485323;1674471;6159794
2022.04_13-10-2022;Московская область;90_105_days;SputnikLite;42337;18190;60527;4485323;1674471;6159794
2022.04_13-10-2022;Московская область;90_105_days;SputnikV;45808;15625;61433;4485323;1674471;6159794
2022.04_13-10-2022;Мурманская область;105_165_days;AllVaccines;64765;21859;86624;436555;144366;580921
2022.04_13-10-2022;Мурманская область;105_165_days;CoviVac;1068;124;1192;436555;144366;580921
2022.04_13-10-2022;Мурманская область;105_165_days;EpiVacCorona;2630;835;3465;436555;144366;580921
2022.04_13-10-2022;Мурманская область;105_165_days;SputnikLite;28531;12001;40532;436555;144366;580921
2022.04_13-10-2022;Мурманская область;105_165_days;SputnikV;32536;8899;41435;436555;144366;580921
2022.04_13-10-2022;Мурманская область;165_195_days;AllVaccines;38657;14089;52746;436555;144366;580921
2022.04_13-10-2022;Мурманская область;165_195_days;CoviVac;579;87;666;436555;144366;580921
2022.04_13-10-2022;Мурманская область;165_195_days;EpiVacCorona;845;460;1305;436555;144366;580921
2022.04_13-10-2022;Мурманская область;165_195_days;SputnikLite;24710;8917;33627;436555;144366;580921
2022.04_13-10-2022;Мурманская область;165_195_days;SputnikV;12523;4625;17148;436555;144366;580921
2022.04_13-10-2022;Мурманская область;21_45_days;AllVaccines;4722;1915;6637;436555;144366;580921
2022.04_13-10-2022;Мурманская область;21_45_days;CoviVac;150;32;182;436555;144366;580921
2022.04_13-10-2022;Мурманская область;21_45_days;EpiVacCorona;31;30;61;436555;144366;580921
2022.04_13-10-2022;Мурманская область;21_45_days;SputnikLite;2772;1233;4005;436555;144366;580921
2022.04_13-10-2022;Мурманская область;21_45_days;SputnikV;1769;620;2389;436555;144366;580921
2022.04_13-10-2022;Мурманская область;45_75_days;AllVaccines;7640;2957;10597;436555;144366;580921
2022.04_13-10-2022;Мурманская область;45_75_days;CoviVac;195;38;233;436555;144366;580921
2022.04_13-10-2022;Мурманская область;45_75_days;EpiVacCorona;42;15;57;436555;144366;580921
2022.04_13-10-2022;Мурманская область;45_75_days;SputnikLite;4038;1855;5893;436555;144366;580921
2022.04_13-10-2022;Мурманская область;45_75_days;SputnikV;3365;1049;4414;436555;144366;580921
2022.04_13-10-2022;Мурманская область;75_90_days;AllVaccines;6961;2475;9436;436555;144366;580921
2022.04_13-10-2022;Мурманская область;75_90_days;CoviVac;106;5;111;436555;144366;580921
2022.04_13-10-2022;Мурманская область;75_90_days;EpiVacCorona;60;32;92;436555;144366;580921
2022.04_13-10-2022;Мурманская область;75_90_days;SputnikLite;3826;1364;5190;436555;144366;580921
2022.04_13-10-2022;Мурманская область;75_90_days;SputnikV;2969;1074;4043;436555;144366;580921
2022.04_13-10-2022;Мурманская область;90_105_days;AllVaccines;8451;3494;11945;436555;144366;580921
2022.04_13-10-2022;Мурманская область;90_105_days;CoviVac;194;35;229;436555;144366;580921
2022.04_13-10-2022;Мурманская область;90_105_days;EpiVacCorona;85;42;127;436555;144366;580921
2022.04_13-10-2022;Мурманская область;90_105_days;SputnikLite;5219;2137;7356;436555;144366;580921
2022.04_13-10-2022;Мурманская область;90_105_days;SputnikV;2953;1280;4233;436555;144366;580921
2022.04_13-10-2022;Ненецкий автономный округ;105_165_days;AllVaccines;2708;911;3619;24931;7449;32380
2022.04_13-10-2022;Ненецкий автономный округ;105_165_days;EpiVacCorona;97;14;111;24931;7449;32380
2022.04_13-10-2022;Ненецкий автономный округ;105_165_days;SputnikLite;2038;808;2846;24931;7449;32380
2022.04_13-10-2022;Ненецкий автономный округ;105_165_days;SputnikV;573;89;662;24931;7449;32380
2022.04_13-10-2022;Ненецкий автономный округ;165_195_days;AllVaccines;2642;855;3497;24931;7449;32380
2022.04_13-10-2022;Ненецкий автономный округ;165_195_days;CoviVac;3;0;3;24931;7449;32380
2022.04_13-10-2022;Ненецкий автономный округ;165_195_days;EpiVacCorona;51;5;56;24931;7449;32380
2022.04_13-10-2022;Ненецкий автономный округ;165_195_days;SputnikLite;2230;769;2999;24931;7449;32380
2022.04_13-10-2022;Ненецкий автономный округ;165_195_days;SputnikV;358;81;439;24931;7449;32380
2022.04_13-10-2022;Ненецкий автономный округ;21_45_days;AllVaccines;140;64;204;24931;7449;32380
2022.04_13-10-2022;Ненецкий автономный округ;21_45_days;EpiVacCorona;4;0;4;24931;7449;32380
2022.04_13-10-2022;Ненецкий автономный округ;21_45_days;SputnikLite;123;62;185;24931;7449;32380
2022.04_13-10-2022;Ненецкий автономный округ;21_45_days;SputnikV;13;2;15;24931;7449;32380
2022.04_13-10-2022;Ненецкий автономный округ;45_75_days;AllVaccines;297;153;450;24931;7449;32380
2022.04_13-10-2022;Ненецкий автономный округ;45_75_days;EpiVacCorona;3;0;3;24931;7449;32380
2022.04_13-10-2022;Ненецкий автономный округ;45_75_days;SputnikLite;242;128;370;24931;7449;32380
2022.04_13-10-2022;Ненецкий автономный округ;45_75_days;SputnikV;52;25;77;24931;7449;32380
2022.04_13-10-2022;Ненецкий автономный округ;75_90_days;AllVaccines;211;104;315;24931;7449;32380
2022.04_13-10-2022;Ненецкий автономный округ;75_90_days;EpiVacCorona;1;0;1;24931;7449;32380
2022.04_13-10-2022;Ненецкий автономный округ;75_90_days;SputnikLite;148;84;232;24931;7449;32380
2022.04_13-10-2022;Ненецкий автономный округ;75_90_days;SputnikV;62;20;82;24931;7449;32380
2022.04_13-10-2022;Ненецкий автономный округ;90_105_days;AllVaccines;293;137;430;24931;7449;32380
2022.04_13-10-2022;Ненецкий автономный округ;90_105_days;SputnikLite;215;121;336;24931;7449;32380
2022.04_13-10-2022;Ненецкий автономный округ;90_105_days;SputnikV;78;16;94;24931;7449;32380
2022.04_13-10-2022;Нижегородская область;105_165_days;AllVaccines;205401;126778;332179;1769909;800663;2570572
2022.04_13-10-2022;Нижегородская область;105_165_days;CoviVac;970;311;1281;1769909;800663;2570572
2022.04_13-10-2022;Нижегородская область;105_165_days;EpiVacCorona;5771;4584;10355;1769909;800663;2570572
2022.04_13-10-2022;Нижегородская область;105_165_days;SputnikLite;82472;61313;143785;1769909;800663;2570572
2022.04_13-10-2022;Нижегородская область;105_165_days;SputnikV;116188;60570;176758;1769909;800663;2570572
2022.04_13-10-2022;Нижегородская область;165_195_days;AllVaccines;168220;89148;257368;1769909;800663;2570572
2022.04_13-10-2022;Нижегородская область;165_195_days;CoviVac;1027;189;1216;1769909;800663;2570572
2022.04_13-10-2022;Нижегородская область;165_195_days;EpiVacCorona;3298;1783;5081;1769909;800663;2570572
2022.04_13-10-2022;Нижегородская область;165_195_days;SputnikLite;47259;40010;87269;1769909;800663;2570572
2022.04_13-10-2022;Нижегородская область;165_195_days;SputnikV;116636;47166;163802;1769909;800663;2570572
2022.04_13-10-2022;Нижегородская область;21_45_days;AllVaccines;8259;6767;15026;1769909;800663;2570572
2022.04_13-10-2022;Нижегородская область;21_45_days;CoviVac;244;78;322;1769909;800663;2570572
2022.04_13-10-2022;Нижегородская область;21_45_days;EpiVacCorona;652;489;1141;1769909;800663;2570572
2022.04_13-10-2022;Нижегородская область;21_45_days;SputnikLite;1177;761;1938;1769909;800663;2570572
2022.04_13-10-2022;Нижегородская область;21_45_days;SputnikV;6186;5439;11625;1769909;800663;2570572
2022.04_13-10-2022;Нижегородская область;45_75_days;AllVaccines;15710;7875;23585;1769909;800663;2570572
2022.04_13-10-2022;Нижегородская область;45_75_days;CoviVac;451;132;583;1769909;800663;2570572
2022.04_13-10-2022;Нижегородская область;45_75_days;EpiVacCorona;1319;897;2216;1769909;800663;2570572
2022.04_13-10-2022;Нижегородская область;45_75_days;SputnikLite;2967;1898;4865;1769909;800663;2570572
2022.04_13-10-2022;Нижегородская область;45_75_days;SputnikV;10973;4948;15921;1769909;800663;2570572
2022.04_13-10-2022;Нижегородская область;75_90_days;AllVaccines;18098;7871;25969;1769909;800663;2570572
2022.04_13-10-2022;Нижегородская область;75_90_days;CoviVac;334;75;409;1769909;800663;2570572
2022.04_13-10-2022;Нижегородская область;75_90_days;EpiVacCorona;644;425;1069;1769909;800663;2570572
2022.04_13-10-2022;Нижегородская область;75_90_days;SputnikLite;7632;3065;10697;1769909;800663;2570572
2022.04_13-10-2022;Нижегородская область;75_90_days;SputnikV;9488;4306;13794;1769909;800663;2570572
2022.04_13-10-2022;Нижегородская область;90_105_days;AllVaccines;26167;12221;38388;1769909;800663;2570572
2022.04_13-10-2022;Нижегородская область;90_105_days;CoviVac;477;154;631;1769909;800663;2570572
2022.04_13-10-2022;Нижегородская область;90_105_days;EpiVacCorona;630;473;1103;1769909;800663;2570572
2022.04_13-10-2022;Нижегородская область;90_105_days;SputnikLite;15914;6645;22559;1769909;800663;2570572
2022.04_13-10-2022;Нижегородская область;90_105_days;SputnikV;9146;4949;14095;1769909;800663;2570572
2022.04_13-10-2022;Новгородская область;105_165_days;AllVaccines;32524;21832;54356;317276;158308;475584
2022.04_13-10-2022;Новгородская область;105_165_days;CoviVac;1192;437;1629;317276;158308;475584
2022.04_13-10-2022;Новгородская область;105_165_days;EpiVacCorona;2745;1536;4281;317276;158308;475584
2022.04_13-10-2022;Новгородская область;105_165_days;SputnikLite;10315;9254;19569;317276;158308;475584
2022.04_13-10-2022;Новгородская область;105_165_days;SputnikV;18272;10605;28877;317276;158308;475584
2022.04_13-10-2022;Новгородская область;165_195_days;AllVaccines;24995;15506;40501;317276;158308;475584
2022.04_13-10-2022;Новгородская область;165_195_days;CoviVac;356;104;460;317276;158308;475584
2022.04_13-10-2022;Новгородская область;165_195_days;EpiVacCorona;870;352;1222;317276;158308;475584
2022.04_13-10-2022;Новгородская область;165_195_days;SputnikLite;11645;8717;20362;317276;158308;475584
2022.04_13-10-2022;Новгородская область;165_195_days;SputnikV;12124;6333;18457;317276;158308;475584
2022.04_13-10-2022;Новгородская область;21_45_days;AllVaccines;1345;1202;2547;317276;158308;475584
2022.04_13-10-2022;Новгородская область;21_45_days;CoviVac;106;33;139;317276;158308;475584
2022.04_13-10-2022;Новгородская область;21_45_days;EpiVacCorona;77;85;162;317276;158308;475584
2022.04_13-10-2022;Новгородская область;21_45_days;SputnikLite;327;317;644;317276;158308;475584
2022.04_13-10-2022;Новгородская область;21_45_days;SputnikV;835;767;1602;317276;158308;475584
2022.04_13-10-2022;Новгородская область;45_75_days;AllVaccines;2761;2152;4913;317276;158308;475584
2022.04_13-10-2022;Новгородская область;45_75_days;CoviVac;171;51;222;317276;158308;475584
2022.04_13-10-2022;Новгородская область;45_75_days;EpiVacCorona;163;165;328;317276;158308;475584
2022.04_13-10-2022;Новгородская область;45_75_days;SputnikLite;456;512;968;317276;158308;475584
2022.04_13-10-2022;Новгородская область;45_75_days;SputnikV;1971;1424;3395;317276;158308;475584
2022.04_13-10-2022;Новгородская область;75_90_days;AllVaccines;2971;1924;4895;317276;158308;475584
2022.04_13-10-2022;Новгородская область;75_90_days;CoviVac;118;60;178;317276;158308;475584
2022.04_13-10-2022;Новгородская область;75_90_days;EpiVacCorona;221;171;392;317276;158308;475584
2022.04_13-10-2022;Новгородская область;75_90_days;SputnikLite;685;406;1091;317276;158308;475584
2022.04_13-10-2022;Новгородская область;75_90_days;SputnikV;1947;1287;3234;317276;158308;475584
2022.04_13-10-2022;Новгородская область;90_105_days;AllVaccines;4453;3402;7855;317276;158308;475584
2022.04_13-10-2022;Новгородская область;90_105_days;CoviVac;202;83;285;317276;158308;475584
2022.04_13-10-2022;Новгородская область;90_105_days;EpiVacCorona;328;276;604;317276;158308;475584
2022.04_13-10-2022;Новгородская область;90_105_days;SputnikLite;1781;1245;3026;317276;158308;475584
2022.04_13-10-2022;Новгородская область;90_105_days;SputnikV;2142;1798;3940;317276;158308;475584
2022.04_13-10-2022;Новосибирская область;105_165_days;AllVaccines;287255;128100;415355;1571829;624100;2195929
2022.04_13-10-2022;Новосибирская область;105_165_days;CoviVac;1316;343;1659;1571829;624100;2195929
2022.04_13-10-2022;Новосибирская область;105_165_days;EpiVacCorona;6715;2979;9694;1571829;624100;2195929
2022.04_13-10-2022;Новосибирская область;105_165_days;SputnikLite;89882;68376;158258;1571829;624100;2195929
2022.04_13-10-2022;Новосибирская область;105_165_days;SputnikV;189342;56402;245744;1571829;624100;2195929
2022.04_13-10-2022;Новосибирская область;165_195_days;AllVaccines;142071;53593;195664;1571829;624100;2195929
2022.04_13-10-2022;Новосибирская область;165_195_days;CoviVac;1166;142;1308;1571829;624100;2195929
2022.04_13-10-2022;Новосибирская область;165_195_days;EpiVacCorona;4537;1413;5950;1571829;624100;2195929
2022.04_13-10-2022;Новосибирская область;165_195_days;SputnikLite;28957;19287;48244;1571829;624100;2195929
2022.04_13-10-2022;Новосибирская область;165_195_days;SputnikV;107411;32751;140162;1571829;624100;2195929
2022.04_13-10-2022;Новосибирская область;21_45_days;AllVaccines;8427;5888;14315;1571829;624100;2195929
2022.04_13-10-2022;Новосибирская область;21_45_days;CoviVac;447;133;580;1571829;624100;2195929
2022.04_13-10-2022;Новосибирская область;21_45_days;EpiVacCorona;431;413;844;1571829;624100;2195929
2022.04_13-10-2022;Новосибирская область;21_45_days;SputnikLite;695;411;1106;1571829;624100;2195929
2022.04_13-10-2022;Новосибирская область;21_45_days;SputnikV;6854;4931;11785;1571829;624100;2195929
2022.04_13-10-2022;Новосибирская область;45_75_days;AllVaccines;13664;7185;20849;1571829;624100;2195929
2022.04_13-10-2022;Новосибирская область;45_75_days;CoviVac;590;156;746;1571829;624100;2195929
2022.04_13-10-2022;Новосибирская область;45_75_days;EpiVacCorona;565;281;846;1571829;624100;2195929
2022.04_13-10-2022;Новосибирская область;45_75_days;SputnikLite;947;618;1565;1571829;624100;2195929
2022.04_13-10-2022;Новосибирская область;45_75_days;SputnikV;11562;6130;17692;1571829;624100;2195929
2022.04_13-10-2022;Новосибирская область;75_90_days;AllVaccines;25635;12251;37886;1571829;624100;2195929
2022.04_13-10-2022;Новосибирская область;75_90_days;CoviVac;398;82;480;1571829;624100;2195929
2022.04_13-10-2022;Новосибирская область;75_90_days;EpiVacCorona;589;336;925;1571829;624100;2195929
2022.04_13-10-2022;Новосибирская область;75_90_days;SputnikLite;12322;5558;17880;1571829;624100;2195929
2022.04_13-10-2022;Новосибирская область;75_90_days;SputnikV;12326;6275;18601;1571829;624100;2195929
2022.04_13-10-2022;Новосибирская область;90_105_days;AllVaccines;31578;15934;47512;1571829;624100;2195929
2022.04_13-10-2022;Новосибирская область;90_105_days;CoviVac;694;161;855;1571829;624100;2195929
2022.04_13-10-2022;Новосибирская область;90_105_days;EpiVacCorona;810;616;1426;1571829;624100;2195929
2022.04_13-10-2022;Новосибирская область;90_105_days;SputnikLite;15972;8124;24096;1571829;624100;2195929
2022.04_13-10-2022;Новосибирская область;90_105_days;SputnikV;14102;7033;21135;1571829;624100;2195929
2022.04_13-10-2022;Омская область;105_165_days;AllVaccines;171319;73735;245054;1058291;431046;1489337
2022.04_13-10-2022;Омская область;105_165_days;CoviVac;1194;311;1505;1058291;431046;1489337
2022.04_13-10-2022;Омская область;105_165_days;EpiVacCorona;4929;1867;6796;1058291;431046;1489337
2022.04_13-10-2022;Омская область;105_165_days;SputnikLite;50314;29608;79922;1058291;431046;1489337
2022.04_13-10-2022;Омская область;105_165_days;SputnikV;114882;41949;156831;1058291;431046;1489337
2022.04_13-10-2022;Омская область;165_195_days;AllVaccines;96190;40635;136825;1058291;431046;1489337
2022.04_13-10-2022;Омская область;165_195_days;CoviVac;983;234;1217;1058291;431046;1489337
2022.04_13-10-2022;Омская область;165_195_days;EpiVacCorona;3094;964;4058;1058291;431046;1489337
2022.04_13-10-2022;Омская область;165_195_days;SputnikLite;21161;13166;34327;1058291;431046;1489337
2022.04_13-10-2022;Омская область;165_195_days;SputnikV;70952;26271;97223;1058291;431046;1489337
2022.04_13-10-2022;Омская область;21_45_days;AllVaccines;8372;3881;12253;1058291;431046;1489337
2022.04_13-10-2022;Омская область;21_45_days;CoviVac;320;81;401;1058291;431046;1489337
2022.04_13-10-2022;Омская область;21_45_days;EpiVacCorona;892;353;1245;1058291;431046;1489337
2022.04_13-10-2022;Омская область;21_45_days;SputnikLite;1627;721;2348;1058291;431046;1489337
2022.04_13-10-2022;Омская область;21_45_days;SputnikV;5533;2726;8259;1058291;431046;1489337
2022.04_13-10-2022;Омская область;45_75_days;AllVaccines;18944;7022;25966;1058291;431046;1489337
2022.04_13-10-2022;Омская область;45_75_days;CoviVac;384;78;462;1058291;431046;1489337
2022.04_13-10-2022;Омская область;45_75_days;EpiVacCorona;1121;472;1593;1058291;431046;1489337
2022.04_13-10-2022;Омская область;45_75_days;SputnikLite;5800;2076;7876;1058291;431046;1489337
2022.04_13-10-2022;Омская область;45_75_days;SputnikV;11639;4396;16035;1058291;431046;1489337
2022.04_13-10-2022;Омская область;75_90_days;AllVaccines;19433;6985;26418;1058291;431046;1489337
2022.04_13-10-2022;Омская область;75_90_days;CoviVac;244;60;304;1058291;431046;1489337
2022.04_13-10-2022;Омская область;75_90_days;EpiVacCorona;616;256;872;1058291;431046;1489337
2022.04_13-10-2022;Омская область;75_90_days;SputnikLite;7472;2062;9534;1058291;431046;1489337
2022.04_13-10-2022;Омская область;75_90_days;SputnikV;11101;4607;15708;1058291;431046;1489337
2022.04_13-10-2022;Омская область;90_105_days;AllVaccines;22805;8830;31635;1058291;431046;1489337
2022.04_13-10-2022;Омская область;90_105_days;CoviVac;300;61;361;1058291;431046;1489337
2022.04_13-10-2022;Омская область;90_105_days;EpiVacCorona;724;373;1097;1058291;431046;1489337
2022.04_13-10-2022;Омская область;90_105_days;SputnikLite;10840;3602;14442;1058291;431046;1489337
2022.04_13-10-2022;Омская область;90_105_days;SputnikV;10941;4794;15735;1058291;431046;1489337
2022.04_13-10-2022;Оренбургская область;105_165_days;AllVaccines;141088;67462;208550;1068899;440686;1509585
2022.04_13-10-2022;Оренбургская область;105_165_days;CoviVac;1529;221;1750;1068899;440686;1509585
2022.04_13-10-2022;Оренбургская область;105_165_days;EpiVacCorona;8066;3567;11633;1068899;440686;1509585
2022.04_13-10-2022;Оренбургская область;105_165_days;SputnikLite;69716;37699;107415;1068899;440686;1509585
2022.04_13-10-2022;Оренбургская область;105_165_days;SputnikV;61777;25975;87752;1068899;440686;1509585
2022.04_13-10-2022;Оренбургская область;165_195_days;AllVaccines;124073;57035;181108;1068899;440686;1509585
2022.04_13-10-2022;Оренбургская область;165_195_days;CoviVac;1332;221;1553;1068899;440686;1509585
2022.04_13-10-2022;Оренбургская область;165_195_days;EpiVacCorona;4433;1524;5957;1068899;440686;1509585
2022.04_13-10-2022;Оренбургская область;165_195_days;SputnikLite;26602;27396;53998;1068899;440686;1509585
2022.04_13-10-2022;Оренбургская область;165_195_days;SputnikV;91706;27894;119600;1068899;440686;1509585
2022.04_13-10-2022;Оренбургская область;21_45_days;AllVaccines;9013;4351;13364;1068899;440686;1509585
2022.04_13-10-2022;Оренбургская область;21_45_days;CoviVac;619;44;663;1068899;440686;1509585
2022.04_13-10-2022;Оренбургская область;21_45_days;EpiVacCorona;484;216;700;1068899;440686;1509585
2022.04_13-10-2022;Оренбургская область;21_45_days;SputnikLite;122;61;183;1068899;440686;1509585
2022.04_13-10-2022;Оренбургская область;21_45_days;SputnikV;7788;4030;11818;1068899;440686;1509585
2022.04_13-10-2022;Оренбургская область;45_75_days;AllVaccines;12880;4308;17188;1068899;440686;1509585
2022.04_13-10-2022;Оренбургская область;45_75_days;CoviVac;610;51;661;1068899;440686;1509585
2022.04_13-10-2022;Оренбургская область;45_75_days;EpiVacCorona;702;238;940;1068899;440686;1509585
2022.04_13-10-2022;Оренбургская область;45_75_days;SputnikLite;1039;299;1338;1068899;440686;1509585
2022.04_13-10-2022;Оренбургская область;45_75_days;SputnikV;10529;3720;14249;1068899;440686;1509585
2022.04_13-10-2022;Оренбургская область;75_90_days;AllVaccines;25525;8359;33884;1068899;440686;1509585
2022.04_13-10-2022;Оренбургская область;75_90_days;CoviVac;321;27;348;1068899;440686;1509585
2022.04_13-10-2022;Оренбургская область;75_90_days;EpiVacCorona;723;300;1023;1068899;440686;1509585
2022.04_13-10-2022;Оренбургская область;75_90_days;SputnikLite;13710;4377;18087;1068899;440686;1509585
2022.04_13-10-2022;Оренбургская область;75_90_days;SputnikV;10771;3655;14426;1068899;440686;1509585
2022.04_13-10-2022;Оренбургская область;90_105_days;AllVaccines;35744;12622;48366;1068899;440686;1509585
2022.04_13-10-2022;Оренбургская область;90_105_days;CoviVac;509;38;547;1068899;440686;1509585
2022.04_13-10-2022;Оренбургская область;90_105_days;EpiVacCorona;1303;526;1829;1068899;440686;1509585
2022.04_13-10-2022;Оренбургская область;90_105_days;SputnikLite;24693;8343;33036;1068899;440686;1509585
2022.04_13-10-2022;Оренбургская область;90_105_days;SputnikV;9239;3715;12954;1068899;440686;1509585
2022.04_13-10-2022;Орловская область;105_165_days;AllVaccines;65436;31251;96687;398663;193123;591786
2022.04_13-10-2022;Орловская область;105_165_days;CoviVac;2085;569;2654;398663;193123;591786
2022.04_13-10-2022;Орловская область;105_165_days;EpiVacCorona;1284;587;1871;398663;193123;591786
2022.04_13-10-2022;Орловская область;105_165_days;SputnikLite;18486;14261;32747;398663;193123;591786
2022.04_13-10-2022;Орловская область;105_165_days;SputnikV;43581;15834;59415;398663;193123;591786
2022.04_13-10-2022;Орловская область;165_195_days;AllVaccines;42370;19994;62364;398663;193123;591786
2022.04_13-10-2022;Орловская область;165_195_days;CoviVac;894;190;1084;398663;193123;591786
2022.04_13-10-2022;Орловская область;165_195_days;EpiVacCorona;431;246;677;398663;193123;591786
2022.04_13-10-2022;Орловская область;165_195_days;SputnikLite;12715;10174;22889;398663;193123;591786
2022.04_13-10-2022;Орловская область;165_195_days;SputnikV;28330;9384;37714;398663;193123;591786
2022.04_13-10-2022;Орловская область;21_45_days;AllVaccines;1979;1276;3255;398663;193123;591786
2022.04_13-10-2022;Орловская область;21_45_days;CoviVac;73;6;79;398663;193123;591786
2022.04_13-10-2022;Орловская область;21_45_days;EpiVacCorona;191;55;246;398663;193123;591786
2022.04_13-10-2022;Орловская область;21_45_days;SputnikLite;114;74;188;398663;193123;591786
2022.04_13-10-2022;Орловская область;21_45_days;SputnikV;1601;1141;2742;398663;193123;591786
2022.04_13-10-2022;Орловская область;45_75_days;AllVaccines;3802;1610;5412;398663;193123;591786
2022.04_13-10-2022;Орловская область;45_75_days;CoviVac;157;23;180;398663;193123;591786
2022.04_13-10-2022;Орловская область;45_75_days;EpiVacCorona;384;114;498;398663;193123;591786
2022.04_13-10-2022;Орловская область;45_75_days;SputnikLite;385;187;572;398663;193123;591786
2022.04_13-10-2022;Орловская область;45_75_days;SputnikV;2876;1286;4162;398663;193123;591786
2022.04_13-10-2022;Орловская область;75_90_days;AllVaccines;3527;1734;5261;398663;193123;591786
2022.04_13-10-2022;Орловская область;75_90_days;CoviVac;82;8;90;398663;193123;591786
2022.04_13-10-2022;Орловская область;75_90_days;EpiVacCorona;251;78;329;398663;193123;591786
2022.04_13-10-2022;Орловская область;75_90_days;SputnikLite;1340;712;2052;398663;193123;591786
2022.04_13-10-2022;Орловская область;75_90_days;SputnikV;1854;936;2790;398663;193123;591786
2022.04_13-10-2022;Орловская область;90_105_days;AllVaccines;6436;3338;9774;398663;193123;591786
2022.04_13-10-2022;Орловская область;90_105_days;CoviVac;127;28;155;398663;193123;591786
2022.04_13-10-2022;Орловская область;90_105_days;EpiVacCorona;244;108;352;398663;193123;591786
2022.04_13-10-2022;Орловская область;90_105_days;SputnikLite;4135;2159;6294;398663;193123;591786
2022.04_13-10-2022;Орловская область;90_105_days;SputnikV;1930;1043;2973;398663;193123;591786
2022.04_13-10-2022;Пензенская область;105_165_days;AllVaccines;95683;73731;169414;710438;350687;1061125
2022.04_13-10-2022;Пензенская область;105_165_days;CoviVac;1152;413;1565;710438;350687;1061125
2022.04_13-10-2022;Пензенская область;105_165_days;EpiVacCorona;2142;4511;6653;710438;350687;1061125
2022.04_13-10-2022;Пензенская область;105_165_days;SputnikLite;38303;22739;61042;710438;350687;1061125
2022.04_13-10-2022;Пензенская область;105_165_days;SputnikV;54086;46068;100154;710438;350687;1061125
2022.04_13-10-2022;Пензенская область;165_195_days;AllVaccines;123977;45292;169269;710438;350687;1061125
2022.04_13-10-2022;Пензенская область;165_195_days;CoviVac;1458;200;1658;710438;350687;1061125
2022.04_13-10-2022;Пензенская область;165_195_days;EpiVacCorona;2479;574;3053;710438;350687;1061125
2022.04_13-10-2022;Пензенская область;165_195_days;SputnikLite;8522;5086;13608;710438;350687;1061125
2022.04_13-10-2022;Пензенская область;165_195_days;SputnikV;111518;39432;150950;710438;350687;1061125
2022.04_13-10-2022;Пензенская область;21_45_days;AllVaccines;16372;31408;47780;710438;350687;1061125
2022.04_13-10-2022;Пензенская область;21_45_days;CoviVac;447;286;733;710438;350687;1061125
2022.04_13-10-2022;Пензенская область;21_45_days;EpiVacCorona;909;1900;2809;710438;350687;1061125
2022.04_13-10-2022;Пензенская область;21_45_days;SputnikLite;657;376;1033;710438;350687;1061125
2022.04_13-10-2022;Пензенская область;21_45_days;SputnikV;14359;28846;43205;710438;350687;1061125
2022.04_13-10-2022;Пензенская область;45_75_days;AllVaccines;21011;29917;50928;710438;350687;1061125
2022.04_13-10-2022;Пензенская область;45_75_days;CoviVac;924;510;1434;710438;350687;1061125
2022.04_13-10-2022;Пензенская область;45_75_days;EpiVacCorona;1779;4482;6261;710438;350687;1061125
2022.04_13-10-2022;Пензенская область;45_75_days;SputnikLite;5360;3087;8447;710438;350687;1061125
2022.04_13-10-2022;Пензенская область;45_75_days;SputnikV;12948;21838;34786;710438;350687;1061125
2022.04_13-10-2022;Пензенская область;75_90_days;AllVaccines;15465;12419;27884;710438;350687;1061125
2022.04_13-10-2022;Пензенская область;75_90_days;CoviVac;207;85;292;710438;350687;1061125
2022.04_13-10-2022;Пензенская область;75_90_days;EpiVacCorona;939;1488;2427;710438;350687;1061125
2022.04_13-10-2022;Пензенская область;75_90_days;SputnikLite;7136;3912;11048;710438;350687;1061125
2022.04_13-10-2022;Пензенская область;75_90_days;SputnikV;7183;6934;14117;710438;350687;1061125
2022.04_13-10-2022;Пензенская область;90_105_days;AllVaccines;15884;11711;27595;710438;350687;1061125
2022.04_13-10-2022;Пензенская область;90_105_days;CoviVac;255;103;358;710438;350687;1061125
2022.04_13-10-2022;Пензенская область;90_105_days;EpiVacCorona;586;677;1263;710438;350687;1061125
2022.04_13-10-2022;Пензенская область;90_105_days;SputnikLite;8943;3653;12596;710438;350687;1061125
2022.04_13-10-2022;Пензенская область;90_105_days;SputnikV;6100;7278;13378;710438;350687;1061125
2022.04_13-10-2022;Пермский край;105_165_days;AllVaccines;194413;96623;291036;1423011;574038;1997049
2022.04_13-10-2022;Пермский край;105_165_days;CoviVac;2202;470;2672;1423011;574038;1997049
2022.04_13-10-2022;Пермский край;105_165_days;EpiVacCorona;2666;993;3659;1423011;574038;1997049
2022.04_13-10-2022;Пермский край;105_165_days;SputnikLite;63380;50846;114226;1423011;574038;1997049
2022.04_13-10-2022;Пермский край;105_165_days;SputnikV;126165;44314;170479;1423011;574038;1997049
2022.04_13-10-2022;Пермский край;165_195_days;AllVaccines;128514;55763;184277;1423011;574038;1997049
2022.04_13-10-2022;Пермский край;165_195_days;CoviVac;1298;272;1570;1423011;574038;1997049
2022.04_13-10-2022;Пермский край;165_195_days;EpiVacCorona;2174;767;2941;1423011;574038;1997049
2022.04_13-10-2022;Пермский край;165_195_days;SputnikLite;21265;19200;40465;1423011;574038;1997049
2022.04_13-10-2022;Пермский край;165_195_days;SputnikV;103777;35524;139301;1423011;574038;1997049
2022.04_13-10-2022;Пермский край;21_45_days;AllVaccines;5837;4882;10719;1423011;574038;1997049
2022.04_13-10-2022;Пермский край;21_45_days;CoviVac;204;106;310;1423011;574038;1997049
2022.04_13-10-2022;Пермский край;21_45_days;EpiVacCorona;295;254;549;1423011;574038;1997049
2022.04_13-10-2022;Пермский край;21_45_days;SputnikLite;966;485;1451;1423011;574038;1997049
2022.04_13-10-2022;Пермский край;21_45_days;SputnikV;4372;4037;8409;1423011;574038;1997049
2022.04_13-10-2022;Пермский край;45_75_days;AllVaccines;12676;6512;19188;1423011;574038;1997049
2022.04_13-10-2022;Пермский край;45_75_days;CoviVac;348;66;414;1423011;574038;1997049
2022.04_13-10-2022;Пермский край;45_75_days;EpiVacCorona;577;311;888;1423011;574038;1997049
2022.04_13-10-2022;Пермский край;45_75_days;SputnikLite;3007;1500;4507;1423011;574038;1997049
2022.04_13-10-2022;Пермский край;45_75_days;SputnikV;8744;4635;13379;1423011;574038;1997049
2022.04_13-10-2022;Пермский край;75_90_days;AllVaccines;16181;7898;24079;1423011;574038;1997049
2022.04_13-10-2022;Пермский край;75_90_days;CoviVac;269;44;313;1423011;574038;1997049
2022.04_13-10-2022;Пермский край;75_90_days;EpiVacCorona;324;185;509;1423011;574038;1997049
2022.04_13-10-2022;Пермский край;75_90_days;SputnikLite;6905;3465;10370;1423011;574038;1997049
2022.04_13-10-2022;Пермский край;75_90_days;SputnikV;8683;4204;12887;1423011;574038;1997049
2022.04_13-10-2022;Пермский край;90_105_days;AllVaccines;21940;11587;33527;1423011;574038;1997049
2022.04_13-10-2022;Пермский край;90_105_days;CoviVac;474;96;570;1423011;574038;1997049
2022.04_13-10-2022;Пермский край;90_105_days;EpiVacCorona;510;318;828;1423011;574038;1997049
2022.04_13-10-2022;Пермский край;90_105_days;SputnikLite;11962;6576;18538;1423011;574038;1997049
2022.04_13-10-2022;Пермский край;90_105_days;SputnikV;8994;4597;13591;1423011;574038;1997049
2022.04_13-10-2022;Приморский край;105_165_days;AllVaccines;210524;73824;284348;1086430;416518;1502948
2022.04_13-10-2022;Приморский край;105_165_days;CoviVac;1446;136;1582;1086430;416518;1502948
2022.04_13-10-2022;Приморский край;105_165_days;EpiVacCorona;2983;1605;4588;1086430;416518;1502948
2022.04_13-10-2022;Приморский край;105_165_days;SputnikLite;47647;36374;84021;1086430;416518;1502948
2022.04_13-10-2022;Приморский край;105_165_days;SputnikV;158448;35709;194157;1086430;416518;1502948
2022.04_13-10-2022;Приморский край;165_195_days;AllVaccines;150063;36532;186595;1086430;416518;1502948
2022.04_13-10-2022;Приморский край;165_195_days;CoviVac;3166;279;3445;1086430;416518;1502948
2022.04_13-10-2022;Приморский край;165_195_days;EpiVacCorona;2185;640;2825;1086430;416518;1502948
2022.04_13-10-2022;Приморский край;165_195_days;SputnikLite;26608;13657;40265;1086430;416518;1502948
2022.04_13-10-2022;Приморский край;165_195_days;SputnikV;118104;21956;140060;1086430;416518;1502948
2022.04_13-10-2022;Приморский край;21_45_days;AllVaccines;6309;3109;9418;1086430;416518;1502948
2022.04_13-10-2022;Приморский край;21_45_days;CoviVac;252;54;306;1086430;416518;1502948
2022.04_13-10-2022;Приморский край;21_45_days;EpiVacCorona;504;378;882;1086430;416518;1502948
2022.04_13-10-2022;Приморский край;21_45_days;SputnikLite;3484;1867;5351;1086430;416518;1502948
2022.04_13-10-2022;Приморский край;21_45_days;SputnikV;2069;810;2879;1086430;416518;1502948
2022.04_13-10-2022;Приморский край;45_75_days;AllVaccines;16251;6733;22984;1086430;416518;1502948
2022.04_13-10-2022;Приморский край;45_75_days;CoviVac;280;18;298;1086430;416518;1502948
2022.04_13-10-2022;Приморский край;45_75_days;EpiVacCorona;1489;794;2283;1086430;416518;1502948
2022.04_13-10-2022;Приморский край;45_75_days;SputnikLite;8635;4093;12728;1086430;416518;1502948
2022.04_13-10-2022;Приморский край;45_75_days;SputnikV;5847;1828;7675;1086430;416518;1502948
2022.04_13-10-2022;Приморский край;75_90_days;AllVaccines;14438;5647;20085;1086430;416518;1502948
2022.04_13-10-2022;Приморский край;75_90_days;CoviVac;171;18;189;1086430;416518;1502948
2022.04_13-10-2022;Приморский край;75_90_days;EpiVacCorona;1101;452;1553;1086430;416518;1502948
2022.04_13-10-2022;Приморский край;75_90_days;SputnikLite;7264;3184;10448;1086430;416518;1502948
2022.04_13-10-2022;Приморский край;75_90_days;SputnikV;5902;1993;7895;1086430;416518;1502948
2022.04_13-10-2022;Приморский край;90_105_days;AllVaccines;19603;9292;28895;1086430;416518;1502948
2022.04_13-10-2022;Приморский край;90_105_days;CoviVac;141;19;160;1086430;416518;1502948
2022.04_13-10-2022;Приморский край;90_105_days;EpiVacCorona;744;377;1121;1086430;416518;1502948
2022.04_13-10-2022;Приморский край;90_105_days;SputnikLite;11915;6536;18451;1086430;416518;1502948
2022.04_13-10-2022;Приморский край;90_105_days;SputnikV;6803;2360;9163;1086430;416518;1502948
2022.04_13-10-2022;Псковская область;105_165_days;AllVaccines;38819;22432;61251;337881;166663;504544
2022.04_13-10-2022;Псковская область;105_165_days;CoviVac;822;110;932;337881;166663;504544
2022.04_13-10-2022;Псковская область;105_165_days;EpiVacCorona;1405;733;2138;337881;166663;504544
2022.04_13-10-2022;Псковская область;105_165_days;SputnikLite;14370;12223;26593;337881;166663;504544
2022.04_13-10-2022;Псковская область;105_165_days;SputnikV;22222;9366;31588;337881;166663;504544
2022.04_13-10-2022;Псковская область;165_195_days;AllVaccines;23818;15702;39520;337881;166663;504544
2022.04_13-10-2022;Псковская область;165_195_days;CoviVac;659;127;786;337881;166663;504544
2022.04_13-10-2022;Псковская область;165_195_days;EpiVacCorona;955;429;1384;337881;166663;504544
2022.04_13-10-2022;Псковская область;165_195_days;SputnikLite;7809;8819;16628;337881;166663;504544
2022.04_13-10-2022;Псковская область;165_195_days;SputnikV;14395;6327;20722;337881;166663;504544
2022.04_13-10-2022;Псковская область;21_45_days;AllVaccines;1602;1382;2984;337881;166663;504544
2022.04_13-10-2022;Псковская область;21_45_days;CoviVac;37;9;46;337881;166663;504544
2022.04_13-10-2022;Псковская область;21_45_days;EpiVacCorona;162;89;251;337881;166663;504544
2022.04_13-10-2022;Псковская область;21_45_days;SputnikLite;62;14;76;337881;166663;504544
2022.04_13-10-2022;Псковская область;21_45_days;SputnikV;1341;1270;2611;337881;166663;504544
2022.04_13-10-2022;Псковская область;45_75_days;AllVaccines;3582;1701;5283;337881;166663;504544
2022.04_13-10-2022;Псковская область;45_75_days;CoviVac;107;7;114;337881;166663;504544
2022.04_13-10-2022;Псковская область;45_75_days;EpiVacCorona;243;128;371;337881;166663;504544
2022.04_13-10-2022;Псковская область;45_75_days;SputnikLite;198;132;330;337881;166663;504544
2022.04_13-10-2022;Псковская область;45_75_days;SputnikV;3034;1434;4468;337881;166663;504544
2022.04_13-10-2022;Псковская область;75_90_days;AllVaccines;4189;1993;6182;337881;166663;504544
2022.04_13-10-2022;Псковская область;75_90_days;CoviVac;97;9;106;337881;166663;504544
2022.04_13-10-2022;Псковская область;75_90_days;EpiVacCorona;277;136;413;337881;166663;504544
2022.04_13-10-2022;Псковская область;75_90_days;SputnikLite;823;435;1258;337881;166663;504544
2022.04_13-10-2022;Псковская область;75_90_days;SputnikV;2992;1413;4405;337881;166663;504544
2022.04_13-10-2022;Псковская область;90_105_days;AllVaccines;7224;3892;11116;337881;166663;504544
2022.04_13-10-2022;Псковская область;90_105_days;CoviVac;167;20;187;337881;166663;504544
2022.04_13-10-2022;Псковская область;90_105_days;EpiVacCorona;330;251;581;337881;166663;504544
2022.04_13-10-2022;Псковская область;90_105_days;SputnikLite;2869;1430;4299;337881;166663;504544
2022.04_13-10-2022;Псковская область;90_105_days;SputnikV;3858;2191;6049;337881;166663;504544
2022.04_13-10-2022;РФ;105_165_days;AllVaccines;10822432;4984982;15807414;82332898;33454776;115787674
2022.04_13-10-2022;РФ;105_165_days;CoviVac;128929;29152;158081;82332898;33454776;115787674
2022.04_13-10-2022;РФ;105_165_days;EpiVacCorona;318241;158033;476274;82332898;33454776;115787674
2022.04_13-10-2022;РФ;105_165_days;SputnikLite;4006532;2358000;6364532;82332898;33454776;115787674
2022.04_13-10-2022;РФ;105_165_days;SputnikV;6368730;2439797;8808527;82332898;33454776;115787674
2022.04_13-10-2022;РФ;165_195_days;AllVaccines;7977980;3387252;11365232;82332898;33454776;115787674
2022.04_13-10-2022;РФ;165_195_days;CoviVac;108207;23188;131395;82332898;33454776;115787674
2022.04_13-10-2022;РФ;165_195_days;EpiVacCorona;211569;85636;297205;82332898;33454776;115787674
2022.04_13-10-2022;РФ;165_195_days;SputnikLite;2091772;1339635;3431407;82332898;33454776;115787674
2022.04_13-10-2022;РФ;165_195_days;SputnikV;5566432;1938793;7505225;82332898;33454776;115787674
2022.04_13-10-2022;РФ;21_45_days;AllVaccines;624842;396575;1021417;82332898;33454776;115787674
2022.04_13-10-2022;РФ;21_45_days;CoviVac;27664;8823;36487;82332898;33454776;115787674
2022.04_13-10-2022;РФ;21_45_days;EpiVacCorona;52289;34307;86596;82332898;33454776;115787674
2022.04_13-10-2022;РФ;21_45_days;SputnikLite;132077;66910;198987;82332898;33454776;115787674
2022.04_13-10-2022;РФ;21_45_days;SputnikV;412812;286535;699347;82332898;33454776;115787674
2022.04_13-10-2022;РФ;45_75_days;AllVaccines;1213425;604790;1818215;82332898;33454776;115787674
2022.04_13-10-2022;РФ;45_75_days;CoviVac;31590;9245;40835;82332898;33454776;115787674
2022.04_13-10-2022;РФ;45_75_days;EpiVacCorona;82151;50347;132498;82332898;33454776;115787674
2022.04_13-10-2022;РФ;45_75_days;SputnikLite;308505;144659;453164;82332898;33454776;115787674
2022.04_13-10-2022;РФ;45_75_days;SputnikV;791179;400539;1191718;82332898;33454776;115787674
2022.04_13-10-2022;РФ;75_90_days;AllVaccines;1291366;553074;1844440;82332898;33454776;115787674
2022.04_13-10-2022;РФ;75_90_days;CoviVac;17784;3867;21651;82332898;33454776;115787674
2022.04_13-10-2022;РФ;75_90_days;EpiVacCorona;61449;31136;92585;82332898;33454776;115787674
2022.04_13-10-2022;РФ;75_90_days;SputnikLite;504437;194771;699208;82332898;33454776;115787674
2022.04_13-10-2022;РФ;75_90_days;SputnikV;707696;323300;1030996;82332898;33454776;115787674
2022.04_13-10-2022;РФ;90_105_days;AllVaccines;1671624;729200;2400824;82332898;33454776;115787674
2022.04_13-10-2022;РФ;90_105_days;CoviVac;24015;6022;30037;82332898;33454776;115787674
2022.04_13-10-2022;РФ;90_105_days;EpiVacCorona;61186;37630;98816;82332898;33454776;115787674
2022.04_13-10-2022;РФ;90_105_days;SputnikLite;842891;331957;1174848;82332898;33454776;115787674
2022.04_13-10-2022;РФ;90_105_days;SputnikV;743532;353591;1097123;82332898;33454776;115787674
2022.04_13-10-2022;Республика Адыгея;105_165_days;AllVaccines;23297;11880;35177;256368;104563;360931
2022.04_13-10-2022;Республика Адыгея;105_165_days;CoviVac;206;57;263;256368;104563;360931
2022.04_13-10-2022;Республика Адыгея;105_165_days;EpiVacCorona;801;421;1222;256368;104563;360931
2022.04_13-10-2022;Республика Адыгея;105_165_days;SputnikLite;12203;7019;19222;256368;104563;360931
2022.04_13-10-2022;Республика Адыгея;105_165_days;SputnikV;10087;4383;14470;256368;104563;360931
2022.04_13-10-2022;Республика Адыгея;165_195_days;AllVaccines;19805;8709;28514;256368;104563;360931
2022.04_13-10-2022;Республика Адыгея;165_195_days;CoviVac;360;91;451;256368;104563;360931
2022.04_13-10-2022;Республика Адыгея;165_195_days;EpiVacCorona;508;222;730;256368;104563;360931
2022.04_13-10-2022;Республика Адыгея;165_195_days;SputnikLite;8120;4527;12647;256368;104563;360931
2022.04_13-10-2022;Республика Адыгея;165_195_days;SputnikV;10817;3869;14686;256368;104563;360931
2022.04_13-10-2022;Республика Адыгея;21_45_days;AllVaccines;1042;708;1750;256368;104563;360931
2022.04_13-10-2022;Республика Адыгея;21_45_days;CoviVac;4;1;5;256368;104563;360931
2022.04_13-10-2022;Республика Адыгея;21_45_days;EpiVacCorona;2;4;6;256368;104563;360931
2022.04_13-10-2022;Республика Адыгея;21_45_days;SputnikLite;711;429;1140;256368;104563;360931
2022.04_13-10-2022;Республика Адыгея;21_45_days;SputnikV;325;274;599;256368;104563;360931
2022.04_13-10-2022;Республика Адыгея;45_75_days;AllVaccines;2170;1449;3619;256368;104563;360931
2022.04_13-10-2022;Республика Адыгея;45_75_days;CoviVac;17;1;18;256368;104563;360931
2022.04_13-10-2022;Республика Адыгея;45_75_days;EpiVacCorona;9;9;18;256368;104563;360931
2022.04_13-10-2022;Республика Адыгея;45_75_days;SputnikLite;1289;918;2207;256368;104563;360931
2022.04_13-10-2022;Республика Адыгея;45_75_days;SputnikV;855;521;1376;256368;104563;360931
2022.04_13-10-2022;Республика Адыгея;75_90_days;AllVaccines;3261;1465;4726;256368;104563;360931
2022.04_13-10-2022;Республика Адыгея;75_90_days;CoviVac;19;4;23;256368;104563;360931
2022.04_13-10-2022;Республика Адыгея;75_90_days;EpiVacCorona;40;16;56;256368;104563;360931
2022.04_13-10-2022;Республика Адыгея;75_90_days;SputnikLite;1417;576;1993;256368;104563;360931
2022.04_13-10-2022;Республика Адыгея;75_90_days;SputnikV;1785;869;2654;256368;104563;360931
2022.04_13-10-2022;Республика Адыгея;90_105_days;AllVaccines;3892;1837;5729;256368;104563;360931
2022.04_13-10-2022;Республика Адыгея;90_105_days;CoviVac;29;9;38;256368;104563;360931
2022.04_13-10-2022;Республика Адыгея;90_105_days;EpiVacCorona;81;45;126;256368;104563;360931
2022.04_13-10-2022;Республика Адыгея;90_105_days;SputnikLite;2435;950;3385;256368;104563;360931
2022.04_13-10-2022;Республика Адыгея;90_105_days;SputnikV;1347;833;2180;256368;104563;360931
2022.04_13-10-2022;Республика Алтай;105_165_days;AllVaccines;18874;6493;25367;117210;36468;153678
2022.04_13-10-2022;Республика Алтай;105_165_days;CoviVac;266;55;321;117210;36468;153678
2022.04_13-10-2022;Республика Алтай;105_165_days;EpiVacCorona;475;160;635;117210;36468;153678
2022.04_13-10-2022;Республика Алтай;105_165_days;SputnikLite;12333;4365;16698;117210;36468;153678
2022.04_13-10-2022;Республика Алтай;105_165_days;SputnikV;5800;1913;7713;117210;36468;153678
2022.04_13-10-2022;Республика Алтай;165_195_days;AllVaccines;9949;4777;14726;117210;36468;153678
2022.04_13-10-2022;Республика Алтай;165_195_days;CoviVac;5;6;11;117210;36468;153678
2022.04_13-10-2022;Республика Алтай;165_195_days;EpiVacCorona;152;51;203;117210;36468;153678
2022.04_13-10-2022;Республика Алтай;165_195_days;SputnikLite;7339;3522;10861;117210;36468;153678
2022.04_13-10-2022;Республика Алтай;165_195_days;SputnikV;2453;1198;3651;117210;36468;153678
2022.04_13-10-2022;Республика Алтай;21_45_days;AllVaccines;1543;862;2405;117210;36468;153678
2022.04_13-10-2022;Республика Алтай;21_45_days;CoviVac;175;95;270;117210;36468;153678
2022.04_13-10-2022;Республика Алтай;21_45_days;EpiVacCorona;268;66;334;117210;36468;153678
2022.04_13-10-2022;Республика Алтай;21_45_days;SputnikLite;295;143;438;117210;36468;153678
2022.04_13-10-2022;Республика Алтай;21_45_days;SputnikV;805;558;1363;117210;36468;153678
2022.04_13-10-2022;Республика Алтай;45_75_days;AllVaccines;2490;935;3425;117210;36468;153678
2022.04_13-10-2022;Республика Алтай;45_75_days;CoviVac;142;21;163;117210;36468;153678
2022.04_13-10-2022;Республика Алтай;45_75_days;EpiVacCorona;182;42;224;117210;36468;153678
2022.04_13-10-2022;Республика Алтай;45_75_days;SputnikLite;1022;337;1359;117210;36468;153678
2022.04_13-10-2022;Республика Алтай;45_75_days;SputnikV;1144;535;1679;117210;36468;153678
2022.04_13-10-2022;Республика Алтай;75_90_days;AllVaccines;2423;784;3207;117210;36468;153678
2022.04_13-10-2022;Республика Алтай;75_90_days;CoviVac;104;13;117;117210;36468;153678
2022.04_13-10-2022;Республика Алтай;75_90_days;EpiVacCorona;152;24;176;117210;36468;153678
2022.04_13-10-2022;Республика Алтай;75_90_days;SputnikLite;828;145;973;117210;36468;153678
2022.04_13-10-2022;Республика Алтай;75_90_days;SputnikV;1339;602;1941;117210;36468;153678
2022.04_13-10-2022;Республика Алтай;90_105_days;AllVaccines;3398;1034;4432;117210;36468;153678
2022.04_13-10-2022;Республика Алтай;90_105_days;CoviVac;76;24;100;117210;36468;153678
2022.04_13-10-2022;Республика Алтай;90_105_days;EpiVacCorona;127;46;173;117210;36468;153678
2022.04_13-10-2022;Республика Алтай;90_105_days;SputnikLite;1870;431;2301;117210;36468;153678
2022.04_13-10-2022;Республика Алтай;90_105_days;SputnikV;1325;533;1858;117210;36468;153678
2022.04_13-10-2022;Республика Башкортостан;105_165_days;AllVaccines;320629;124529;445158;2235962;869874;3105836
2022.04_13-10-2022;Республика Башкортостан;105_165_days;CoviVac;8820;2178;10998;2235962;869874;3105836
2022.04_13-10-2022;Республика Башкортостан;105_165_days;EpiVacCorona;11020;6152;17172;2235962;869874;3105836
2022.04_13-10-2022;Республика Башкортостан;105_165_days;SputnikLite;107804;48334;156138;2235962;869874;3105836
2022.04_13-10-2022;Республика Башкортостан;105_165_days;SputnikV;192985;67865;260850;2235962;869874;3105836
2022.04_13-10-2022;Республика Башкортостан;165_195_days;AllVaccines;297419;103933;401352;2235962;869874;3105836
2022.04_13-10-2022;Республика Башкортостан;165_195_days;CoviVac;828;198;1026;2235962;869874;3105836
2022.04_13-10-2022;Республика Башкортостан;165_195_days;EpiVacCorona;7892;3699;11591;2235962;869874;3105836
2022.04_13-10-2022;Республика Башкортостан;165_195_days;SputnikLite;31398;19823;51221;2235962;869874;3105836
2022.04_13-10-2022;Республика Башкортостан;165_195_days;SputnikV;257301;80213;337514;2235962;869874;3105836
2022.04_13-10-2022;Республика Башкортостан;21_45_days;AllVaccines;23968;15224;39192;2235962;869874;3105836
2022.04_13-10-2022;Республика Башкортостан;21_45_days;CoviVac;2270;1147;3417;2235962;869874;3105836
2022.04_13-10-2022;Республика Башкортостан;21_45_days;EpiVacCorona;2395;2035;4430;2235962;869874;3105836
2022.04_13-10-2022;Республика Башкортостан;21_45_days;SputnikLite;6010;1714;7724;2235962;869874;3105836
2022.04_13-10-2022;Республика Башкортостан;21_45_days;SputnikV;13293;10328;23621;2235962;869874;3105836
2022.04_13-10-2022;Республика Башкортостан;45_75_days;AllVaccines;52372;28006;80378;2235962;869874;3105836
2022.04_13-10-2022;Республика Башкортостан;45_75_days;CoviVac;917;344;1261;2235962;869874;3105836
2022.04_13-10-2022;Республика Башкортостан;45_75_days;EpiVacCorona;5757;4263;10020;2235962;869874;3105836
2022.04_13-10-2022;Республика Башкортостан;45_75_days;SputnikLite;13925;4782;18707;2235962;869874;3105836
2022.04_13-10-2022;Республика Башкортостан;45_75_days;SputnikV;31773;18617;50390;2235962;869874;3105836
2022.04_13-10-2022;Республика Башкортостан;75_90_days;AllVaccines;40518;19485;60003;2235962;869874;3105836
2022.04_13-10-2022;Республика Башкортостан;75_90_days;CoviVac;255;60;315;2235962;869874;3105836
2022.04_13-10-2022;Республика Башкортостан;75_90_days;EpiVacCorona;2018;1215;3233;2235962;869874;3105836
2022.04_13-10-2022;Республика Башкортостан;75_90_days;SputnikLite;10610;3101;13711;2235962;869874;3105836
2022.04_13-10-2022;Республика Башкортостан;75_90_days;SputnikV;27635;15109;42744;2235962;869874;3105836
2022.04_13-10-2022;Республика Башкортостан;90_105_days;AllVaccines;44679;22163;66842;2235962;869874;3105836
2022.04_13-10-2022;Республика Башкортостан;90_105_days;CoviVac;365;79;444;2235962;869874;3105836
2022.04_13-10-2022;Республика Башкортостан;90_105_days;EpiVacCorona;1883;1563;3446;2235962;869874;3105836
2022.04_13-10-2022;Республика Башкортостан;90_105_days;SputnikLite;18010;6128;24138;2235962;869874;3105836
2022.04_13-10-2022;Республика Башкортостан;90_105_days;SputnikV;24421;14393;38814;2235962;869874;3105836
2022.04_13-10-2022;Республика Бурятия;105_165_days;AllVaccines;83100;33986;117086;542372;176777;719149
2022.04_13-10-2022;Республика Бурятия;105_165_days;CoviVac;1021;318;1339;542372;176777;719149
2022.04_13-10-2022;Республика Бурятия;105_165_days;EpiVacCorona;1460;886;2346;542372;176777;719149
2022.04_13-10-2022;Республика Бурятия;105_165_days;SputnikLite;34722;17117;51839;542372;176777;719149
2022.04_13-10-2022;Республика Бурятия;105_165_days;SputnikV;45897;15665;61562;542372;176777;719149
2022.04_13-10-2022;Республика Бурятия;165_195_days;AllVaccines;45942;17956;63898;542372;176777;719149
2022.04_13-10-2022;Республика Бурятия;165_195_days;CoviVac;645;132;777;542372;176777;719149
2022.04_13-10-2022;Республика Бурятия;165_195_days;EpiVacCorona;920;476;1396;542372;176777;719149
2022.04_13-10-2022;Республика Бурятия;165_195_days;SputnikLite;14518;7704;22222;542372;176777;719149
2022.04_13-10-2022;Республика Бурятия;165_195_days;SputnikV;29859;9644;39503;542372;176777;719149
2022.04_13-10-2022;Республика Бурятия;21_45_days;AllVaccines;5114;2347;7461;542372;176777;719149
2022.04_13-10-2022;Республика Бурятия;21_45_days;CoviVac;380;164;544;542372;176777;719149
2022.04_13-10-2022;Республика Бурятия;21_45_days;EpiVacCorona;941;595;1536;542372;176777;719149
2022.04_13-10-2022;Республика Бурятия;21_45_days;SputnikLite;566;194;760;542372;176777;719149
2022.04_13-10-2022;Республика Бурятия;21_45_days;SputnikV;3227;1394;4621;542372;176777;719149
2022.04_13-10-2022;Республика Бурятия;45_75_days;AllVaccines;12670;4705;17375;542372;176777;719149
2022.04_13-10-2022;Республика Бурятия;45_75_days;CoviVac;270;89;359;542372;176777;719149
2022.04_13-10-2022;Республика Бурятия;45_75_days;EpiVacCorona;972;435;1407;542372;176777;719149
2022.04_13-10-2022;Республика Бурятия;45_75_days;SputnikLite;3447;1225;4672;542372;176777;719149
2022.04_13-10-2022;Республика Бурятия;45_75_days;SputnikV;7981;2956;10937;542372;176777;719149
2022.04_13-10-2022;Республика Бурятия;75_90_days;AllVaccines;13449;5155;18604;542372;176777;719149
2022.04_13-10-2022;Республика Бурятия;75_90_days;CoviVac;118;36;154;542372;176777;719149
2022.04_13-10-2022;Республика Бурятия;75_90_days;EpiVacCorona;387;196;583;542372;176777;719149
2022.04_13-10-2022;Республика Бурятия;75_90_days;SputnikLite;4519;1531;6050;542372;176777;719149
2022.04_13-10-2022;Республика Бурятия;75_90_days;SputnikV;8425;3392;11817;542372;176777;719149
2022.04_13-10-2022;Республика Бурятия;90_105_days;AllVaccines;15753;6473;22226;542372;176777;719149
2022.04_13-10-2022;Республика Бурятия;90_105_days;CoviVac;126;54;180;542372;176777;719149
2022.04_13-10-2022;Республика Бурятия;90_105_days;EpiVacCorona;578;307;885;542372;176777;719149
2022.04_13-10-2022;Республика Бурятия;90_105_days;SputnikLite;6734;2231;8965;542372;176777;719149
2022.04_13-10-2022;Республика Бурятия;90_105_days;SputnikV;8315;3881;12196;542372;176777;719149
2022.04_13-10-2022;Республика Дагестан;105_165_days;AllVaccines;176827;37241;214068;1856109;394621;2250730
2022.04_13-10-2022;Республика Дагестан;105_165_days;CoviVac;2359;429;2788;1856109;394621;2250730
2022.04_13-10-2022;Республика Дагестан;105_165_days;EpiVacCorona;18394;3299;21693;1856109;394621;2250730
2022.04_13-10-2022;Республика Дагестан;105_165_days;SputnikLite;43987;9596;53583;1856109;394621;2250730
2022.04_13-10-2022;Республика Дагестан;105_165_days;SputnikV;112087;23917;136004;1856109;394621;2250730
2022.04_13-10-2022;Республика Дагестан;165_195_days;AllVaccines;101846;16377;118223;1856109;394621;2250730
2022.04_13-10-2022;Республика Дагестан;165_195_days;CoviVac;758;145;903;1856109;394621;2250730
2022.04_13-10-2022;Республика Дагестан;165_195_days;EpiVacCorona;5898;743;6641;1856109;394621;2250730
2022.04_13-10-2022;Республика Дагестан;165_195_days;SputnikLite;20191;3373;23564;1856109;394621;2250730
2022.04_13-10-2022;Республика Дагестан;165_195_days;SputnikV;74999;12116;87115;1856109;394621;2250730
2022.04_13-10-2022;Республика Дагестан;21_45_days;AllVaccines;43524;14664;58188;1856109;394621;2250730
2022.04_13-10-2022;Республика Дагестан;21_45_days;CoviVac;2698;878;3576;1856109;394621;2250730
2022.04_13-10-2022;Республика Дагестан;21_45_days;EpiVacCorona;5747;3021;8768;1856109;394621;2250730
2022.04_13-10-2022;Республика Дагестан;21_45_days;SputnikLite;331;69;400;1856109;394621;2250730
2022.04_13-10-2022;Республика Дагестан;21_45_days;SputnikV;34748;10696;45444;1856109;394621;2250730
2022.04_13-10-2022;Республика Дагестан;45_75_days;AllVaccines;97802;26805;124607;1856109;394621;2250730
2022.04_13-10-2022;Республика Дагестан;45_75_days;CoviVac;3913;1396;5309;1856109;394621;2250730
2022.04_13-10-2022;Республика Дагестан;45_75_days;EpiVacCorona;12749;3697;16446;1856109;394621;2250730
2022.04_13-10-2022;Республика Дагестан;45_75_days;SputnikLite;4671;1201;5872;1856109;394621;2250730
2022.04_13-10-2022;Республика Дагестан;45_75_days;SputnikV;76469;20511;96980;1856109;394621;2250730
2022.04_13-10-2022;Республика Дагестан;75_90_days;AllVaccines;66283;18811;85094;1856109;394621;2250730
2022.04_13-10-2022;Республика Дагестан;75_90_days;CoviVac;2075;351;2426;1856109;394621;2250730
2022.04_13-10-2022;Республика Дагестан;75_90_days;EpiVacCorona;7855;2040;9895;1856109;394621;2250730
2022.04_13-10-2022;Республика Дагестан;75_90_days;SputnikLite;5554;1472;7026;1856109;394621;2250730
2022.04_13-10-2022;Республика Дагестан;75_90_days;SputnikV;50799;14948;65747;1856109;394621;2250730
2022.04_13-10-2022;Республика Дагестан;90_105_days;AllVaccines;102270;28739;131009;1856109;394621;2250730
2022.04_13-10-2022;Республика Дагестан;90_105_days;CoviVac;1014;201;1215;1856109;394621;2250730
2022.04_13-10-2022;Республика Дагестан;90_105_days;EpiVacCorona;4227;893;5120;1856109;394621;2250730
2022.04_13-10-2022;Республика Дагестан;90_105_days;SputnikLite;10217;1729;11946;1856109;394621;2250730
2022.04_13-10-2022;Республика Дагестан;90_105_days;SputnikV;86812;25916;112728;1856109;394621;2250730
2022.04_13-10-2022;Республика Ингушетия;105_165_days;AllVaccines;67944;14170;82114;295583;61477;357060
2022.04_13-10-2022;Республика Ингушетия;105_165_days;CoviVac;382;188;570;295583;61477;357060
2022.04_13-10-2022;Республика Ингушетия;105_165_days;EpiVacCorona;683;184;867;295583;61477;357060
2022.04_13-10-2022;Республика Ингушетия;105_165_days;SputnikLite;37210;7229;44439;295583;61477;357060
2022.04_13-10-2022;Республика Ингушетия;105_165_days;SputnikV;29669;6569;36238;295583;61477;357060
2022.04_13-10-2022;Республика Ингушетия;165_195_days;AllVaccines;15791;3567;19358;295583;61477;357060
2022.04_13-10-2022;Республика Ингушетия;165_195_days;CoviVac;9;7;16;295583;61477;357060
2022.04_13-10-2022;Республика Ингушетия;165_195_days;SputnikLite;7937;2182;10119;295583;61477;357060
2022.04_13-10-2022;Республика Ингушетия;165_195_days;SputnikV;7845;1378;9223;295583;61477;357060
2022.04_13-10-2022;Республика Ингушетия;21_45_days;AllVaccines;8882;1369;10251;295583;61477;357060
2022.04_13-10-2022;Республика Ингушетия;21_45_days;CoviVac;338;30;368;295583;61477;357060
2022.04_13-10-2022;Республика Ингушетия;21_45_days;EpiVacCorona;5339;903;6242;295583;61477;357060
2022.04_13-10-2022;Республика Ингушетия;21_45_days;SputnikLite;349;63;412;295583;61477;357060
2022.04_13-10-2022;Республика Ингушетия;21_45_days;SputnikV;2856;373;3229;295583;61477;357060
2022.04_13-10-2022;Республика Ингушетия;45_75_days;AllVaccines;7101;1148;8249;295583;61477;357060
2022.04_13-10-2022;Республика Ингушетия;45_75_days;CoviVac;93;5;98;295583;61477;357060
2022.04_13-10-2022;Республика Ингушетия;45_75_days;EpiVacCorona;2215;442;2657;295583;61477;357060
2022.04_13-10-2022;Республика Ингушетия;45_75_days;SputnikLite;1710;220;1930;295583;61477;357060
2022.04_13-10-2022;Республика Ингушетия;45_75_days;SputnikV;3083;481;3564;295583;61477;357060
2022.04_13-10-2022;Республика Ингушетия;75_90_days;AllVaccines;10018;1641;11659;295583;61477;357060
2022.04_13-10-2022;Республика Ингушетия;75_90_days;CoviVac;30;6;36;295583;61477;357060
2022.04_13-10-2022;Республика Ингушетия;75_90_days;EpiVacCorona;2884;529;3413;295583;61477;357060
2022.04_13-10-2022;Республика Ингушетия;75_90_days;SputnikLite;3792;549;4341;295583;61477;357060
2022.04_13-10-2022;Республика Ингушетия;75_90_days;SputnikV;3312;557;3869;295583;61477;357060
2022.04_13-10-2022;Республика Ингушетия;90_105_days;AllVaccines;8508;1314;9822;295583;61477;357060
2022.04_13-10-2022;Республика Ингушетия;90_105_days;CoviVac;12;0;12;295583;61477;357060
2022.04_13-10-2022;Республика Ингушетия;90_105_days;EpiVacCorona;51;11;62;295583;61477;357060
2022.04_13-10-2022;Республика Ингушетия;90_105_days;SputnikLite;3589;533;4122;295583;61477;357060
2022.04_13-10-2022;Республика Ингушетия;90_105_days;SputnikV;4856;770;5626;295583;61477;357060
2022.04_13-10-2022;Республика Калмыкия;105_165_days;AllVaccines;17227;7009;24236;150440;54890;205330
2022.04_13-10-2022;Республика Калмыкия;105_165_days;CoviVac;401;101;502;150440;54890;205330
2022.04_13-10-2022;Республика Калмыкия;105_165_days;EpiVacCorona;419;237;656;150440;54890;205330
2022.04_13-10-2022;Республика Калмыкия;105_165_days;SputnikLite;13218;5521;18739;150440;54890;205330
2022.04_13-10-2022;Республика Калмыкия;105_165_days;SputnikV;3189;1150;4339;150440;54890;205330
2022.04_13-10-2022;Республика Калмыкия;165_195_days;AllVaccines;19750;8562;28312;150440;54890;205330
2022.04_13-10-2022;Республика Калмыкия;165_195_days;CoviVac;445;89;534;150440;54890;205330
2022.04_13-10-2022;Республика Калмыкия;165_195_days;EpiVacCorona;54;24;78;150440;54890;205330
2022.04_13-10-2022;Республика Калмыкия;165_195_days;SputnikLite;16597;7145;23742;150440;54890;205330
2022.04_13-10-2022;Республика Калмыкия;165_195_days;SputnikV;2654;1304;3958;150440;54890;205330
2022.04_13-10-2022;Республика Калмыкия;21_45_days;AllVaccines;1256;903;2159;150440;54890;205330
2022.04_13-10-2022;Республика Калмыкия;21_45_days;CoviVac;4;0;4;150440;54890;205330
2022.04_13-10-2022;Республика Калмыкия;21_45_days;EpiVacCorona;22;18;40;150440;54890;205330
2022.04_13-10-2022;Республика Калмыкия;21_45_days;SputnikLite;1018;750;1768;150440;54890;205330
2022.04_13-10-2022;Республика Калмыкия;21_45_days;SputnikV;212;135;347;150440;54890;205330
2022.04_13-10-2022;Республика Калмыкия;45_75_days;AllVaccines;1459;923;2382;150440;54890;205330
2022.04_13-10-2022;Республика Калмыкия;45_75_days;CoviVac;7;1;8;150440;54890;205330
2022.04_13-10-2022;Республика Калмыкия;45_75_days;EpiVacCorona;56;32;88;150440;54890;205330
2022.04_13-10-2022;Республика Калмыкия;45_75_days;SputnikLite;1080;710;1790;150440;54890;205330
2022.04_13-10-2022;Республика Калмыкия;45_75_days;SputnikV;316;180;496;150440;54890;205330
2022.04_13-10-2022;Республика Калмыкия;75_90_days;AllVaccines;1609;695;2304;150440;54890;205330
2022.04_13-10-2022;Республика Калмыкия;75_90_days;CoviVac;11;2;13;150440;54890;205330
2022.04_13-10-2022;Республика Калмыкия;75_90_days;EpiVacCorona;72;15;87;150440;54890;205330
2022.04_13-10-2022;Республика Калмыкия;75_90_days;SputnikLite;1251;542;1793;150440;54890;205330
2022.04_13-10-2022;Республика Калмыкия;75_90_days;SputnikV;275;136;411;150440;54890;205330
2022.04_13-10-2022;Республика Калмыкия;90_105_days;AllVaccines;2448;1069;3517;150440;54890;205330
2022.04_13-10-2022;Республика Калмыкия;90_105_days;CoviVac;16;12;28;150440;54890;205330
2022.04_13-10-2022;Республика Калмыкия;90_105_days;EpiVacCorona;40;8;48;150440;54890;205330
2022.04_13-10-2022;Республика Калмыкия;90_105_days;SputnikLite;1973;834;2807;150440;54890;205330
2022.04_13-10-2022;Республика Калмыкия;90_105_days;SputnikV;419;215;634;150440;54890;205330
2022.04_13-10-2022;Республика Карелия;105_165_days;AllVaccines;37672;22393;60065;334874;149526;484400
2022.04_13-10-2022;Республика Карелия;105_165_days;CoviVac;919;215;1134;334874;149526;484400
2022.04_13-10-2022;Республика Карелия;105_165_days;EpiVacCorona;1470;858;2328;334874;149526;484400
2022.04_13-10-2022;Республика Карелия;105_165_days;SputnikLite;16670;11616;28286;334874;149526;484400
2022.04_13-10-2022;Республика Карелия;105_165_days;SputnikV;18613;9704;28317;334874;149526;484400
2022.04_13-10-2022;Республика Карелия;165_195_days;AllVaccines;24483;20849;45332;334874;149526;484400
2022.04_13-10-2022;Республика Карелия;165_195_days;CoviVac;703;177;880;334874;149526;484400
2022.04_13-10-2022;Республика Карелия;165_195_days;EpiVacCorona;449;323;772;334874;149526;484400
2022.04_13-10-2022;Республика Карелия;165_195_days;SputnikLite;13370;13090;26460;334874;149526;484400
2022.04_13-10-2022;Республика Карелия;165_195_days;SputnikV;9961;7259;17220;334874;149526;484400
2022.04_13-10-2022;Республика Карелия;21_45_days;AllVaccines;2496;2497;4993;334874;149526;484400
2022.04_13-10-2022;Республика Карелия;21_45_days;CoviVac;23;5;28;334874;149526;484400
2022.04_13-10-2022;Республика Карелия;21_45_days;EpiVacCorona;38;62;100;334874;149526;484400
2022.04_13-10-2022;Республика Карелия;21_45_days;SputnikLite;1346;1364;2710;334874;149526;484400
2022.04_13-10-2022;Республика Карелия;21_45_days;SputnikV;1089;1066;2155;334874;149526;484400
2022.04_13-10-2022;Республика Карелия;45_75_days;AllVaccines;6470;4287;10757;334874;149526;484400
2022.04_13-10-2022;Республика Карелия;45_75_days;CoviVac;82;20;102;334874;149526;484400
2022.04_13-10-2022;Республика Карелия;45_75_days;EpiVacCorona;183;120;303;334874;149526;484400
2022.04_13-10-2022;Республика Карелия;45_75_days;SputnikLite;3647;2617;6264;334874;149526;484400
2022.04_13-10-2022;Республика Карелия;45_75_days;SputnikV;2558;1530;4088;334874;149526;484400
2022.04_13-10-2022;Республика Карелия;75_90_days;AllVaccines;6141;3383;9524;334874;149526;484400
2022.04_13-10-2022;Республика Карелия;75_90_days;CoviVac;99;12;111;334874;149526;484400
2022.04_13-10-2022;Республика Карелия;75_90_days;EpiVacCorona;198;127;325;334874;149526;484400
2022.04_13-10-2022;Республика Карелия;75_90_days;SputnikLite;2571;1279;3850;334874;149526;484400
2022.04_13-10-2022;Республика Карелия;75_90_days;SputnikV;3273;1965;5238;334874;149526;484400
2022.04_13-10-2022;Республика Карелия;90_105_days;AllVaccines;6406;3366;9772;334874;149526;484400
2022.04_13-10-2022;Республика Карелия;90_105_days;CoviVac;182;40;222;334874;149526;484400
2022.04_13-10-2022;Республика Карелия;90_105_days;EpiVacCorona;312;223;535;334874;149526;484400
2022.04_13-10-2022;Республика Карелия;90_105_days;SputnikLite;3722;1492;5214;334874;149526;484400
2022.04_13-10-2022;Республика Карелия;90_105_days;SputnikV;2190;1611;3801;334874;149526;484400
2022.04_13-10-2022;Республика Коми;105_165_days;AllVaccines;49282;23632;72914;465210;166370;631580
2022.04_13-10-2022;Республика Коми;105_165_days;CoviVac;641;155;796;465210;166370;631580
2022.04_13-10-2022;Республика Коми;105_165_days;EpiVacCorona;1508;663;2171;465210;166370;631580
2022.04_13-10-2022;Республика Коми;105_165_days;SputnikLite;25031;12727;37758;465210;166370;631580
2022.04_13-10-2022;Республика Коми;105_165_days;SputnikV;22102;10087;32189;465210;166370;631580
2022.04_13-10-2022;Республика Коми;165_195_days;AllVaccines;32988;17423;50411;465210;166370;631580
2022.04_13-10-2022;Республика Коми;165_195_days;CoviVac;451;98;549;465210;166370;631580
2022.04_13-10-2022;Республика Коми;165_195_days;EpiVacCorona;412;150;562;465210;166370;631580
2022.04_13-10-2022;Республика Коми;165_195_days;SputnikLite;21417;11256;32673;465210;166370;631580
2022.04_13-10-2022;Республика Коми;165_195_days;SputnikV;10708;5919;16627;465210;166370;631580
2022.04_13-10-2022;Республика Коми;21_45_days;AllVaccines;3032;1398;4430;465210;166370;631580
2022.04_13-10-2022;Республика Коми;21_45_days;CoviVac;117;49;166;465210;166370;631580
2022.04_13-10-2022;Республика Коми;21_45_days;EpiVacCorona;103;51;154;465210;166370;631580
2022.04_13-10-2022;Республика Коми;21_45_days;SputnikLite;1187;485;1672;465210;166370;631580
2022.04_13-10-2022;Республика Коми;21_45_days;SputnikV;1625;813;2438;465210;166370;631580
2022.04_13-10-2022;Республика Коми;45_75_days;AllVaccines;8741;3315;12056;465210;166370;631580
2022.04_13-10-2022;Республика Коми;45_75_days;CoviVac;127;55;182;465210;166370;631580
2022.04_13-10-2022;Республика Коми;45_75_days;EpiVacCorona;221;63;284;465210;166370;631580
2022.04_13-10-2022;Республика Коми;45_75_days;SputnikLite;4114;1473;5587;465210;166370;631580
2022.04_13-10-2022;Республика Коми;45_75_days;SputnikV;4279;1724;6003;465210;166370;631580
2022.04_13-10-2022;Республика Коми;75_90_days;AllVaccines;5970;2716;8686;465210;166370;631580
2022.04_13-10-2022;Республика Коми;75_90_days;CoviVac;121;25;146;465210;166370;631580
2022.04_13-10-2022;Республика Коми;75_90_days;EpiVacCorona;149;81;230;465210;166370;631580
2022.04_13-10-2022;Республика Коми;75_90_days;SputnikLite;2191;672;2863;465210;166370;631580
2022.04_13-10-2022;Республика Коми;75_90_days;SputnikV;3509;1938;5447;465210;166370;631580
2022.04_13-10-2022;Республика Коми;90_105_days;AllVaccines;7662;3311;10973;465210;166370;631580
2022.04_13-10-2022;Республика Коми;90_105_days;CoviVac;159;36;195;465210;166370;631580
2022.04_13-10-2022;Республика Коми;90_105_days;EpiVacCorona;318;184;502;465210;166370;631580
2022.04_13-10-2022;Республика Коми;90_105_days;SputnikLite;4556;1513;6069;465210;166370;631580
2022.04_13-10-2022;Республика Коми;90_105_days;SputnikV;2629;1578;4207;465210;166370;631580
2022.04_13-10-2022;Республика Крым;105_165_days;AllVaccines;188038;95459;283497;1036087;480146;1516233
2022.04_13-10-2022;Республика Крым;105_165_days;CoviVac;1356;458;1814;1036087;480146;1516233
2022.04_13-10-2022;Республика Крым;105_165_days;EpiVacCorona;4483;2422;6905;1036087;480146;1516233
2022.04_13-10-2022;Республика Крым;105_165_days;SputnikLite;68119;57886;126005;1036087;480146;1516233
2022.04_13-10-2022;Республика Крым;105_165_days;SputnikV;114080;34693;148773;1036087;480146;1516233
2022.04_13-10-2022;Республика Крым;165_195_days;AllVaccines;208888;53309;262197;1036087;480146;1516233
2022.04_13-10-2022;Республика Крым;165_195_days;CoviVac;2021;436;2457;1036087;480146;1516233
2022.04_13-10-2022;Республика Крым;165_195_days;EpiVacCorona;5482;1679;7161;1036087;480146;1516233
2022.04_13-10-2022;Республика Крым;165_195_days;SputnikLite;17915;19631;37546;1036087;480146;1516233
2022.04_13-10-2022;Республика Крым;165_195_days;SputnikV;183470;31563;215033;1036087;480146;1516233
2022.04_13-10-2022;Республика Крым;21_45_days;AllVaccines;8001;4674;12675;1036087;480146;1516233
2022.04_13-10-2022;Республика Крым;21_45_days;CoviVac;431;161;592;1036087;480146;1516233
2022.04_13-10-2022;Республика Крым;21_45_days;EpiVacCorona;601;432;1033;1036087;480146;1516233
2022.04_13-10-2022;Республика Крым;21_45_days;SputnikLite;493;85;578;1036087;480146;1516233
2022.04_13-10-2022;Республика Крым;21_45_days;SputnikV;6476;3996;10472;1036087;480146;1516233
2022.04_13-10-2022;Республика Крым;45_75_days;AllVaccines;11225;5522;16747;1036087;480146;1516233
2022.04_13-10-2022;Республика Крым;45_75_days;CoviVac;370;108;478;1036087;480146;1516233
2022.04_13-10-2022;Республика Крым;45_75_days;EpiVacCorona;1366;787;2153;1036087;480146;1516233
2022.04_13-10-2022;Республика Крым;45_75_days;SputnikLite;550;250;800;1036087;480146;1516233
2022.04_13-10-2022;Республика Крым;45_75_days;SputnikV;8939;4377;13316;1036087;480146;1516233
2022.04_13-10-2022;Республика Крым;75_90_days;AllVaccines;11493;4623;16116;1036087;480146;1516233
2022.04_13-10-2022;Республика Крым;75_90_days;CoviVac;214;66;280;1036087;480146;1516233
2022.04_13-10-2022;Республика Крым;75_90_days;EpiVacCorona;1484;729;2213;1036087;480146;1516233
2022.04_13-10-2022;Республика Крым;75_90_days;SputnikLite;3326;1353;4679;1036087;480146;1516233
2022.04_13-10-2022;Республика Крым;75_90_days;SputnikV;6469;2475;8944;1036087;480146;1516233
2022.04_13-10-2022;Республика Крым;90_105_days;AllVaccines;18253;9537;27790;1036087;480146;1516233
2022.04_13-10-2022;Республика Крым;90_105_days;CoviVac;246;97;343;1036087;480146;1516233
2022.04_13-10-2022;Республика Крым;90_105_days;EpiVacCorona;1162;737;1899;1036087;480146;1516233
2022.04_13-10-2022;Республика Крым;90_105_days;SputnikLite;9874;5384;15258;1036087;480146;1516233
2022.04_13-10-2022;Республика Крым;90_105_days;SputnikV;6971;3319;10290;1036087;480146;1516233
2022.04_13-10-2022;Республика Марий Эл;105_165_days;AllVaccines;57855;24622;82477;370626;156749;527375
2022.04_13-10-2022;Республика Марий Эл;105_165_days;CoviVac;588;193;781;370626;156749;527375
2022.04_13-10-2022;Республика Марий Эл;105_165_days;EpiVacCorona;2275;995;3270;370626;156749;527375
2022.04_13-10-2022;Республика Марий Эл;105_165_days;SputnikLite;25345;12426;37771;370626;156749;527375
2022.04_13-10-2022;Республика Марий Эл;105_165_days;SputnikV;29647;11008;40655;370626;156749;527375
2022.04_13-10-2022;Республика Марий Эл;165_195_days;AllVaccines;41312;17405;58717;370626;156749;527375
2022.04_13-10-2022;Республика Марий Эл;165_195_days;CoviVac;417;122;539;370626;156749;527375
2022.04_13-10-2022;Республика Марий Эл;165_195_days;EpiVacCorona;3206;878;4084;370626;156749;527375
2022.04_13-10-2022;Республика Марий Эл;165_195_days;SputnikLite;14396;7905;22301;370626;156749;527375
2022.04_13-10-2022;Республика Марий Эл;165_195_days;SputnikV;23293;8500;31793;370626;156749;527375
2022.04_13-10-2022;Республика Марий Эл;21_45_days;AllVaccines;2015;1094;3109;370626;156749;527375
2022.04_13-10-2022;Республика Марий Эл;21_45_days;CoviVac;29;3;32;370626;156749;527375
2022.04_13-10-2022;Республика Марий Эл;21_45_days;EpiVacCorona;111;39;150;370626;156749;527375
2022.04_13-10-2022;Республика Марий Эл;21_45_days;SputnikLite;626;67;693;370626;156749;527375
2022.04_13-10-2022;Республика Марий Эл;21_45_days;SputnikV;1249;985;2234;370626;156749;527375
2022.04_13-10-2022;Республика Марий Эл;45_75_days;AllVaccines;2542;2440;4982;370626;156749;527375
2022.04_13-10-2022;Республика Марий Эл;45_75_days;CoviVac;251;142;393;370626;156749;527375
2022.04_13-10-2022;Республика Марий Эл;45_75_days;EpiVacCorona;167;240;407;370626;156749;527375
2022.04_13-10-2022;Республика Марий Эл;45_75_days;SputnikLite;564;310;874;370626;156749;527375
2022.04_13-10-2022;Республика Марий Эл;45_75_days;SputnikV;1560;1748;3308;370626;156749;527375
2022.04_13-10-2022;Республика Марий Эл;75_90_days;AllVaccines;5057;4544;9601;370626;156749;527375
2022.04_13-10-2022;Республика Марий Эл;75_90_days;CoviVac;110;79;189;370626;156749;527375
2022.04_13-10-2022;Республика Марий Эл;75_90_days;EpiVacCorona;147;195;342;370626;156749;527375
2022.04_13-10-2022;Республика Марий Эл;75_90_days;SputnikLite;3393;2807;6200;370626;156749;527375
2022.04_13-10-2022;Республика Марий Эл;75_90_days;SputnikV;1407;1463;2870;370626;156749;527375
2022.04_13-10-2022;Республика Марий Эл;90_105_days;AllVaccines;5546;4016;9562;370626;156749;527375
2022.04_13-10-2022;Республика Марий Эл;90_105_days;CoviVac;85;35;120;370626;156749;527375
2022.04_13-10-2022;Республика Марий Эл;90_105_days;EpiVacCorona;485;467;952;370626;156749;527375
2022.04_13-10-2022;Республика Марий Эл;90_105_days;SputnikLite;3217;2361;5578;370626;156749;527375
2022.04_13-10-2022;Республика Марий Эл;90_105_days;SputnikV;1759;1153;2912;370626;156749;527375
2022.04_13-10-2022;Республика Мордовия;105_165_days;AllVaccines;69961;34781;104742;448319;198808;647127
2022.04_13-10-2022;Республика Мордовия;105_165_days;CoviVac;1024;300;1324;448319;198808;647127
2022.04_13-10-2022;Республика Мордовия;105_165_days;EpiVacCorona;2810;1418;4228;448319;198808;647127
2022.04_13-10-2022;Республика Мордовия;105_165_days;SputnikLite;36356;18053;54409;448319;198808;647127
2022.04_13-10-2022;Республика Мордовия;105_165_days;SputnikV;29771;15010;44781;448319;198808;647127
2022.04_13-10-2022;Республика Мордовия;165_195_days;AllVaccines;51341;28091;79432;448319;198808;647127
2022.04_13-10-2022;Республика Мордовия;165_195_days;CoviVac;881;234;1115;448319;198808;647127
2022.04_13-10-2022;Республика Мордовия;165_195_days;EpiVacCorona;1459;480;1939;448319;198808;647127
2022.04_13-10-2022;Республика Мордовия;165_195_days;SputnikLite;16956;12863;29819;448319;198808;647127
2022.04_13-10-2022;Республика Мордовия;165_195_days;SputnikV;32045;14514;46559;448319;198808;647127
2022.04_13-10-2022;Республика Мордовия;21_45_days;AllVaccines;11888;8467;20355;448319;198808;647127
2022.04_13-10-2022;Республика Мордовия;21_45_days;CoviVac;294;90;384;448319;198808;647127
2022.04_13-10-2022;Республика Мордовия;21_45_days;EpiVacCorona;735;750;1485;448319;198808;647127
2022.04_13-10-2022;Республика Мордовия;21_45_days;SputnikLite;2810;2011;4821;448319;198808;647127
2022.04_13-10-2022;Республика Мордовия;21_45_days;SputnikV;8049;5616;13665;448319;198808;647127
2022.04_13-10-2022;Республика Мордовия;45_75_days;AllVaccines;12511;7401;19912;448319;198808;647127
2022.04_13-10-2022;Республика Мордовия;45_75_days;CoviVac;298;157;455;448319;198808;647127
2022.04_13-10-2022;Республика Мордовия;45_75_days;EpiVacCorona;884;608;1492;448319;198808;647127
2022.04_13-10-2022;Республика Мордовия;45_75_days;SputnikLite;5540;2910;8450;448319;198808;647127
2022.04_13-10-2022;Республика Мордовия;45_75_days;SputnikV;5789;3726;9515;448319;198808;647127
2022.04_13-10-2022;Республика Мордовия;75_90_days;AllVaccines;13272;6883;20155;448319;198808;647127
2022.04_13-10-2022;Республика Мордовия;75_90_days;CoviVac;153;25;178;448319;198808;647127
2022.04_13-10-2022;Республика Мордовия;75_90_days;EpiVacCorona;1407;975;2382;448319;198808;647127
2022.04_13-10-2022;Республика Мордовия;75_90_days;SputnikLite;6847;3236;10083;448319;198808;647127
2022.04_13-10-2022;Республика Мордовия;75_90_days;SputnikV;4865;2647;7512;448319;198808;647127
2022.04_13-10-2022;Республика Мордовия;90_105_days;AllVaccines;15074;6689;21763;448319;198808;647127
2022.04_13-10-2022;Республика Мордовия;90_105_days;CoviVac;195;52;247;448319;198808;647127
2022.04_13-10-2022;Республика Мордовия;90_105_days;EpiVacCorona;1332;650;1982;448319;198808;647127
2022.04_13-10-2022;Республика Мордовия;90_105_days;SputnikLite;8431;3062;11493;448319;198808;647127
2022.04_13-10-2022;Республика Мордовия;90_105_days;SputnikV;5116;2925;8041;448319;198808;647127
2022.04_13-10-2022;Республика Саха (Якутия);105_165_days;AllVaccines;71986;20123;92109;568643;148395;717038
2022.04_13-10-2022;Республика Саха (Якутия);105_165_days;CoviVac;1197;163;1360;568643;148395;717038
2022.04_13-10-2022;Республика Саха (Якутия);105_165_days;EpiVacCorona;767;311;1078;568643;148395;717038
2022.04_13-10-2022;Республика Саха (Якутия);105_165_days;SputnikLite;37823;10759;48582;568643;148395;717038
2022.04_13-10-2022;Республика Саха (Якутия);105_165_days;SputnikV;32199;8890;41089;568643;148395;717038
2022.04_13-10-2022;Республика Саха (Якутия);165_195_days;AllVaccines;47899;14057;61956;568643;148395;717038
2022.04_13-10-2022;Республика Саха (Якутия);165_195_days;CoviVac;888;167;1055;568643;148395;717038
2022.04_13-10-2022;Республика Саха (Якутия);165_195_days;EpiVacCorona;386;180;566;568643;148395;717038
2022.04_13-10-2022;Республика Саха (Якутия);165_195_days;SputnikLite;30681;9335;40016;568643;148395;717038
2022.04_13-10-2022;Республика Саха (Якутия);165_195_days;SputnikV;15944;4375;20319;568643;148395;717038
2022.04_13-10-2022;Республика Саха (Якутия);21_45_days;AllVaccines;4645;1127;5772;568643;148395;717038
2022.04_13-10-2022;Республика Саха (Якутия);21_45_days;CoviVac;103;12;115;568643;148395;717038
2022.04_13-10-2022;Республика Саха (Якутия);21_45_days;EpiVacCorona;453;89;542;568643;148395;717038
2022.04_13-10-2022;Республика Саха (Якутия);21_45_days;SputnikLite;812;254;1066;568643;148395;717038
2022.04_13-10-2022;Республика Саха (Якутия);21_45_days;SputnikV;3277;772;4049;568643;148395;717038
2022.04_13-10-2022;Республика Саха (Якутия);45_75_days;AllVaccines;10144;2075;12219;568643;148395;717038
2022.04_13-10-2022;Республика Саха (Якутия);45_75_days;CoviVac;153;21;174;568643;148395;717038
2022.04_13-10-2022;Республика Саха (Якутия);45_75_days;EpiVacCorona;494;151;645;568643;148395;717038
2022.04_13-10-2022;Республика Саха (Якутия);45_75_days;SputnikLite;2650;565;3215;568643;148395;717038
2022.04_13-10-2022;Республика Саха (Якутия);45_75_days;SputnikV;6847;1338;8185;568643;148395;717038
2022.04_13-10-2022;Республика Саха (Якутия);75_90_days;AllVaccines;10503;2485;12988;568643;148395;717038
2022.04_13-10-2022;Республика Саха (Якутия);75_90_days;CoviVac;109;10;119;568643;148395;717038
2022.04_13-10-2022;Республика Саха (Якутия);75_90_days;EpiVacCorona;414;133;547;568643;148395;717038
2022.04_13-10-2022;Республика Саха (Якутия);75_90_days;SputnikLite;2782;437;3219;568643;148395;717038
2022.04_13-10-2022;Республика Саха (Якутия);75_90_days;SputnikV;7198;1905;9103;568643;148395;717038
2022.04_13-10-2022;Республика Саха (Якутия);90_105_days;AllVaccines;11526;2959;14485;568643;148395;717038
2022.04_13-10-2022;Республика Саха (Якутия);90_105_days;CoviVac;105;16;121;568643;148395;717038
2022.04_13-10-2022;Республика Саха (Якутия);90_105_days;EpiVacCorona;382;186;568;568643;148395;717038
2022.04_13-10-2022;Республика Саха (Якутия);90_105_days;SputnikLite;3954;627;4581;568643;148395;717038
2022.04_13-10-2022;Республика Саха (Якутия);90_105_days;SputnikV;7085;2130;9215;568643;148395;717038
2022.04_13-10-2022;Республика Северная Осетия - Алания;105_165_days;AllVaccines;35474;8316;43790;385443;144230;529673
2022.04_13-10-2022;Республика Северная Осетия - Алания;105_165_days;CoviVac;309;126;435;385443;144230;529673
2022.04_13-10-2022;Республика Северная Осетия - Алания;105_165_days;EpiVacCorona;2598;731;3329;385443;144230;529673
2022.04_13-10-2022;Республика Северная Осетия - Алания;105_165_days;SputnikLite;14479;3845;18324;385443;144230;529673
2022.04_13-10-2022;Республика Северная Осетия - Алания;105_165_days;SputnikV;18088;3614;21702;385443;144230;529673
2022.04_13-10-2022;Республика Северная Осетия - Алания;165_195_days;AllVaccines;32264;6531;38795;385443;144230;529673
2022.04_13-10-2022;Республика Северная Осетия - Алания;165_195_days;CoviVac;478;125;603;385443;144230;529673
2022.04_13-10-2022;Республика Северная Осетия - Алания;165_195_days;EpiVacCorona;545;55;600;385443;144230;529673
2022.04_13-10-2022;Республика Северная Осетия - Алания;165_195_days;SputnikLite;16732;3604;20336;385443;144230;529673
2022.04_13-10-2022;Республика Северная Осетия - Алания;165_195_days;SputnikV;14509;2747;17256;385443;144230;529673
2022.04_13-10-2022;Республика Северная Осетия - Алания;21_45_days;AllVaccines;2157;1156;3313;385443;144230;529673
2022.04_13-10-2022;Республика Северная Осетия - Алания;21_45_days;CoviVac;162;112;274;385443;144230;529673
2022.04_13-10-2022;Республика Северная Осетия - Алания;21_45_days;EpiVacCorona;28;13;41;385443;144230;529673
2022.04_13-10-2022;Республика Северная Осетия - Алания;21_45_days;SputnikLite;286;89;375;385443;144230;529673
2022.04_13-10-2022;Республика Северная Осетия - Алания;21_45_days;SputnikV;1681;942;2623;385443;144230;529673
2022.04_13-10-2022;Республика Северная Осетия - Алания;45_75_days;AllVaccines;4106;1848;5954;385443;144230;529673
2022.04_13-10-2022;Республика Северная Осетия - Алания;45_75_days;CoviVac;85;257;342;385443;144230;529673
2022.04_13-10-2022;Республика Северная Осетия - Алания;45_75_days;EpiVacCorona;296;475;771;385443;144230;529673
2022.04_13-10-2022;Республика Северная Осетия - Алания;45_75_days;SputnikLite;1026;329;1355;385443;144230;529673
2022.04_13-10-2022;Республика Северная Осетия - Алания;45_75_days;SputnikV;2699;787;3486;385443;144230;529673
2022.04_13-10-2022;Республика Северная Осетия - Алания;75_90_days;AllVaccines;3952;1056;5008;385443;144230;529673
2022.04_13-10-2022;Республика Северная Осетия - Алания;75_90_days;CoviVac;47;10;57;385443;144230;529673
2022.04_13-10-2022;Республика Северная Осетия - Алания;75_90_days;EpiVacCorona;126;22;148;385443;144230;529673
2022.04_13-10-2022;Республика Северная Осетия - Алания;75_90_days;SputnikLite;1547;409;1956;385443;144230;529673
2022.04_13-10-2022;Республика Северная Осетия - Алания;75_90_days;SputnikV;2232;615;2847;385443;144230;529673
2022.04_13-10-2022;Республика Северная Осетия - Алания;90_105_days;AllVaccines;3532;1443;4975;385443;144230;529673
2022.04_13-10-2022;Республика Северная Осетия - Алания;90_105_days;CoviVac;23;9;32;385443;144230;529673
2022.04_13-10-2022;Республика Северная Осетия - Алания;90_105_days;EpiVacCorona;124;148;272;385443;144230;529673
2022.04_13-10-2022;Республика Северная Осетия - Алания;90_105_days;SputnikLite;1386;572;1958;385443;144230;529673
2022.04_13-10-2022;Республика Северная Осетия - Алания;90_105_days;SputnikV;1999;714;2713;385443;144230;529673
2022.04_13-10-2022;Республика Татарстан;105_165_days;AllVaccines;298207;142716;440923;2180132;866477;3046609
2022.04_13-10-2022;Республика Татарстан;105_165_days;CoviVac;1158;446;1604;2180132;866477;3046609
2022.04_13-10-2022;Республика Татарстан;105_165_days;EpiVacCorona;5210;4010;9220;2180132;866477;3046609
2022.04_13-10-2022;Республика Татарстан;105_165_days;SputnikLite;71044;50463;121507;2180132;866477;3046609
2022.04_13-10-2022;Республика Татарстан;105_165_days;SputnikV;220795;87797;308592;2180132;866477;3046609
2022.04_13-10-2022;Республика Татарстан;165_195_days;AllVaccines;508093;139959;648052;2180132;866477;3046609
2022.04_13-10-2022;Республика Татарстан;165_195_days;CoviVac;2043;428;2471;2180132;866477;3046609
2022.04_13-10-2022;Республика Татарстан;165_195_days;EpiVacCorona;9758;4243;14001;2180132;866477;3046609
2022.04_13-10-2022;Республика Татарстан;165_195_days;SputnikLite;51634;27506;79140;2180132;866477;3046609
2022.04_13-10-2022;Республика Татарстан;165_195_days;SputnikV;444658;107782;552440;2180132;866477;3046609
2022.04_13-10-2022;Республика Татарстан;21_45_days;AllVaccines;15473;7440;22913;2180132;866477;3046609
2022.04_13-10-2022;Республика Татарстан;21_45_days;CoviVac;147;59;206;2180132;866477;3046609
2022.04_13-10-2022;Республика Татарстан;21_45_days;EpiVacCorona;1164;678;1842;2180132;866477;3046609
2022.04_13-10-2022;Республика Татарстан;21_45_days;SputnikLite;6661;3972;10633;2180132;866477;3046609
2022.04_13-10-2022;Республика Татарстан;21_45_days;SputnikV;7501;2731;10232;2180132;866477;3046609
2022.04_13-10-2022;Республика Татарстан;45_75_days;AllVaccines;34188;13501;47689;2180132;866477;3046609
2022.04_13-10-2022;Республика Татарстан;45_75_days;CoviVac;510;213;723;2180132;866477;3046609
2022.04_13-10-2022;Республика Татарстан;45_75_days;EpiVacCorona;1015;655;1670;2180132;866477;3046609
2022.04_13-10-2022;Республика Татарстан;45_75_days;SputnikLite;11775;5396;17171;2180132;866477;3046609
2022.04_13-10-2022;Республика Татарстан;45_75_days;SputnikV;20888;7237;28125;2180132;866477;3046609
2022.04_13-10-2022;Республика Татарстан;75_90_days;AllVaccines;28862;12208;41070;2180132;866477;3046609
2022.04_13-10-2022;Республика Татарстан;75_90_days;CoviVac;147;65;212;2180132;866477;3046609
2022.04_13-10-2022;Республика Татарстан;75_90_days;EpiVacCorona;358;254;612;2180132;866477;3046609
2022.04_13-10-2022;Республика Татарстан;75_90_days;SputnikLite;11433;4347;15780;2180132;866477;3046609
2022.04_13-10-2022;Республика Татарстан;75_90_days;SputnikV;16924;7542;24466;2180132;866477;3046609
2022.04_13-10-2022;Республика Татарстан;90_105_days;AllVaccines;33624;15372;48996;2180132;866477;3046609
2022.04_13-10-2022;Республика Татарстан;90_105_days;CoviVac;272;134;406;2180132;866477;3046609
2022.04_13-10-2022;Республика Татарстан;90_105_days;EpiVacCorona;509;483;992;2180132;866477;3046609
2022.04_13-10-2022;Республика Татарстан;90_105_days;SputnikLite;15446;6021;21467;2180132;866477;3046609
2022.04_13-10-2022;Республика Татарстан;90_105_days;SputnikV;17397;8734;26131;2180132;866477;3046609
2022.04_13-10-2022;Республика Тыва;105_165_days;AllVaccines;23776;4872;28648;176122;31028;207150
2022.04_13-10-2022;Республика Тыва;105_165_days;CoviVac;6;0;6;176122;31028;207150
2022.04_13-10-2022;Республика Тыва;105_165_days;EpiVacCorona;221;19;240;176122;31028;207150
2022.04_13-10-2022;Республика Тыва;105_165_days;SputnikLite;15833;3728;19561;176122;31028;207150
2022.04_13-10-2022;Республика Тыва;105_165_days;SputnikV;7716;1125;8841;176122;31028;207150
2022.04_13-10-2022;Республика Тыва;165_195_days;AllVaccines;18524;3768;22292;176122;31028;207150
2022.04_13-10-2022;Республика Тыва;165_195_days;CoviVac;22;2;24;176122;31028;207150
2022.04_13-10-2022;Республика Тыва;165_195_days;EpiVacCorona;85;22;107;176122;31028;207150
2022.04_13-10-2022;Республика Тыва;165_195_days;SputnikLite;14084;2934;17018;176122;31028;207150
2022.04_13-10-2022;Республика Тыва;165_195_days;SputnikV;4333;810;5143;176122;31028;207150
2022.04_13-10-2022;Республика Тыва;21_45_days;AllVaccines;4243;828;5071;176122;31028;207150
2022.04_13-10-2022;Республика Тыва;21_45_days;CoviVac;334;45;379;176122;31028;207150
2022.04_13-10-2022;Республика Тыва;21_45_days;EpiVacCorona;417;104;521;176122;31028;207150
2022.04_13-10-2022;Республика Тыва;21_45_days;SputnikLite;1684;272;1956;176122;31028;207150
2022.04_13-10-2022;Республика Тыва;21_45_days;SputnikV;1808;407;2215;176122;31028;207150
2022.04_13-10-2022;Республика Тыва;45_75_days;AllVaccines;7875;1415;9290;176122;31028;207150
2022.04_13-10-2022;Республика Тыва;45_75_days;CoviVac;91;35;126;176122;31028;207150
2022.04_13-10-2022;Республика Тыва;45_75_days;EpiVacCorona;307;44;351;176122;31028;207150
2022.04_13-10-2022;Республика Тыва;45_75_days;SputnikLite;4096;807;4903;176122;31028;207150
2022.04_13-10-2022;Республика Тыва;45_75_days;SputnikV;3381;529;3910;176122;31028;207150
2022.04_13-10-2022;Республика Тыва;75_90_days;AllVaccines;5701;1040;6741;176122;31028;207150
2022.04_13-10-2022;Республика Тыва;75_90_days;CoviVac;21;2;23;176122;31028;207150
2022.04_13-10-2022;Республика Тыва;75_90_days;EpiVacCorona;66;14;80;176122;31028;207150
2022.04_13-10-2022;Республика Тыва;75_90_days;SputnikLite;2995;548;3543;176122;31028;207150
2022.04_13-10-2022;Республика Тыва;75_90_days;SputnikV;2619;476;3095;176122;31028;207150
2022.04_13-10-2022;Республика Тыва;90_105_days;AllVaccines;4782;759;5541;176122;31028;207150
2022.04_13-10-2022;Республика Тыва;90_105_days;CoviVac;13;1;14;176122;31028;207150
2022.04_13-10-2022;Республика Тыва;90_105_days;EpiVacCorona;62;7;69;176122;31028;207150
2022.04_13-10-2022;Республика Тыва;90_105_days;SputnikLite;2334;328;2662;176122;31028;207150
2022.04_13-10-2022;Республика Тыва;90_105_days;SputnikV;2373;423;2796;176122;31028;207150
2022.04_13-10-2022;Республика Хакасия;105_165_days;AllVaccines;32937;14827;47764;291439;112190;403629
2022.04_13-10-2022;Республика Хакасия;105_165_days;CoviVac;513;143;656;291439;112190;403629
2022.04_13-10-2022;Республика Хакасия;105_165_days;EpiVacCorona;940;389;1329;291439;112190;403629
2022.04_13-10-2022;Республика Хакасия;105_165_days;SputnikLite;17050;8230;25280;291439;112190;403629
2022.04_13-10-2022;Республика Хакасия;105_165_days;SputnikV;14434;6065;20499;291439;112190;403629
2022.04_13-10-2022;Республика Хакасия;165_195_days;AllVaccines;20207;12007;32214;291439;112190;403629
2022.04_13-10-2022;Республика Хакасия;165_195_days;CoviVac;489;165;654;291439;112190;403629
2022.04_13-10-2022;Республика Хакасия;165_195_days;EpiVacCorona;384;198;582;291439;112190;403629
2022.04_13-10-2022;Республика Хакасия;165_195_days;SputnikLite;10121;7168;17289;291439;112190;403629
2022.04_13-10-2022;Республика Хакасия;165_195_days;SputnikV;9213;4476;13689;291439;112190;403629
2022.04_13-10-2022;Республика Хакасия;21_45_days;AllVaccines;1417;672;2089;291439;112190;403629
2022.04_13-10-2022;Республика Хакасия;21_45_days;CoviVac;129;42;171;291439;112190;403629
2022.04_13-10-2022;Республика Хакасия;21_45_days;EpiVacCorona;77;35;112;291439;112190;403629
2022.04_13-10-2022;Республика Хакасия;21_45_days;SputnikLite;132;98;230;291439;112190;403629
2022.04_13-10-2022;Республика Хакасия;21_45_days;SputnikV;1079;497;1576;291439;112190;403629
2022.04_13-10-2022;Республика Хакасия;45_75_days;AllVaccines;3508;1531;5039;291439;112190;403629
2022.04_13-10-2022;Республика Хакасия;45_75_days;CoviVac;89;15;104;291439;112190;403629
2022.04_13-10-2022;Республика Хакасия;45_75_days;EpiVacCorona;166;51;217;291439;112190;403629
2022.04_13-10-2022;Республика Хакасия;45_75_days;SputnikLite;685;296;981;291439;112190;403629
2022.04_13-10-2022;Республика Хакасия;45_75_days;SputnikV;2568;1169;3737;291439;112190;403629
2022.04_13-10-2022;Республика Хакасия;75_90_days;AllVaccines;5627;2154;7781;291439;112190;403629
2022.04_13-10-2022;Республика Хакасия;75_90_days;CoviVac;114;24;138;291439;112190;403629
2022.04_13-10-2022;Республика Хакасия;75_90_days;EpiVacCorona;220;72;292;291439;112190;403629
2022.04_13-10-2022;Республика Хакасия;75_90_days;SputnikLite;2743;848;3591;291439;112190;403629
2022.04_13-10-2022;Республика Хакасия;75_90_days;SputnikV;2550;1210;3760;291439;112190;403629
2022.04_13-10-2022;Республика Хакасия;90_105_days;AllVaccines;7271;2577;9848;291439;112190;403629
2022.04_13-10-2022;Республика Хакасия;90_105_days;CoviVac;133;47;180;291439;112190;403629
2022.04_13-10-2022;Республика Хакасия;90_105_days;EpiVacCorona;374;136;510;291439;112190;403629
2022.04_13-10-2022;Республика Хакасия;90_105_days;SputnikLite;4883;1465;6348;291439;112190;403629
2022.04_13-10-2022;Республика Хакасия;90_105_days;SputnikV;1881;929;2810;291439;112190;403629
2022.04_13-10-2022;Ростовская область;105_165_days;AllVaccines;243343;133799;377142;2367942;1020468;3388410
2022.04_13-10-2022;Ростовская область;105_165_days;CoviVac;1631;676;2307;2367942;1020468;3388410
2022.04_13-10-2022;Ростовская область;105_165_days;EpiVacCorona;2143;1451;3594;2367942;1020468;3388410
2022.04_13-10-2022;Ростовская область;105_165_days;SputnikLite;82819;45602;128421;2367942;1020468;3388410
2022.04_13-10-2022;Ростовская область;105_165_days;SputnikV;156750;86070;242820;2367942;1020468;3388410
2022.04_13-10-2022;Ростовская область;165_195_days;AllVaccines;132735;70758;203493;2367942;1020468;3388410
2022.04_13-10-2022;Ростовская область;165_195_days;CoviVac;1908;780;2688;2367942;1020468;3388410
2022.04_13-10-2022;Ростовская область;165_195_days;EpiVacCorona;1730;794;2524;2367942;1020468;3388410
2022.04_13-10-2022;Ростовская область;165_195_days;SputnikLite;31884;23733;55617;2367942;1020468;3388410
2022.04_13-10-2022;Ростовская область;165_195_days;SputnikV;97213;45451;142664;2367942;1020468;3388410
2022.04_13-10-2022;Ростовская область;21_45_days;AllVaccines;25840;17089;42929;2367942;1020468;3388410
2022.04_13-10-2022;Ростовская область;21_45_days;CoviVac;792;287;1079;2367942;1020468;3388410
2022.04_13-10-2022;Ростовская область;21_45_days;EpiVacCorona;2710;2124;4834;2367942;1020468;3388410
2022.04_13-10-2022;Ростовская область;21_45_days;SputnikLite;1666;609;2275;2367942;1020468;3388410
2022.04_13-10-2022;Ростовская область;21_45_days;SputnikV;20672;14069;34741;2367942;1020468;3388410
2022.04_13-10-2022;Ростовская область;45_75_days;AllVaccines;46221;26238;72459;2367942;1020468;3388410
2022.04_13-10-2022;Ростовская область;45_75_days;CoviVac;825;206;1031;2367942;1020468;3388410
2022.04_13-10-2022;Ростовская область;45_75_days;EpiVacCorona;3369;1864;5233;2367942;1020468;3388410
2022.04_13-10-2022;Ростовская область;45_75_days;SputnikLite;8364;2997;11361;2367942;1020468;3388410
2022.04_13-10-2022;Ростовская область;45_75_days;SputnikV;33663;21171;54834;2367942;1020468;3388410
2022.04_13-10-2022;Ростовская область;75_90_days;AllVaccines;61961;28020;89981;2367942;1020468;3388410
2022.04_13-10-2022;Ростовская область;75_90_days;CoviVac;538;147;685;2367942;1020468;3388410
2022.04_13-10-2022;Ростовская область;75_90_days;EpiVacCorona;2856;2065;4921;2367942;1020468;3388410
2022.04_13-10-2022;Ростовская область;75_90_days;SputnikLite;24208;7518;31726;2367942;1020468;3388410
2022.04_13-10-2022;Ростовская область;75_90_days;SputnikV;34359;18290;52649;2367942;1020468;3388410
2022.04_13-10-2022;Ростовская область;90_105_days;AllVaccines;56444;26395;82839;2367942;1020468;3388410
2022.04_13-10-2022;Ростовская область;90_105_days;CoviVac;740;213;953;2367942;1020468;3388410
2022.04_13-10-2022;Ростовская область;90_105_days;EpiVacCorona;1803;975;2778;2367942;1020468;3388410
2022.04_13-10-2022;Ростовская область;90_105_days;SputnikLite;24500;6877;31377;2367942;1020468;3388410
2022.04_13-10-2022;Ростовская область;90_105_days;SputnikV;29401;18330;47731;2367942;1020468;3388410
2022.04_13-10-2022;Рязанская область;105_165_days;AllVaccines;91755;50044;141799;600731;301318;902049
2022.04_13-10-2022;Рязанская область;105_165_days;CoviVac;1466;439;1905;600731;301318;902049
2022.04_13-10-2022;Рязанская область;105_165_days;EpiVacCorona;2234;947;3181;600731;301318;902049
2022.04_13-10-2022;Рязанская область;105_165_days;SputnikLite;29980;24883;54863;600731;301318;902049
2022.04_13-10-2022;Рязанская область;105_165_days;SputnikV;58075;23775;81850;600731;301318;902049
2022.04_13-10-2022;Рязанская область;165_195_days;AllVaccines;87799;27079;114878;600731;301318;902049
2022.04_13-10-2022;Рязанская область;165_195_days;CoviVac;1304;266;1570;600731;301318;902049
2022.04_13-10-2022;Рязанская область;165_195_days;EpiVacCorona;4487;1109;5596;600731;301318;902049
2022.04_13-10-2022;Рязанская область;165_195_days;SputnikLite;6799;6740;13539;600731;301318;902049
2022.04_13-10-2022;Рязанская область;165_195_days;SputnikV;75209;18964;94173;600731;301318;902049
2022.04_13-10-2022;Рязанская область;21_45_days;AllVaccines;3042;2641;5683;600731;301318;902049
2022.04_13-10-2022;Рязанская область;21_45_days;CoviVac;145;41;186;600731;301318;902049
2022.04_13-10-2022;Рязанская область;21_45_days;EpiVacCorona;62;24;86;600731;301318;902049
2022.04_13-10-2022;Рязанская область;21_45_days;SputnikLite;1152;1233;2385;600731;301318;902049
2022.04_13-10-2022;Рязанская область;21_45_days;SputnikV;1683;1343;3026;600731;301318;902049
2022.04_13-10-2022;Рязанская область;45_75_days;AllVaccines;5118;2597;7715;600731;301318;902049
2022.04_13-10-2022;Рязанская область;45_75_days;CoviVac;198;55;253;600731;301318;902049
2022.04_13-10-2022;Рязанская область;45_75_days;EpiVacCorona;124;62;186;600731;301318;902049
2022.04_13-10-2022;Рязанская область;45_75_days;SputnikLite;1308;863;2171;600731;301318;902049
2022.04_13-10-2022;Рязанская область;45_75_days;SputnikV;3488;1617;5105;600731;301318;902049
2022.04_13-10-2022;Рязанская область;75_90_days;AllVaccines;7211;3163;10374;600731;301318;902049
2022.04_13-10-2022;Рязанская область;75_90_days;CoviVac;90;18;108;600731;301318;902049
2022.04_13-10-2022;Рязанская область;75_90_days;EpiVacCorona;128;50;178;600731;301318;902049
2022.04_13-10-2022;Рязанская область;75_90_days;SputnikLite;3177;1768;4945;600731;301318;902049
2022.04_13-10-2022;Рязанская область;75_90_days;SputnikV;3816;1327;5143;600731;301318;902049
2022.04_13-10-2022;Рязанская область;90_105_days;AllVaccines;9804;4588;14392;600731;301318;902049
2022.04_13-10-2022;Рязанская область;90_105_days;CoviVac;161;57;218;600731;301318;902049
2022.04_13-10-2022;Рязанская область;90_105_days;EpiVacCorona;215;80;295;600731;301318;902049
2022.04_13-10-2022;Рязанская область;90_105_days;SputnikLite;4961;2541;7502;600731;301318;902049
2022.04_13-10-2022;Рязанская область;90_105_days;SputnikV;4467;1910;6377;600731;301318;902049
2022.04_13-10-2022;Самарская область;105_165_days;AllVaccines;226500;128432;354932;1769846;769791;2539637
2022.04_13-10-2022;Самарская область;105_165_days;CoviVac;1797;663;2460;1769846;769791;2539637
2022.04_13-10-2022;Самарская область;105_165_days;EpiVacCorona;3741;3249;6990;1769846;769791;2539637
2022.04_13-10-2022;Самарская область;105_165_days;SputnikLite;77035;55053;132088;1769846;769791;2539637
2022.04_13-10-2022;Самарская область;105_165_days;SputnikV;143927;69467;213394;1769846;769791;2539637
2022.04_13-10-2022;Самарская область;165_195_days;AllVaccines;194119;96690;290809;1769846;769791;2539637
2022.04_13-10-2022;Самарская область;165_195_days;CoviVac;975;336;1311;1769846;769791;2539637
2022.04_13-10-2022;Самарская область;165_195_days;EpiVacCorona;2527;1543;4070;1769846;769791;2539637
2022.04_13-10-2022;Самарская область;165_195_days;SputnikLite;29318;23936;53254;1769846;769791;2539637
2022.04_13-10-2022;Самарская область;165_195_days;SputnikV;161299;70875;232174;1769846;769791;2539637
2022.04_13-10-2022;Самарская область;21_45_days;AllVaccines;15208;16709;31917;1769846;769791;2539637
2022.04_13-10-2022;Самарская область;21_45_days;CoviVac;393;222;615;1769846;769791;2539637
2022.04_13-10-2022;Самарская область;21_45_days;EpiVacCorona;1354;2198;3552;1769846;769791;2539637
2022.04_13-10-2022;Самарская область;21_45_days;SputnikLite;4244;2475;6719;1769846;769791;2539637
2022.04_13-10-2022;Самарская область;21_45_days;SputnikV;9217;11814;21031;1769846;769791;2539637
2022.04_13-10-2022;Самарская область;45_75_days;AllVaccines;27173;18468;45641;1769846;769791;2539637
2022.04_13-10-2022;Самарская область;45_75_days;CoviVac;373;230;603;1769846;769791;2539637
2022.04_13-10-2022;Самарская область;45_75_days;EpiVacCorona;1578;1933;3511;1769846;769791;2539637
2022.04_13-10-2022;Самарская область;45_75_days;SputnikLite;9766;4504;14270;1769846;769791;2539637
2022.04_13-10-2022;Самарская область;45_75_days;SputnikV;15456;11801;27257;1769846;769791;2539637
2022.04_13-10-2022;Самарская область;75_90_days;AllVaccines;23952;12500;36452;1769846;769791;2539637
2022.04_13-10-2022;Самарская область;75_90_days;CoviVac;274;86;360;1769846;769791;2539637
2022.04_13-10-2022;Самарская область;75_90_days;EpiVacCorona;614;695;1309;1769846;769791;2539637
2022.04_13-10-2022;Самарская область;75_90_days;SputnikLite;8323;3233;11556;1769846;769791;2539637
2022.04_13-10-2022;Самарская область;75_90_days;SputnikV;14741;8486;23227;1769846;769791;2539637
2022.04_13-10-2022;Самарская область;90_105_days;AllVaccines;27610;14273;41883;1769846;769791;2539637
2022.04_13-10-2022;Самарская область;90_105_days;CoviVac;404;129;533;1769846;769791;2539637
2022.04_13-10-2022;Самарская область;90_105_days;EpiVacCorona;806;807;1613;1769846;769791;2539637
2022.04_13-10-2022;Самарская область;90_105_days;SputnikLite;12407;4782;17189;1769846;769791;2539637
2022.04_13-10-2022;Самарская область;90_105_days;SputnikV;13993;8555;22548;1769846;769791;2539637
2022.04_13-10-2022;Саратовская область;105_165_days;AllVaccines;186016;86388;272404;1348454;599954;1948408
2022.04_13-10-2022;Саратовская область;105_165_days;CoviVac;1785;452;2237;1348454;599954;1948408
2022.04_13-10-2022;Саратовская область;105_165_days;EpiVacCorona;8707;3998;12705;1348454;599954;1948408
2022.04_13-10-2022;Саратовская область;105_165_days;SputnikLite;60622;37020;97642;1348454;599954;1948408
2022.04_13-10-2022;Саратовская область;105_165_days;SputnikV;114902;44918;159820;1348454;599954;1948408
2022.04_13-10-2022;Саратовская область;165_195_days;AllVaccines;136885;57533;194418;1348454;599954;1948408
2022.04_13-10-2022;Саратовская область;165_195_days;CoviVac;1020;151;1171;1348454;599954;1948408
2022.04_13-10-2022;Саратовская область;165_195_days;EpiVacCorona;5445;1841;7286;1348454;599954;1948408
2022.04_13-10-2022;Саратовская область;165_195_days;SputnikLite;27542;16488;44030;1348454;599954;1948408
2022.04_13-10-2022;Саратовская область;165_195_days;SputnikV;102878;39053;141931;1348454;599954;1948408
2022.04_13-10-2022;Саратовская область;21_45_days;AllVaccines;11077;7972;19049;1348454;599954;1948408
2022.04_13-10-2022;Саратовская область;21_45_days;CoviVac;627;200;827;1348454;599954;1948408
2022.04_13-10-2022;Саратовская область;21_45_days;EpiVacCorona;1484;767;2251;1348454;599954;1948408
2022.04_13-10-2022;Саратовская область;21_45_days;SputnikLite;2356;1554;3910;1348454;599954;1948408
2022.04_13-10-2022;Саратовская область;21_45_days;SputnikV;6610;5451;12061;1348454;599954;1948408
2022.04_13-10-2022;Саратовская область;45_75_days;AllVaccines;15683;10080;25763;1348454;599954;1948408
2022.04_13-10-2022;Саратовская область;45_75_days;CoviVac;469;229;698;1348454;599954;1948408
2022.04_13-10-2022;Саратовская область;45_75_days;EpiVacCorona;1864;1641;3505;1348454;599954;1948408
2022.04_13-10-2022;Саратовская область;45_75_days;SputnikLite;5061;2715;7776;1348454;599954;1948408
2022.04_13-10-2022;Саратовская область;45_75_days;SputnikV;8289;5495;13784;1348454;599954;1948408
2022.04_13-10-2022;Саратовская область;75_90_days;AllVaccines;16522;9061;25583;1348454;599954;1948408
2022.04_13-10-2022;Саратовская область;75_90_days;CoviVac;208;76;284;1348454;599954;1948408
2022.04_13-10-2022;Саратовская область;75_90_days;EpiVacCorona;1237;771;2008;1348454;599954;1948408
2022.04_13-10-2022;Саратовская область;75_90_days;SputnikLite;7055;3645;10700;1348454;599954;1948408
2022.04_13-10-2022;Саратовская область;75_90_days;SputnikV;8022;4569;12591;1348454;599954;1948408
2022.04_13-10-2022;Саратовская область;90_105_days;AllVaccines;25862;13703;39565;1348454;599954;1948408
2022.04_13-10-2022;Саратовская область;90_105_days;CoviVac;521;144;665;1348454;599954;1948408
2022.04_13-10-2022;Саратовская область;90_105_days;EpiVacCorona;1675;1294;2969;1348454;599954;1948408
2022.04_13-10-2022;Саратовская область;90_105_days;SputnikLite;13966;5994;19960;1348454;599954;1948408
2022.04_13-10-2022;Саратовская область;90_105_days;SputnikV;9700;6271;15971;1348454;599954;1948408
2022.04_13-10-2022;Сахалинская область;105_165_days;AllVaccines;38775;14284;53059;276677;101794;378471
2022.04_13-10-2022;Сахалинская область;105_165_days;CoviVac;664;128;792;276677;101794;378471
2022.04_13-10-2022;Сахалинская область;105_165_days;EpiVacCorona;2437;571;3008;276677;101794;378471
2022.04_13-10-2022;Сахалинская область;105_165_days;SputnikLite;20950;10045;30995;276677;101794;378471
2022.04_13-10-2022;Сахалинская область;105_165_days;SputnikV;14724;3540;18264;276677;101794;378471
2022.04_13-10-2022;Сахалинская область;165_195_days;AllVaccines;20218;11687;31905;276677;101794;378471
2022.04_13-10-2022;Сахалинская область;165_195_days;CoviVac;60;8;68;276677;101794;378471
2022.04_13-10-2022;Сахалинская область;165_195_days;EpiVacCorona;1909;647;2556;276677;101794;378471
2022.04_13-10-2022;Сахалинская область;165_195_days;SputnikLite;10388;8698;19086;276677;101794;378471
2022.04_13-10-2022;Сахалинская область;165_195_days;SputnikV;7861;2334;10195;276677;101794;378471
2022.04_13-10-2022;Сахалинская область;21_45_days;AllVaccines;3352;1162;4514;276677;101794;378471
2022.04_13-10-2022;Сахалинская область;21_45_days;CoviVac;149;11;160;276677;101794;378471
2022.04_13-10-2022;Сахалинская область;21_45_days;EpiVacCorona;148;13;161;276677;101794;378471
2022.04_13-10-2022;Сахалинская область;21_45_days;SputnikLite;1907;893;2800;276677;101794;378471
2022.04_13-10-2022;Сахалинская область;21_45_days;SputnikV;1148;245;1393;276677;101794;378471
2022.04_13-10-2022;Сахалинская область;45_75_days;AllVaccines;6684;1960;8644;276677;101794;378471
2022.04_13-10-2022;Сахалинская область;45_75_days;CoviVac;246;26;272;276677;101794;378471
2022.04_13-10-2022;Сахалинская область;45_75_days;EpiVacCorona;327;71;398;276677;101794;378471
2022.04_13-10-2022;Сахалинская область;45_75_days;SputnikLite;3305;1125;4430;276677;101794;378471
2022.04_13-10-2022;Сахалинская область;45_75_days;SputnikV;2806;738;3544;276677;101794;378471
2022.04_13-10-2022;Сахалинская область;75_90_days;AllVaccines;3974;1350;5324;276677;101794;378471
2022.04_13-10-2022;Сахалинская область;75_90_days;CoviVac;82;18;100;276677;101794;378471
2022.04_13-10-2022;Сахалинская область;75_90_days;EpiVacCorona;267;45;312;276677;101794;378471
2022.04_13-10-2022;Сахалинская область;75_90_days;SputnikLite;2098;741;2839;276677;101794;378471
2022.04_13-10-2022;Сахалинская область;75_90_days;SputnikV;1527;546;2073;276677;101794;378471
2022.04_13-10-2022;Сахалинская область;90_105_days;AllVaccines;6100;1895;7995;276677;101794;378471
2022.04_13-10-2022;Сахалинская область;90_105_days;CoviVac;101;25;126;276677;101794;378471
2022.04_13-10-2022;Сахалинская область;90_105_days;EpiVacCorona;276;38;314;276677;101794;378471
2022.04_13-10-2022;Сахалинская область;90_105_days;SputnikLite;4576;1511;6087;276677;101794;378471
2022.04_13-10-2022;Сахалинская область;90_105_days;SputnikV;1147;321;1468;276677;101794;378471
2022.04_13-10-2022;Свердловская область;105_165_days;AllVaccines;383881;181010;564891;2364046;987486;3351532
2022.04_13-10-2022;Свердловская область;105_165_days;CoviVac;1233;328;1561;2364046;987486;3351532
2022.04_13-10-2022;Свердловская область;105_165_days;EpiVacCorona;8896;5191;14087;2364046;987486;3351532
2022.04_13-10-2022;Свердловская область;105_165_days;SputnikLite;123347;75414;198761;2364046;987486;3351532
2022.04_13-10-2022;Свердловская область;105_165_days;SputnikV;250405;100077;350482;2364046;987486;3351532
2022.04_13-10-2022;Свердловская область;165_195_days;AllVaccines;314953;107483;422436;2364046;987486;3351532
2022.04_13-10-2022;Свердловская область;165_195_days;CoviVac;3597;669;4266;2364046;987486;3351532
2022.04_13-10-2022;Свердловская область;165_195_days;EpiVacCorona;7965;2900;10865;2364046;987486;3351532
2022.04_13-10-2022;Свердловская область;165_195_days;SputnikLite;56925;32080;89005;2364046;987486;3351532
2022.04_13-10-2022;Свердловская область;165_195_days;SputnikV;246466;71834;318300;2364046;987486;3351532
2022.04_13-10-2022;Свердловская область;21_45_days;AllVaccines;22541;14936;37477;2364046;987486;3351532
2022.04_13-10-2022;Свердловская область;21_45_days;CoviVac;250;65;315;2364046;987486;3351532
2022.04_13-10-2022;Свердловская область;21_45_days;EpiVacCorona;1280;702;1982;2364046;987486;3351532
2022.04_13-10-2022;Свердловская область;21_45_days;SputnikLite;3594;2000;5594;2364046;987486;3351532
2022.04_13-10-2022;Свердловская область;21_45_days;SputnikV;17417;12169;29586;2364046;987486;3351532
2022.04_13-10-2022;Свердловская область;45_75_days;AllVaccines;37242;17919;55161;2364046;987486;3351532
2022.04_13-10-2022;Свердловская область;45_75_days;CoviVac;211;49;260;2364046;987486;3351532
2022.04_13-10-2022;Свердловская область;45_75_days;EpiVacCorona;1938;995;2933;2364046;987486;3351532
2022.04_13-10-2022;Свердловская область;45_75_days;SputnikLite;8456;3820;12276;2364046;987486;3351532
2022.04_13-10-2022;Свердловская область;45_75_days;SputnikV;26637;13055;39692;2364046;987486;3351532
2022.04_13-10-2022;Свердловская область;75_90_days;AllVaccines;33919;15430;49349;2364046;987486;3351532
2022.04_13-10-2022;Свердловская область;75_90_days;CoviVac;192;55;247;2364046;987486;3351532
2022.04_13-10-2022;Свердловская область;75_90_days;EpiVacCorona;2488;1136;3624;2364046;987486;3351532
2022.04_13-10-2022;Свердловская область;75_90_days;SputnikLite;11795;4901;16696;2364046;987486;3351532
2022.04_13-10-2022;Свердловская область;75_90_days;SputnikV;19444;9338;28782;2364046;987486;3351532
2022.04_13-10-2022;Свердловская область;90_105_days;AllVaccines;47433;22946;70379;2364046;987486;3351532
2022.04_13-10-2022;Свердловская область;90_105_days;CoviVac;515;131;646;2364046;987486;3351532
2022.04_13-10-2022;Свердловская область;90_105_days;EpiVacCorona;3765;1890;5655;2364046;987486;3351532
2022.04_13-10-2022;Свердловская область;90_105_days;SputnikLite;24553;10657;35210;2364046;987486;3351532
2022.04_13-10-2022;Свердловская область;90_105_days;SputnikV;18600;10268;28868;2364046;987486;3351532
2022.04_13-10-2022;Смоленская область;105_165_days;AllVaccines;50366;32354;82720;521379;238479;759858
2022.04_13-10-2022;Смоленская область;105_165_days;CoviVac;501;124;625;521379;238479;759858
2022.04_13-10-2022;Смоленская область;105_165_days;EpiVacCorona;2512;1459;3971;521379;238479;759858
2022.04_13-10-2022;Смоленская область;105_165_days;SputnikLite;20690;16504;37194;521379;238479;759858
2022.04_13-10-2022;Смоленская область;105_165_days;SputnikV;26663;14267;40930;521379;238479;759858
2022.04_13-10-2022;Смоленская область;165_195_days;AllVaccines;35296;19888;55184;521379;238479;759858
2022.04_13-10-2022;Смоленская область;165_195_days;CoviVac;147;33;180;521379;238479;759858
2022.04_13-10-2022;Смоленская область;165_195_days;EpiVacCorona;332;149;481;521379;238479;759858
2022.04_13-10-2022;Смоленская область;165_195_days;SputnikLite;12593;11205;23798;521379;238479;759858
2022.04_13-10-2022;Смоленская область;165_195_days;SputnikV;22224;8501;30725;521379;238479;759858
2022.04_13-10-2022;Смоленская область;21_45_days;AllVaccines;4204;2567;6771;521379;238479;759858
2022.04_13-10-2022;Смоленская область;21_45_days;CoviVac;230;70;300;521379;238479;759858
2022.04_13-10-2022;Смоленская область;21_45_days;EpiVacCorona;199;132;331;521379;238479;759858
2022.04_13-10-2022;Смоленская область;21_45_days;SputnikLite;1719;1107;2826;521379;238479;759858
2022.04_13-10-2022;Смоленская область;21_45_days;SputnikV;2056;1258;3314;521379;238479;759858
2022.04_13-10-2022;Смоленская область;45_75_days;AllVaccines;6851;3488;10339;521379;238479;759858
2022.04_13-10-2022;Смоленская область;45_75_days;CoviVac;306;100;406;521379;238479;759858
2022.04_13-10-2022;Смоленская область;45_75_days;EpiVacCorona;562;281;843;521379;238479;759858
2022.04_13-10-2022;Смоленская область;45_75_days;SputnikLite;1132;633;1765;521379;238479;759858
2022.04_13-10-2022;Смоленская область;45_75_days;SputnikV;4851;2474;7325;521379;238479;759858
2022.04_13-10-2022;Смоленская область;75_90_days;AllVaccines;6512;3552;10064;521379;238479;759858
2022.04_13-10-2022;Смоленская область;75_90_days;CoviVac;119;44;163;521379;238479;759858
2022.04_13-10-2022;Смоленская область;75_90_days;EpiVacCorona;434;217;651;521379;238479;759858
2022.04_13-10-2022;Смоленская область;75_90_days;SputnikLite;2054;1048;3102;521379;238479;759858
2022.04_13-10-2022;Смоленская область;75_90_days;SputnikV;3905;2243;6148;521379;238479;759858
2022.04_13-10-2022;Смоленская область;90_105_days;AllVaccines;7623;4023;11646;521379;238479;759858
2022.04_13-10-2022;Смоленская область;90_105_days;CoviVac;154;49;203;521379;238479;759858
2022.04_13-10-2022;Смоленская область;90_105_days;EpiVacCorona;674;466;1140;521379;238479;759858
2022.04_13-10-2022;Смоленская область;90_105_days;SputnikLite;3540;1565;5105;521379;238479;759858
2022.04_13-10-2022;Смоленская область;90_105_days;SputnikV;3255;1943;5198;521379;238479;759858
2022.04_13-10-2022;Ставропольский край;105_165_days;AllVaccines;203667;78169;281836;1590669;616030;2206699
2022.04_13-10-2022;Ставропольский край;105_165_days;CoviVac;1313;446;1759;1590669;616030;2206699
2022.04_13-10-2022;Ставропольский край;105_165_days;EpiVacCorona;7329;3221;10550;1590669;616030;2206699
2022.04_13-10-2022;Ставропольский край;105_165_days;SputnikLite;67567;36372;103939;1590669;616030;2206699
2022.04_13-10-2022;Ставропольский край;105_165_days;SputnikV;127458;38130;165588;1590669;616030;2206699
2022.04_13-10-2022;Ставропольский край;165_195_days;AllVaccines;134266;50958;185224;1590669;616030;2206699
2022.04_13-10-2022;Ставропольский край;165_195_days;CoviVac;1535;424;1959;1590669;616030;2206699
2022.04_13-10-2022;Ставропольский край;165_195_days;EpiVacCorona;3362;1294;4656;1590669;616030;2206699
2022.04_13-10-2022;Ставропольский край;165_195_days;SputnikLite;32726;18701;51427;1590669;616030;2206699
2022.04_13-10-2022;Ставропольский край;165_195_days;SputnikV;96643;30539;127182;1590669;616030;2206699
2022.04_13-10-2022;Ставропольский край;21_45_days;AllVaccines;10561;5676;16237;1590669;616030;2206699
2022.04_13-10-2022;Ставропольский край;21_45_days;CoviVac;368;126;494;1590669;616030;2206699
2022.04_13-10-2022;Ставропольский край;21_45_days;EpiVacCorona;1317;605;1922;1590669;616030;2206699
2022.04_13-10-2022;Ставропольский край;21_45_days;SputnikLite;986;641;1627;1590669;616030;2206699
2022.04_13-10-2022;Ставропольский край;21_45_days;SputnikV;7890;4304;12194;1590669;616030;2206699
2022.04_13-10-2022;Ставропольский край;45_75_days;AllVaccines;16228;12500;28728;1590669;616030;2206699
2022.04_13-10-2022;Ставропольский край;45_75_days;CoviVac;694;494;1188;1590669;616030;2206699
2022.04_13-10-2022;Ставропольский край;45_75_days;EpiVacCorona;1344;696;2040;1590669;616030;2206699
2022.04_13-10-2022;Ставропольский край;45_75_days;SputnikLite;2316;1428;3744;1590669;616030;2206699
2022.04_13-10-2022;Ставропольский край;45_75_days;SputnikV;11874;9882;21756;1590669;616030;2206699
2022.04_13-10-2022;Ставропольский край;75_90_days;AllVaccines;15237;8639;23876;1590669;616030;2206699
2022.04_13-10-2022;Ставропольский край;75_90_days;CoviVac;216;170;386;1590669;616030;2206699
2022.04_13-10-2022;Ставропольский край;75_90_days;EpiVacCorona;2296;1388;3684;1590669;616030;2206699
2022.04_13-10-2022;Ставропольский край;75_90_days;SputnikLite;6049;2374;8423;1590669;616030;2206699
2022.04_13-10-2022;Ставропольский край;75_90_days;SputnikV;6676;4707;11383;1590669;616030;2206699
2022.04_13-10-2022;Ставропольский край;90_105_days;AllVaccines;21453;10580;32033;1590669;616030;2206699
2022.04_13-10-2022;Ставропольский край;90_105_days;CoviVac;334;307;641;1590669;616030;2206699
2022.04_13-10-2022;Ставропольский край;90_105_days;EpiVacCorona;2858;2282;5140;1590669;616030;2206699
2022.04_13-10-2022;Ставропольский край;90_105_days;SputnikLite;10907;4434;15341;1590669;616030;2206699
2022.04_13-10-2022;Ставропольский край;90_105_days;SputnikV;7354;3557;10911;1590669;616030;2206699
2022.04_13-10-2022;Тамбовская область;105_165_days;AllVaccines;60192;37559;97751;545785;279936;825721
2022.04_13-10-2022;Тамбовская область;105_165_days;CoviVac;1315;241;1556;545785;279936;825721
2022.04_13-10-2022;Тамбовская область;105_165_days;EpiVacCorona;2694;1896;4590;545785;279936;825721
2022.04_13-10-2022;Тамбовская область;105_165_days;SputnikLite;34864;16700;51564;545785;279936;825721
2022.04_13-10-2022;Тамбовская область;105_165_days;SputnikV;21319;18722;40041;545785;279936;825721
2022.04_13-10-2022;Тамбовская область;165_195_days;AllVaccines;41148;29720;70868;545785;279936;825721
2022.04_13-10-2022;Тамбовская область;165_195_days;CoviVac;1048;231;1279;545785;279936;825721
2022.04_13-10-2022;Тамбовская область;165_195_days;EpiVacCorona;633;358;991;545785;279936;825721
2022.04_13-10-2022;Тамбовская область;165_195_days;SputnikLite;22834;13935;36769;545785;279936;825721
2022.04_13-10-2022;Тамбовская область;165_195_days;SputnikV;16633;15196;31829;545785;279936;825721
2022.04_13-10-2022;Тамбовская область;21_45_days;AllVaccines;6975;6371;13346;545785;279936;825721
2022.04_13-10-2022;Тамбовская область;21_45_days;CoviVac;1103;251;1354;545785;279936;825721
2022.04_13-10-2022;Тамбовская область;21_45_days;EpiVacCorona;1100;1006;2106;545785;279936;825721
2022.04_13-10-2022;Тамбовская область;21_45_days;SputnikLite;128;74;202;545785;279936;825721
2022.04_13-10-2022;Тамбовская область;21_45_days;SputnikV;4644;5040;9684;545785;279936;825721
2022.04_13-10-2022;Тамбовская область;45_75_days;AllVaccines;13259;8525;21784;545785;279936;825721
2022.04_13-10-2022;Тамбовская область;45_75_days;CoviVac;529;57;586;545785;279936;825721
2022.04_13-10-2022;Тамбовская область;45_75_days;EpiVacCorona;1015;832;1847;545785;279936;825721
2022.04_13-10-2022;Тамбовская область;45_75_days;SputnikLite;1185;812;1997;545785;279936;825721
2022.04_13-10-2022;Тамбовская область;45_75_days;SputnikV;10530;6824;17354;545785;279936;825721
2022.04_13-10-2022;Тамбовская область;75_90_days;AllVaccines;9567;5314;14881;545785;279936;825721
2022.04_13-10-2022;Тамбовская область;75_90_days;CoviVac;223;32;255;545785;279936;825721
2022.04_13-10-2022;Тамбовская область;75_90_days;EpiVacCorona;1039;683;1722;545785;279936;825721
2022.04_13-10-2022;Тамбовская область;75_90_days;SputnikLite;4120;1421;5541;545785;279936;825721
2022.04_13-10-2022;Тамбовская область;75_90_days;SputnikV;4185;3178;7363;545785;279936;825721
2022.04_13-10-2022;Тамбовская область;90_105_days;AllVaccines;15612;10157;25769;545785;279936;825721
2022.04_13-10-2022;Тамбовская область;90_105_days;CoviVac;286;48;334;545785;279936;825721
2022.04_13-10-2022;Тамбовская область;90_105_days;EpiVacCorona;2614;2162;4776;545785;279936;825721
2022.04_13-10-2022;Тамбовская область;90_105_days;SputnikLite;6852;1930;8782;545785;279936;825721
2022.04_13-10-2022;Тамбовская область;90_105_days;SputnikV;5860;6017;11877;545785;279936;825721
2022.04_13-10-2022;Тверская область;105_165_days;AllVaccines;62616;39659;102275;681519;330234;1011753
2022.04_13-10-2022;Тверская область;105_165_days;CoviVac;1592;411;2003;681519;330234;1011753
2022.04_13-10-2022;Тверская область;105_165_days;EpiVacCorona;3895;2605;6500;681519;330234;1011753
2022.04_13-10-2022;Тверская область;105_165_days;SputnikLite;27979;20417;48396;681519;330234;1011753
2022.04_13-10-2022;Тверская область;105_165_days;SputnikV;29150;16226;45376;681519;330234;1011753
2022.04_13-10-2022;Тверская область;165_195_days;AllVaccines;51971;32100;84071;681519;330234;1011753
2022.04_13-10-2022;Тверская область;165_195_days;CoviVac;845;220;1065;681519;330234;1011753
2022.04_13-10-2022;Тверская область;165_195_days;EpiVacCorona;2611;1140;3751;681519;330234;1011753
2022.04_13-10-2022;Тверская область;165_195_days;SputnikLite;17275;16509;33784;681519;330234;1011753
2022.04_13-10-2022;Тверская область;165_195_days;SputnikV;31240;14231;45471;681519;330234;1011753
2022.04_13-10-2022;Тверская область;21_45_days;AllVaccines;3382;3616;6998;681519;330234;1011753
2022.04_13-10-2022;Тверская область;21_45_days;CoviVac;230;44;274;681519;330234;1011753
2022.04_13-10-2022;Тверская область;21_45_days;EpiVacCorona;152;144;296;681519;330234;1011753
2022.04_13-10-2022;Тверская область;21_45_days;SputnikLite;1082;1511;2593;681519;330234;1011753
2022.04_13-10-2022;Тверская область;21_45_days;SputnikV;1918;1917;3835;681519;330234;1011753
2022.04_13-10-2022;Тверская область;45_75_days;AllVaccines;7500;5693;13193;681519;330234;1011753
2022.04_13-10-2022;Тверская область;45_75_days;CoviVac;245;71;316;681519;330234;1011753
2022.04_13-10-2022;Тверская область;45_75_days;EpiVacCorona;296;196;492;681519;330234;1011753
2022.04_13-10-2022;Тверская область;45_75_days;SputnikLite;3616;3199;6815;681519;330234;1011753
2022.04_13-10-2022;Тверская область;45_75_days;SputnikV;3343;2227;5570;681519;330234;1011753
2022.04_13-10-2022;Тверская область;75_90_days;AllVaccines;8872;5048;13920;681519;330234;1011753
2022.04_13-10-2022;Тверская область;75_90_days;CoviVac;225;48;273;681519;330234;1011753
2022.04_13-10-2022;Тверская область;75_90_days;EpiVacCorona;414;259;673;681519;330234;1011753
2022.04_13-10-2022;Тверская область;75_90_days;SputnikLite;4340;2470;6810;681519;330234;1011753
2022.04_13-10-2022;Тверская область;75_90_days;SputnikV;3893;2271;6164;681519;330234;1011753
2022.04_13-10-2022;Тверская область;90_105_days;AllVaccines;12285;7017;19302;681519;330234;1011753
2022.04_13-10-2022;Тверская область;90_105_days;CoviVac;313;92;405;681519;330234;1011753
2022.04_13-10-2022;Тверская область;90_105_days;EpiVacCorona;523;493;1016;681519;330234;1011753
2022.04_13-10-2022;Тверская область;90_105_days;SputnikLite;7800;4054;11854;681519;330234;1011753
2022.04_13-10-2022;Тверская область;90_105_days;SputnikV;3649;2378;6027;681519;330234;1011753
2022.04_13-10-2022;Томская область;105_165_days;AllVaccines;97477;36564;134041;621613;222482;844095
2022.04_13-10-2022;Томская область;105_165_days;CoviVac;1835;265;2100;621613;222482;844095
2022.04_13-10-2022;Томская область;105_165_days;EpiVacCorona;2261;900;3161;621613;222482;844095
2022.04_13-10-2022;Томская область;105_165_days;SputnikLite;32939;20295;53234;621613;222482;844095
2022.04_13-10-2022;Томская область;105_165_days;SputnikV;60442;15104;75546;621613;222482;844095
2022.04_13-10-2022;Томская область;165_195_days;AllVaccines;66726;22686;89412;621613;222482;844095
2022.04_13-10-2022;Томская область;165_195_days;CoviVac;1783;229;2012;621613;222482;844095
2022.04_13-10-2022;Томская область;165_195_days;EpiVacCorona;948;259;1207;621613;222482;844095
2022.04_13-10-2022;Томская область;165_195_days;SputnikLite;23085;13251;36336;621613;222482;844095
2022.04_13-10-2022;Томская область;165_195_days;SputnikV;40910;8947;49857;621613;222482;844095
2022.04_13-10-2022;Томская область;21_45_days;AllVaccines;3520;2376;5896;621613;222482;844095
2022.04_13-10-2022;Томская область;21_45_days;CoviVac;147;20;167;621613;222482;844095
2022.04_13-10-2022;Томская область;21_45_days;EpiVacCorona;250;104;354;621613;222482;844095
2022.04_13-10-2022;Томская область;21_45_days;SputnikLite;818;615;1433;621613;222482;844095
2022.04_13-10-2022;Томская область;21_45_days;SputnikV;2305;1637;3942;621613;222482;844095
2022.04_13-10-2022;Томская область;45_75_days;AllVaccines;8055;3922;11977;621613;222482;844095
2022.04_13-10-2022;Томская область;45_75_days;CoviVac;207;11;218;621613;222482;844095
2022.04_13-10-2022;Томская область;45_75_days;EpiVacCorona;428;160;588;621613;222482;844095
2022.04_13-10-2022;Томская область;45_75_days;SputnikLite;3102;1671;4773;621613;222482;844095
2022.04_13-10-2022;Томская область;45_75_days;SputnikV;4318;2080;6398;621613;222482;844095
2022.04_13-10-2022;Томская область;75_90_days;AllVaccines;9428;4431;13859;621613;222482;844095
2022.04_13-10-2022;Томская область;75_90_days;CoviVac;123;5;128;621613;222482;844095
2022.04_13-10-2022;Томская область;75_90_days;EpiVacCorona;664;218;882;621613;222482;844095
2022.04_13-10-2022;Томская область;75_90_days;SputnikLite;4025;1718;5743;621613;222482;844095
2022.04_13-10-2022;Томская область;75_90_days;SputnikV;4616;2490;7106;621613;222482;844095
2022.04_13-10-2022;Томская область;90_105_days;AllVaccines;14009;6485;20494;621613;222482;844095
2022.04_13-10-2022;Томская область;90_105_days;CoviVac;178;31;209;621613;222482;844095
2022.04_13-10-2022;Томская область;90_105_days;EpiVacCorona;745;361;1106;621613;222482;844095
2022.04_13-10-2022;Томская область;90_105_days;SputnikLite;8838;3944;12782;621613;222482;844095
2022.04_13-10-2022;Томская область;90_105_days;SputnikV;4248;2149;6397;621613;222482;844095
2022.04_13-10-2022;Тульская область;105_165_days;AllVaccines;94156;51930;146086;804510;401385;1205895
2022.04_13-10-2022;Тульская область;105_165_days;CoviVac;837;331;1168;804510;401385;1205895
2022.04_13-10-2022;Тульская область;105_165_days;EpiVacCorona;3320;2533;5853;804510;401385;1205895
2022.04_13-10-2022;Тульская область;105_165_days;SputnikLite;42552;24879;67431;804510;401385;1205895
2022.04_13-10-2022;Тульская область;105_165_days;SputnikV;47447;24187;71634;804510;401385;1205895
2022.04_13-10-2022;Тульская область;165_195_days;AllVaccines;57942;37917;95859;804510;401385;1205895
2022.04_13-10-2022;Тульская область;165_195_days;CoviVac;1224;440;1664;804510;401385;1205895
2022.04_13-10-2022;Тульская область;165_195_days;EpiVacCorona;2790;2758;5548;804510;401385;1205895
2022.04_13-10-2022;Тульская область;165_195_days;SputnikLite;28917;17991;46908;804510;401385;1205895
2022.04_13-10-2022;Тульская область;165_195_days;SputnikV;25011;16728;41739;804510;401385;1205895
2022.04_13-10-2022;Тульская область;21_45_days;AllVaccines;6083;3482;9565;804510;401385;1205895
2022.04_13-10-2022;Тульская область;21_45_days;CoviVac;98;40;138;804510;401385;1205895
2022.04_13-10-2022;Тульская область;21_45_days;EpiVacCorona;666;362;1028;804510;401385;1205895
2022.04_13-10-2022;Тульская область;21_45_days;SputnikLite;181;99;280;804510;401385;1205895
2022.04_13-10-2022;Тульская область;21_45_days;SputnikV;5138;2981;8119;804510;401385;1205895
2022.04_13-10-2022;Тульская область;45_75_days;AllVaccines;14686;6304;20990;804510;401385;1205895
2022.04_13-10-2022;Тульская область;45_75_days;CoviVac;214;27;241;804510;401385;1205895
2022.04_13-10-2022;Тульская область;45_75_days;EpiVacCorona;1173;566;1739;804510;401385;1205895
2022.04_13-10-2022;Тульская область;45_75_days;SputnikLite;1362;610;1972;804510;401385;1205895
2022.04_13-10-2022;Тульская область;45_75_days;SputnikV;11937;5101;17038;804510;401385;1205895
2022.04_13-10-2022;Тульская область;75_90_days;AllVaccines;13313;5670;18983;804510;401385;1205895
2022.04_13-10-2022;Тульская область;75_90_days;CoviVac;165;30;195;804510;401385;1205895
2022.04_13-10-2022;Тульская область;75_90_days;EpiVacCorona;968;473;1441;804510;401385;1205895
2022.04_13-10-2022;Тульская область;75_90_days;SputnikLite;4456;1497;5953;804510;401385;1205895
2022.04_13-10-2022;Тульская область;75_90_days;SputnikV;7724;3670;11394;804510;401385;1205895
2022.04_13-10-2022;Тульская область;90_105_days;AllVaccines;17403;7870;25273;804510;401385;1205895
2022.04_13-10-2022;Тульская область;90_105_days;CoviVac;292;111;403;804510;401385;1205895
2022.04_13-10-2022;Тульская область;90_105_days;EpiVacCorona;880;641;1521;804510;401385;1205895
2022.04_13-10-2022;Тульская область;90_105_days;SputnikLite;10611;3823;14434;804510;401385;1205895
2022.04_13-10-2022;Тульская область;90_105_days;SputnikV;5620;3295;8915;804510;401385;1205895
2022.04_13-10-2022;Тюменская область;105_165_days;AllVaccines;165894;67418;233312;870789;301209;1171998
2022.04_13-10-2022;Тюменская область;105_165_days;CoviVac;601;143;744;870789;301209;1171998
2022.04_13-10-2022;Тюменская область;105_165_days;EpiVacCorona;619;267;886;870789;301209;1171998
2022.04_13-10-2022;Тюменская область;105_165_days;SputnikLite;73231;40662;113893;870789;301209;1171998
2022.04_13-10-2022;Тюменская область;105_165_days;SputnikV;91443;26346;117789;870789;301209;1171998
2022.04_13-10-2022;Тюменская область;165_195_days;AllVaccines;87425;31963;119388;870789;301209;1171998
2022.04_13-10-2022;Тюменская область;165_195_days;CoviVac;1167;201;1368;870789;301209;1171998
2022.04_13-10-2022;Тюменская область;165_195_days;EpiVacCorona;1058;267;1325;870789;301209;1171998
2022.04_13-10-2022;Тюменская область;165_195_days;SputnikLite;28197;17244;45441;870789;301209;1171998
2022.04_13-10-2022;Тюменская область;165_195_days;SputnikV;57003;14251;71254;870789;301209;1171998
2022.04_13-10-2022;Тюменская область;21_45_days;AllVaccines;5965;2815;8780;870789;301209;1171998
2022.04_13-10-2022;Тюменская область;21_45_days;CoviVac;290;82;372;870789;301209;1171998
2022.04_13-10-2022;Тюменская область;21_45_days;EpiVacCorona;522;162;684;870789;301209;1171998
2022.04_13-10-2022;Тюменская область;21_45_days;SputnikLite;1147;368;1515;870789;301209;1171998
2022.04_13-10-2022;Тюменская область;21_45_days;SputnikV;4006;2203;6209;870789;301209;1171998
2022.04_13-10-2022;Тюменская область;45_75_days;AllVaccines;12029;4945;16974;870789;301209;1171998
2022.04_13-10-2022;Тюменская область;45_75_days;CoviVac;130;44;174;870789;301209;1171998
2022.04_13-10-2022;Тюменская область;45_75_days;EpiVacCorona;483;210;693;870789;301209;1171998
2022.04_13-10-2022;Тюменская область;45_75_days;SputnikLite;3916;1211;5127;870789;301209;1171998
2022.04_13-10-2022;Тюменская область;45_75_days;SputnikV;7500;3480;10980;870789;301209;1171998
2022.04_13-10-2022;Тюменская область;75_90_days;AllVaccines;15142;5775;20917;870789;301209;1171998
2022.04_13-10-2022;Тюменская область;75_90_days;CoviVac;79;21;100;870789;301209;1171998
2022.04_13-10-2022;Тюменская область;75_90_days;EpiVacCorona;525;285;810;870789;301209;1171998
2022.04_13-10-2022;Тюменская область;75_90_days;SputnikLite;7014;2383;9397;870789;301209;1171998
2022.04_13-10-2022;Тюменская область;75_90_days;SputnikV;7524;3086;10610;870789;301209;1171998
2022.04_13-10-2022;Тюменская область;90_105_days;AllVaccines;22079;8922;31001;870789;301209;1171998
2022.04_13-10-2022;Тюменская область;90_105_days;CoviVac;183;46;229;870789;301209;1171998
2022.04_13-10-2022;Тюменская область;90_105_days;EpiVacCorona;234;99;333;870789;301209;1171998
2022.04_13-10-2022;Тюменская область;90_105_days;SputnikLite;15981;6463;22444;870789;301209;1171998
2022.04_13-10-2022;Тюменская область;90_105_days;SputnikV;5681;2314;7995;870789;301209;1171998
2022.04_13-10-2022;Удмуртская Республика;105_165_days;AllVaccines;95985;50464;146449;818861;336450;1155311
2022.04_13-10-2022;Удмуртская Республика;105_165_days;CoviVac;2401;387;2788;818861;336450;1155311
2022.04_13-10-2022;Удмуртская Республика;105_165_days;EpiVacCorona;3898;2476;6374;818861;336450;1155311
2022.04_13-10-2022;Удмуртская Республика;105_165_days;SputnikLite;28564;24750;53314;818861;336450;1155311
2022.04_13-10-2022;Удмуртская Республика;105_165_days;SputnikV;61122;22851;83973;818861;336450;1155311
2022.04_13-10-2022;Удмуртская Республика;165_195_days;AllVaccines;100626;37186;137812;818861;336450;1155311
2022.04_13-10-2022;Удмуртская Республика;165_195_days;CoviVac;1469;210;1679;818861;336450;1155311
2022.04_13-10-2022;Удмуртская Республика;165_195_days;EpiVacCorona;5596;2617;8213;818861;336450;1155311
2022.04_13-10-2022;Удмуртская Республика;165_195_days;SputnikLite;13294;11470;24764;818861;336450;1155311
2022.04_13-10-2022;Удмуртская Республика;165_195_days;SputnikV;80267;22889;103156;818861;336450;1155311
2022.04_13-10-2022;Удмуртская Республика;21_45_days;AllVaccines;5260;3605;8865;818861;336450;1155311
2022.04_13-10-2022;Удмуртская Республика;21_45_days;CoviVac;611;172;783;818861;336450;1155311
2022.04_13-10-2022;Удмуртская Республика;21_45_days;EpiVacCorona;543;491;1034;818861;336450;1155311
2022.04_13-10-2022;Удмуртская Республика;21_45_days;SputnikLite;537;334;871;818861;336450;1155311
2022.04_13-10-2022;Удмуртская Республика;21_45_days;SputnikV;3569;2608;6177;818861;336450;1155311
2022.04_13-10-2022;Удмуртская Республика;45_75_days;AllVaccines;10712;6047;16759;818861;336450;1155311
2022.04_13-10-2022;Удмуртская Республика;45_75_days;CoviVac;368;71;439;818861;336450;1155311
2022.04_13-10-2022;Удмуртская Республика;45_75_days;EpiVacCorona;759;520;1279;818861;336450;1155311
2022.04_13-10-2022;Удмуртская Республика;45_75_days;SputnikLite;2337;1471;3808;818861;336450;1155311
2022.04_13-10-2022;Удмуртская Республика;45_75_days;SputnikV;7248;3985;11233;818861;336450;1155311
2022.04_13-10-2022;Удмуртская Республика;75_90_days;AllVaccines;11439;6244;17683;818861;336450;1155311
2022.04_13-10-2022;Удмуртская Республика;75_90_days;CoviVac;130;28;158;818861;336450;1155311
2022.04_13-10-2022;Удмуртская Республика;75_90_days;EpiVacCorona;686;458;1144;818861;336450;1155311
2022.04_13-10-2022;Удмуртская Республика;75_90_days;SputnikLite;4312;2233;6545;818861;336450;1155311
2022.04_13-10-2022;Удмуртская Республика;75_90_days;SputnikV;6311;3525;9836;818861;336450;1155311
2022.04_13-10-2022;Удмуртская Республика;90_105_days;AllVaccines;13508;8543;22051;818861;336450;1155311
2022.04_13-10-2022;Удмуртская Республика;90_105_days;CoviVac;202;41;243;818861;336450;1155311
2022.04_13-10-2022;Удмуртская Республика;90_105_days;EpiVacCorona;641;664;1305;818861;336450;1155311
2022.04_13-10-2022;Удмуртская Республика;90_105_days;SputnikLite;7245;4228;11473;818861;336450;1155311
2022.04_13-10-2022;Удмуртская Республика;90_105_days;SputnikV;5420;3610;9030;818861;336450;1155311
2022.04_13-10-2022;Ульяновская область;105_165_days;AllVaccines;86304;46696;133000;672149;320065;992214
2022.04_13-10-2022;Ульяновская область;105_165_days;CoviVac;1061;241;1302;672149;320065;992214
2022.04_13-10-2022;Ульяновская область;105_165_days;EpiVacCorona;2768;1461;4229;672149;320065;992214
2022.04_13-10-2022;Ульяновская область;105_165_days;SputnikLite;29624;22559;52183;672149;320065;992214
2022.04_13-10-2022;Ульяновская область;105_165_days;SputnikV;52851;22435;75286;672149;320065;992214
2022.04_13-10-2022;Ульяновская область;165_195_days;AllVaccines;65022;32321;97343;672149;320065;992214
2022.04_13-10-2022;Ульяновская область;165_195_days;CoviVac;1511;358;1869;672149;320065;992214
2022.04_13-10-2022;Ульяновская область;165_195_days;EpiVacCorona;1609;569;2178;672149;320065;992214
2022.04_13-10-2022;Ульяновская область;165_195_days;SputnikLite;14643;14146;28789;672149;320065;992214
2022.04_13-10-2022;Ульяновская область;165_195_days;SputnikV;47259;17248;64507;672149;320065;992214
2022.04_13-10-2022;Ульяновская область;21_45_days;AllVaccines;3828;2423;6251;672149;320065;992214
2022.04_13-10-2022;Ульяновская область;21_45_days;CoviVac;115;35;150;672149;320065;992214
2022.04_13-10-2022;Ульяновская область;21_45_days;EpiVacCorona;192;106;298;672149;320065;992214
2022.04_13-10-2022;Ульяновская область;21_45_days;SputnikLite;361;248;609;672149;320065;992214
2022.04_13-10-2022;Ульяновская область;21_45_days;SputnikV;3160;2034;5194;672149;320065;992214
2022.04_13-10-2022;Ульяновская область;45_75_days;AllVaccines;6343;3280;9623;672149;320065;992214
2022.04_13-10-2022;Ульяновская область;45_75_days;CoviVac;95;34;129;672149;320065;992214
2022.04_13-10-2022;Ульяновская область;45_75_days;EpiVacCorona;461;235;696;672149;320065;992214
2022.04_13-10-2022;Ульяновская область;45_75_days;SputnikLite;1247;623;1870;672149;320065;992214
2022.04_13-10-2022;Ульяновская область;45_75_days;SputnikV;4540;2388;6928;672149;320065;992214
2022.04_13-10-2022;Ульяновская область;75_90_days;AllVaccines;7025;3738;10763;672149;320065;992214
2022.04_13-10-2022;Ульяновская область;75_90_days;CoviVac;81;21;102;672149;320065;992214
2022.04_13-10-2022;Ульяновская область;75_90_days;EpiVacCorona;611;353;964;672149;320065;992214
2022.04_13-10-2022;Ульяновская область;75_90_days;SputnikLite;2451;1123;3574;672149;320065;992214
2022.04_13-10-2022;Ульяновская область;75_90_days;SputnikV;3882;2241;6123;672149;320065;992214
2022.04_13-10-2022;Ульяновская область;90_105_days;AllVaccines;10259;5239;15498;672149;320065;992214
2022.04_13-10-2022;Ульяновская область;90_105_days;CoviVac;136;41;177;672149;320065;992214
2022.04_13-10-2022;Ульяновская область;90_105_days;EpiVacCorona;435;298;733;672149;320065;992214
2022.04_13-10-2022;Ульяновская область;90_105_days;SputnikLite;6168;2881;9049;672149;320065;992214
2022.04_13-10-2022;Ульяновская область;90_105_days;SputnikV;3520;2019;5539;672149;320065;992214
2022.04_13-10-2022;Хабаровский край;105_165_days;AllVaccines;101973;39348;141321;757169;265178;1022347
2022.04_13-10-2022;Хабаровский край;105_165_days;CoviVac;1789;352;2141;757169;265178;1022347
2022.04_13-10-2022;Хабаровский край;105_165_days;EpiVacCorona;6384;2215;8599;757169;265178;1022347
2022.04_13-10-2022;Хабаровский край;105_165_days;SputnikLite;35636;17860;53496;757169;265178;1022347
2022.04_13-10-2022;Хабаровский край;105_165_days;SputnikV;58164;18921;77085;757169;265178;1022347
2022.04_13-10-2022;Хабаровский край;165_195_days;AllVaccines;51270;19412;70682;757169;265178;1022347
2022.04_13-10-2022;Хабаровский край;165_195_days;CoviVac;1181;252;1433;757169;265178;1022347
2022.04_13-10-2022;Хабаровский край;165_195_days;EpiVacCorona;1237;336;1573;757169;265178;1022347
2022.04_13-10-2022;Хабаровский край;165_195_days;SputnikLite;28316;10894;39210;757169;265178;1022347
2022.04_13-10-2022;Хабаровский край;165_195_days;SputnikV;20536;7930;28466;757169;265178;1022347
2022.04_13-10-2022;Хабаровский край;21_45_days;AllVaccines;4027;2556;6583;757169;265178;1022347
2022.04_13-10-2022;Хабаровский край;21_45_days;CoviVac;98;34;132;757169;265178;1022347
2022.04_13-10-2022;Хабаровский край;21_45_days;EpiVacCorona;346;232;578;757169;265178;1022347
2022.04_13-10-2022;Хабаровский край;21_45_days;SputnikLite;828;307;1135;757169;265178;1022347
2022.04_13-10-2022;Хабаровский край;21_45_days;SputnikV;2755;1983;4738;757169;265178;1022347
2022.04_13-10-2022;Хабаровский край;45_75_days;AllVaccines;7573;3481;11054;757169;265178;1022347
2022.04_13-10-2022;Хабаровский край;45_75_days;CoviVac;188;83;271;757169;265178;1022347
2022.04_13-10-2022;Хабаровский край;45_75_days;EpiVacCorona;533;260;793;757169;265178;1022347
2022.04_13-10-2022;Хабаровский край;45_75_days;SputnikLite;1734;717;2451;757169;265178;1022347
2022.04_13-10-2022;Хабаровский край;45_75_days;SputnikV;5118;2421;7539;757169;265178;1022347
2022.04_13-10-2022;Хабаровский край;75_90_days;AllVaccines;11975;5398;17373;757169;265178;1022347
2022.04_13-10-2022;Хабаровский край;75_90_days;CoviVac;127;29;156;757169;265178;1022347
2022.04_13-10-2022;Хабаровский край;75_90_days;EpiVacCorona;740;312;1052;757169;265178;1022347
2022.04_13-10-2022;Хабаровский край;75_90_days;SputnikLite;4833;1719;6552;757169;265178;1022347
2022.04_13-10-2022;Хабаровский край;75_90_days;SputnikV;6275;3338;9613;757169;265178;1022347
2022.04_13-10-2022;Хабаровский край;90_105_days;AllVaccines;14891;6976;21867;757169;265178;1022347
2022.04_13-10-2022;Хабаровский край;90_105_days;CoviVac;276;54;330;757169;265178;1022347
2022.04_13-10-2022;Хабаровский край;90_105_days;EpiVacCorona;1120;497;1617;757169;265178;1022347
2022.04_13-10-2022;Хабаровский край;90_105_days;SputnikLite;7515;3236;10751;757169;265178;1022347
2022.04_13-10-2022;Хабаровский край;90_105_days;SputnikV;5980;3189;9169;757169;265178;1022347
2022.04_13-10-2022;Ханты-Мансийский автономный округ - Югра;105_165_days;AllVaccines;148039;37550;185589;1019471;240107;1259578
2022.04_13-10-2022;Ханты-Мансийский автономный округ - Югра;105_165_days;CoviVac;659;134;793;1019471;240107;1259578
2022.04_13-10-2022;Ханты-Мансийский автономный округ - Югра;105_165_days;EpiVacCorona;1999;744;2743;1019471;240107;1259578
2022.04_13-10-2022;Ханты-Мансийский автономный округ - Югра;105_165_days;SputnikLite;73579;20579;94158;1019471;240107;1259578
2022.04_13-10-2022;Ханты-Мансийский автономный округ - Югра;105_165_days;SputnikV;71802;16093;87895;1019471;240107;1259578
2022.04_13-10-2022;Ханты-Мансийский автономный округ - Югра;165_195_days;AllVaccines;131269;27587;158856;1019471;240107;1259578
2022.04_13-10-2022;Ханты-Мансийский автономный округ - Югра;165_195_days;CoviVac;1189;208;1397;1019471;240107;1259578
2022.04_13-10-2022;Ханты-Мансийский автономный округ - Югра;165_195_days;EpiVacCorona;1439;398;1837;1019471;240107;1259578
2022.04_13-10-2022;Ханты-Мансийский автономный округ - Югра;165_195_days;SputnikLite;29450;11121;40571;1019471;240107;1259578
2022.04_13-10-2022;Ханты-Мансийский автономный округ - Югра;165_195_days;SputnikV;99191;15860;115051;1019471;240107;1259578
2022.04_13-10-2022;Ханты-Мансийский автономный округ - Югра;21_45_days;AllVaccines;8699;1821;10520;1019471;240107;1259578
2022.04_13-10-2022;Ханты-Мансийский автономный округ - Югра;21_45_days;CoviVac;290;34;324;1019471;240107;1259578
2022.04_13-10-2022;Ханты-Мансийский автономный округ - Югра;21_45_days;EpiVacCorona;423;95;518;1019471;240107;1259578
2022.04_13-10-2022;Ханты-Мансийский автономный округ - Югра;21_45_days;SputnikLite;1275;257;1532;1019471;240107;1259578
2022.04_13-10-2022;Ханты-Мансийский автономный округ - Югра;21_45_days;SputnikV;6711;1435;8146;1019471;240107;1259578
2022.04_13-10-2022;Ханты-Мансийский автономный округ - Югра;45_75_days;AllVaccines;18085;3514;21599;1019471;240107;1259578
2022.04_13-10-2022;Ханты-Мансийский автономный округ - Югра;45_75_days;CoviVac;227;36;263;1019471;240107;1259578
2022.04_13-10-2022;Ханты-Мансийский автономный округ - Югра;45_75_days;EpiVacCorona;322;70;392;1019471;240107;1259578
2022.04_13-10-2022;Ханты-Мансийский автономный округ - Югра;45_75_days;SputnikLite;6325;1322;7647;1019471;240107;1259578
2022.04_13-10-2022;Ханты-Мансийский автономный округ - Югра;45_75_days;SputnikV;11211;2086;13297;1019471;240107;1259578
2022.04_13-10-2022;Ханты-Мансийский автономный округ - Югра;75_90_days;AllVaccines;21005;3669;24674;1019471;240107;1259578
2022.04_13-10-2022;Ханты-Мансийский автономный округ - Югра;75_90_days;CoviVac;95;20;115;1019471;240107;1259578
2022.04_13-10-2022;Ханты-Мансийский автономный округ - Югра;75_90_days;EpiVacCorona;230;48;278;1019471;240107;1259578
2022.04_13-10-2022;Ханты-Мансийский автономный округ - Югра;75_90_days;SputnikLite;11986;1757;13743;1019471;240107;1259578
2022.04_13-10-2022;Ханты-Мансийский автономный округ - Югра;75_90_days;SputnikV;8694;1844;10538;1019471;240107;1259578
2022.04_13-10-2022;Ханты-Мансийский автономный округ - Югра;90_105_days;AllVaccines;24633;5227;29860;1019471;240107;1259578
2022.04_13-10-2022;Ханты-Мансийский автономный округ - Югра;90_105_days;CoviVac;164;30;194;1019471;240107;1259578
2022.04_13-10-2022;Ханты-Мансийский автономный округ - Югра;90_105_days;EpiVacCorona;274;99;373;1019471;240107;1259578
2022.04_13-10-2022;Ханты-Мансийский автономный округ - Югра;90_105_days;SputnikLite;16451;3130;19581;1019471;240107;1259578
2022.04_13-10-2022;Ханты-Мансийский автономный округ - Югра;90_105_days;SputnikV;7744;1968;9712;1019471;240107;1259578
2022.04_13-10-2022;Челябинская область;105_165_days;AllVaccines;267357;129491;396848;1901705;795956;2697661
2022.04_13-10-2022;Челябинская область;105_165_days;CoviVac;1653;509;2162;1901705;795956;2697661
2022.04_13-10-2022;Челябинская область;105_165_days;EpiVacCorona;7740;4550;12290;1901705;795956;2697661
2022.04_13-10-2022;Челябинская область;105_165_days;SputnikLite;101247;57928;159175;1901705;795956;2697661
2022.04_13-10-2022;Челябинская область;105_165_days;SputnikV;156717;66504;223221;1901705;795956;2697661
2022.04_13-10-2022;Челябинская область;165_195_days;AllVaccines;284875;98370;383245;1901705;795956;2697661
2022.04_13-10-2022;Челябинская область;165_195_days;CoviVac;3217;577;3794;1901705;795956;2697661
2022.04_13-10-2022;Челябинская область;165_195_days;EpiVacCorona;10024;3520;13544;1901705;795956;2697661
2022.04_13-10-2022;Челябинская область;165_195_days;SputnikLite;44079;23240;67319;1901705;795956;2697661
2022.04_13-10-2022;Челябинская область;165_195_days;SputnikV;227555;71033;298588;1901705;795956;2697661
2022.04_13-10-2022;Челябинская область;21_45_days;AllVaccines;16119;10244;26363;1901705;795956;2697661
2022.04_13-10-2022;Челябинская область;21_45_days;CoviVac;781;164;945;1901705;795956;2697661
2022.04_13-10-2022;Челябинская область;21_45_days;EpiVacCorona;1117;837;1954;1901705;795956;2697661
2022.04_13-10-2022;Челябинская область;21_45_days;SputnikLite;6680;3891;10571;1901705;795956;2697661
2022.04_13-10-2022;Челябинская область;21_45_days;SputnikV;7541;5352;12893;1901705;795956;2697661
2022.04_13-10-2022;Челябинская область;45_75_days;AllVaccines;27400;14681;42081;1901705;795956;2697661
2022.04_13-10-2022;Челябинская область;45_75_days;CoviVac;268;57;325;1901705;795956;2697661
2022.04_13-10-2022;Челябинская область;45_75_days;EpiVacCorona;1221;1441;2662;1901705;795956;2697661
2022.04_13-10-2022;Челябинская область;45_75_days;SputnikLite;12014;6327;18341;1901705;795956;2697661
2022.04_13-10-2022;Челябинская область;45_75_days;SputnikV;13897;6856;20753;1901705;795956;2697661
2022.04_13-10-2022;Челябинская область;75_90_days;AllVaccines;27745;12902;40647;1901705;795956;2697661
2022.04_13-10-2022;Челябинская область;75_90_days;CoviVac;155;22;177;1901705;795956;2697661
2022.04_13-10-2022;Челябинская область;75_90_days;EpiVacCorona;1993;1310;3303;1901705;795956;2697661
2022.04_13-10-2022;Челябинская область;75_90_days;SputnikLite;13756;5220;18976;1901705;795956;2697661
2022.04_13-10-2022;Челябинская область;75_90_days;SputnikV;11841;6350;18191;1901705;795956;2697661
2022.04_13-10-2022;Челябинская область;90_105_days;AllVaccines;31552;16925;48477;1901705;795956;2697661
2022.04_13-10-2022;Челябинская область;90_105_days;CoviVac;288;81;369;1901705;795956;2697661
2022.04_13-10-2022;Челябинская область;90_105_days;EpiVacCorona;1727;1574;3301;1901705;795956;2697661
2022.04_13-10-2022;Челябинская область;90_105_days;SputnikLite;18462;7529;25991;1901705;795956;2697661
2022.04_13-10-2022;Челябинская область;90_105_days;SputnikV;11075;7741;18816;1901705;795956;2697661
2022.04_13-10-2022;Чеченская Республика;105_165_days;AllVaccines;42691;5425;48116;809759;137234;946993
2022.04_13-10-2022;Чеченская Республика;105_165_days;CoviVac;185;38;223;809759;137234;946993
2022.04_13-10-2022;Чеченская Республика;105_165_days;EpiVacCorona;2673;444;3117;809759;137234;946993
2022.04_13-10-2022;Чеченская Республика;105_165_days;SputnikLite;30464;3495;33959;809759;137234;946993
2022.04_13-10-2022;Чеченская Республика;105_165_days;SputnikV;9369;1448;10817;809759;137234;946993
2022.04_13-10-2022;Чеченская Республика;165_195_days;AllVaccines;18792;3083;21875;809759;137234;946993
2022.04_13-10-2022;Чеченская Республика;165_195_days;CoviVac;364;67;431;809759;137234;946993
2022.04_13-10-2022;Чеченская Республика;165_195_days;EpiVacCorona;1944;313;2257;809759;137234;946993
2022.04_13-10-2022;Чеченская Республика;165_195_days;SputnikLite;2953;192;3145;809759;137234;946993
2022.04_13-10-2022;Чеченская Республика;165_195_days;SputnikV;13531;2511;16042;809759;137234;946993
2022.04_13-10-2022;Чеченская Республика;21_45_days;AllVaccines;10699;1749;12448;809759;137234;946993
2022.04_13-10-2022;Чеченская Республика;21_45_days;CoviVac;696;126;822;809759;137234;946993
2022.04_13-10-2022;Чеченская Республика;21_45_days;EpiVacCorona;32;2;34;809759;137234;946993
2022.04_13-10-2022;Чеченская Республика;21_45_days;SputnikLite;7014;1114;8128;809759;137234;946993
2022.04_13-10-2022;Чеченская Республика;21_45_days;SputnikV;2957;507;3464;809759;137234;946993
2022.04_13-10-2022;Чеченская Республика;45_75_days;AllVaccines;14443;2889;17332;809759;137234;946993
2022.04_13-10-2022;Чеченская Республика;45_75_days;CoviVac;3429;652;4081;809759;137234;946993
2022.04_13-10-2022;Чеченская Республика;45_75_days;EpiVacCorona;271;29;300;809759;137234;946993
2022.04_13-10-2022;Чеченская Республика;45_75_days;SputnikLite;2841;717;3558;809759;137234;946993
2022.04_13-10-2022;Чеченская Республика;45_75_days;SputnikV;7902;1491;9393;809759;137234;946993
2022.04_13-10-2022;Чеченская Республика;75_90_days;AllVaccines;7890;1230;9120;809759;137234;946993
2022.04_13-10-2022;Чеченская Республика;75_90_days;CoviVac;215;22;237;809759;137234;946993
2022.04_13-10-2022;Чеченская Республика;75_90_days;EpiVacCorona;346;45;391;809759;137234;946993
2022.04_13-10-2022;Чеченская Республика;75_90_days;SputnikLite;4623;754;5377;809759;137234;946993
2022.04_13-10-2022;Чеченская Республика;75_90_days;SputnikV;2706;409;3115;809759;137234;946993
2022.04_13-10-2022;Чеченская Республика;90_105_days;AllVaccines;15879;1781;17660;809759;137234;946993
2022.04_13-10-2022;Чеченская Республика;90_105_days;CoviVac;3;0;3;809759;137234;946993
2022.04_13-10-2022;Чеченская Республика;90_105_days;EpiVacCorona;328;55;383;809759;137234;946993
2022.04_13-10-2022;Чеченская Республика;90_105_days;SputnikLite;13172;1426;14598;809759;137234;946993
2022.04_13-10-2022;Чеченская Республика;90_105_days;SputnikV;2376;300;2676;809759;137234;946993
2022.04_13-10-2022;Чувашская Республика;105_165_days;AllVaccines;93611;45827;139438;674689;275580;950269
2022.04_13-10-2022;Чувашская Республика;105_165_days;CoviVac;1284;191;1475;674689;275580;950269
2022.04_13-10-2022;Чувашская Республика;105_165_days;EpiVacCorona;2511;1088;3599;674689;275580;950269
2022.04_13-10-2022;Чувашская Республика;105_165_days;SputnikLite;29153;21307;50460;674689;275580;950269
2022.04_13-10-2022;Чувашская Республика;105_165_days;SputnikV;60663;23241;83904;674689;275580;950269
2022.04_13-10-2022;Чувашская Республика;165_195_days;AllVaccines;70456;27820;98276;674689;275580;950269
2022.04_13-10-2022;Чувашская Республика;165_195_days;CoviVac;1172;175;1347;674689;275580;950269
2022.04_13-10-2022;Чувашская Республика;165_195_days;EpiVacCorona;2041;499;2540;674689;275580;950269
2022.04_13-10-2022;Чувашская Республика;165_195_days;SputnikLite;9884;9383;19267;674689;275580;950269
2022.04_13-10-2022;Чувашская Республика;165_195_days;SputnikV;57359;17763;75122;674689;275580;950269
2022.04_13-10-2022;Чувашская Республика;21_45_days;AllVaccines;5820;3651;9471;674689;275580;950269
2022.04_13-10-2022;Чувашская Республика;21_45_days;CoviVac;446;127;573;674689;275580;950269
2022.04_13-10-2022;Чувашская Республика;21_45_days;EpiVacCorona;275;189;464;674689;275580;950269
2022.04_13-10-2022;Чувашская Республика;21_45_days;SputnikLite;1081;891;1972;674689;275580;950269
2022.04_13-10-2022;Чувашская Республика;21_45_days;SputnikV;4018;2444;6462;674689;275580;950269
2022.04_13-10-2022;Чувашская Республика;45_75_days;AllVaccines;9391;5311;14702;674689;275580;950269
2022.04_13-10-2022;Чувашская Республика;45_75_days;CoviVac;162;23;185;674689;275580;950269
2022.04_13-10-2022;Чувашская Республика;45_75_days;EpiVacCorona;730;525;1255;674689;275580;950269
2022.04_13-10-2022;Чувашская Республика;45_75_days;SputnikLite;2679;1297;3976;674689;275580;950269
2022.04_13-10-2022;Чувашская Республика;45_75_days;SputnikV;5820;3466;9286;674689;275580;950269
2022.04_13-10-2022;Чувашская Республика;75_90_days;AllVaccines;12154;5639;17793;674689;275580;950269
2022.04_13-10-2022;Чувашская Республика;75_90_days;CoviVac;248;35;283;674689;275580;950269
2022.04_13-10-2022;Чувашская Республика;75_90_days;EpiVacCorona;732;295;1027;674689;275580;950269
2022.04_13-10-2022;Чувашская Республика;75_90_days;SputnikLite;6210;2682;8892;674689;275580;950269
2022.04_13-10-2022;Чувашская Республика;75_90_days;SputnikV;4964;2627;7591;674689;275580;950269
2022.04_13-10-2022;Чувашская Республика;90_105_days;AllVaccines;14591;7280;21871;674689;275580;950269
2022.04_13-10-2022;Чувашская Республика;90_105_days;CoviVac;199;45;244;674689;275580;950269
2022.04_13-10-2022;Чувашская Республика;90_105_days;EpiVacCorona;848;429;1277;674689;275580;950269
2022.04_13-10-2022;Чувашская Республика;90_105_days;SputnikLite;7146;3447;10593;674689;275580;950269
2022.04_13-10-2022;Чувашская Республика;90_105_days;SputnikV;6398;3359;9757;674689;275580;950269
2022.04_13-10-2022;Чукотский автономный округ;105_165_days;AllVaccines;4320;712;5032;30806;6299;37105
2022.04_13-10-2022;Чукотский автономный округ;105_165_days;CoviVac;130;19;149;30806;6299;37105
2022.04_13-10-2022;Чукотский автономный округ;105_165_days;EpiVacCorona;395;56;451;30806;6299;37105
2022.04_13-10-2022;Чукотский автономный округ;105_165_days;SputnikLite;3113;540;3653;30806;6299;37105
2022.04_13-10-2022;Чукотский автономный округ;105_165_days;SputnikV;682;97;779;30806;6299;37105
2022.04_13-10-2022;Чукотский автономный округ;165_195_days;AllVaccines;4435;746;5181;30806;6299;37105
2022.04_13-10-2022;Чукотский автономный округ;165_195_days;CoviVac;526;33;559;30806;6299;37105
2022.04_13-10-2022;Чукотский автономный округ;165_195_days;EpiVacCorona;255;34;289;30806;6299;37105
2022.04_13-10-2022;Чукотский автономный округ;165_195_days;SputnikLite;3214;615;3829;30806;6299;37105
2022.04_13-10-2022;Чукотский автономный округ;165_195_days;SputnikV;440;64;504;30806;6299;37105
2022.04_13-10-2022;Чукотский автономный округ;21_45_days;AllVaccines;510;106;616;30806;6299;37105
2022.04_13-10-2022;Чукотский автономный округ;21_45_days;CoviVac;21;1;22;30806;6299;37105
2022.04_13-10-2022;Чукотский автономный округ;21_45_days;EpiVacCorona;18;4;22;30806;6299;37105
2022.04_13-10-2022;Чукотский автономный округ;21_45_days;SputnikLite;304;66;370;30806;6299;37105
2022.04_13-10-2022;Чукотский автономный округ;21_45_days;SputnikV;167;35;202;30806;6299;37105
2022.04_13-10-2022;Чукотский автономный округ;45_75_days;AllVaccines;921;148;1069;30806;6299;37105
2022.04_13-10-2022;Чукотский автономный округ;45_75_days;CoviVac;16;1;17;30806;6299;37105
2022.04_13-10-2022;Чукотский автономный округ;45_75_days;EpiVacCorona;33;3;36;30806;6299;37105
2022.04_13-10-2022;Чукотский автономный округ;45_75_days;SputnikLite;604;98;702;30806;6299;37105
2022.04_13-10-2022;Чукотский автономный округ;45_75_days;SputnikV;268;46;314;30806;6299;37105
2022.04_13-10-2022;Чукотский автономный округ;75_90_days;AllVaccines;655;91;746;30806;6299;37105
2022.04_13-10-2022;Чукотский автономный округ;75_90_days;CoviVac;29;2;31;30806;6299;37105
2022.04_13-10-2022;Чукотский автономный округ;75_90_days;EpiVacCorona;40;5;45;30806;6299;37105
2022.04_13-10-2022;Чукотский автономный округ;75_90_days;SputnikLite;410;54;464;30806;6299;37105
2022.04_13-10-2022;Чукотский автономный округ;75_90_days;SputnikV;176;30;206;30806;6299;37105
2022.04_13-10-2022;Чукотский автономный округ;90_105_days;AllVaccines;873;124;997;30806;6299;37105
2022.04_13-10-2022;Чукотский автономный округ;90_105_days;CoviVac;32;4;36;30806;6299;37105
2022.04_13-10-2022;Чукотский автономный округ;90_105_days;EpiVacCorona;52;14;66;30806;6299;37105
2022.04_13-10-2022;Чукотский автономный округ;90_105_days;SputnikLite;629;71;700;30806;6299;37105
2022.04_13-10-2022;Чукотский автономный округ;90_105_days;SputnikV;160;35;195;30806;6299;37105
2022.04_13-10-2022;Ямало-Ненецкий автономный округ;105_165_days;AllVaccines;44320;5752;50072;346064;56429;402493
2022.04_13-10-2022;Ямало-Ненецкий автономный округ;105_165_days;CoviVac;459;81;540;346064;56429;402493
2022.04_13-10-2022;Ямало-Ненецкий автономный округ;105_165_days;EpiVacCorona;246;34;280;346064;56429;402493
2022.04_13-10-2022;Ямало-Ненецкий автономный округ;105_165_days;SputnikLite;25247;3731;28978;346064;56429;402493
2022.04_13-10-2022;Ямало-Ненецкий автономный округ;105_165_days;SputnikV;18368;1906;20274;346064;56429;402493
2022.04_13-10-2022;Ямало-Ненецкий автономный округ;165_195_days;AllVaccines;43082;5144;48226;346064;56429;402493
2022.04_13-10-2022;Ямало-Ненецкий автономный округ;165_195_days;CoviVac;536;50;586;346064;56429;402493
2022.04_13-10-2022;Ямало-Ненецкий автономный округ;165_195_days;EpiVacCorona;222;19;241;346064;56429;402493
2022.04_13-10-2022;Ямало-Ненецкий автономный округ;165_195_days;SputnikLite;18905;3320;22225;346064;56429;402493
2022.04_13-10-2022;Ямало-Ненецкий автономный округ;165_195_days;SputnikV;23419;1755;25174;346064;56429;402493
2022.04_13-10-2022;Ямало-Ненецкий автономный округ;21_45_days;AllVaccines;4142;534;4676;346064;56429;402493
2022.04_13-10-2022;Ямало-Ненецкий автономный округ;21_45_days;CoviVac;50;7;57;346064;56429;402493
2022.04_13-10-2022;Ямало-Ненецкий автономный округ;21_45_days;EpiVacCorona;63;9;72;346064;56429;402493
2022.04_13-10-2022;Ямало-Ненецкий автономный округ;21_45_days;SputnikLite;2872;369;3241;346064;56429;402493
2022.04_13-10-2022;Ямало-Ненецкий автономный округ;21_45_days;SputnikV;1157;149;1306;346064;56429;402493
2022.04_13-10-2022;Ямало-Ненецкий автономный округ;45_75_days;AllVaccines;6535;800;7335;346064;56429;402493
2022.04_13-10-2022;Ямало-Ненецкий автономный округ;45_75_days;CoviVac;51;7;58;346064;56429;402493
2022.04_13-10-2022;Ямало-Ненецкий автономный округ;45_75_days;EpiVacCorona;163;25;188;346064;56429;402493
2022.04_13-10-2022;Ямало-Ненецкий автономный округ;45_75_days;SputnikLite;4072;508;4580;346064;56429;402493
2022.04_13-10-2022;Ямало-Ненецкий автономный округ;45_75_days;SputnikV;2249;260;2509;346064;56429;402493
2022.04_13-10-2022;Ямало-Ненецкий автономный округ;75_90_days;AllVaccines;5746;764;6510;346064;56429;402493
2022.04_13-10-2022;Ямало-Ненецкий автономный округ;75_90_days;CoviVac;47;3;50;346064;56429;402493
2022.04_13-10-2022;Ямало-Ненецкий автономный округ;75_90_days;EpiVacCorona;163;21;184;346064;56429;402493
2022.04_13-10-2022;Ямало-Ненецкий автономный округ;75_90_days;SputnikLite;3279;405;3684;346064;56429;402493
2022.04_13-10-2022;Ямало-Ненецкий автономный округ;75_90_days;SputnikV;2257;335;2592;346064;56429;402493
2022.04_13-10-2022;Ямало-Ненецкий автономный округ;90_105_days;AllVaccines;8341;1045;9386;346064;56429;402493
2022.04_13-10-2022;Ямало-Ненецкий автономный округ;90_105_days;CoviVac;64;6;70;346064;56429;402493
2022.04_13-10-2022;Ямало-Ненецкий автономный округ;90_105_days;EpiVacCorona;91;14;105;346064;56429;402493
2022.04_13-10-2022;Ямало-Ненецкий автономный округ;90_105_days;SputnikLite;5976;687;6663;346064;56429;402493
2022.04_13-10-2022;Ямало-Ненецкий автономный округ;90_105_days;SputnikV;2210;338;2548;346064;56429;402493
2022.04_13-10-2022;Ярославская область;105_165_days;AllVaccines;72231;40021;112252;682586;317712;1000298
2022.04_13-10-2022;Ярославская область;105_165_days;CoviVac;1375;317;1692;682586;317712;1000298
2022.04_13-10-2022;Ярославская область;105_165_days;EpiVacCorona;1708;843;2551;682586;317712;1000298
2022.04_13-10-2022;Ярославская область;105_165_days;SputnikLite;33952;21593;55545;682586;317712;1000298
2022.04_13-10-2022;Ярославская область;105_165_days;SputnikV;35196;17268;52464;682586;317712;1000298
2022.04_13-10-2022;Ярославская область;165_195_days;AllVaccines;53100;29542;82642;682586;317712;1000298
2022.04_13-10-2022;Ярославская область;165_195_days;CoviVac;484;37;521;682586;317712;1000298
2022.04_13-10-2022;Ярославская область;165_195_days;EpiVacCorona;565;236;801;682586;317712;1000298
2022.04_13-10-2022;Ярославская область;165_195_days;SputnikLite;30471;16815;47286;682586;317712;1000298
2022.04_13-10-2022;Ярославская область;165_195_days;SputnikV;21580;12454;34034;682586;317712;1000298
2022.04_13-10-2022;Ярославская область;21_45_days;AllVaccines;3149;2342;5491;682586;317712;1000298
2022.04_13-10-2022;Ярославская область;21_45_days;CoviVac;176;64;240;682586;317712;1000298
2022.04_13-10-2022;Ярославская область;21_45_days;EpiVacCorona;134;79;213;682586;317712;1000298
2022.04_13-10-2022;Ярославская область;21_45_days;SputnikLite;811;408;1219;682586;317712;1000298
2022.04_13-10-2022;Ярославская область;21_45_days;SputnikV;2028;1791;3819;682586;317712;1000298
2022.04_13-10-2022;Ярославская область;45_75_days;AllVaccines;7141;3499;10640;682586;317712;1000298
2022.04_13-10-2022;Ярославская область;45_75_days;CoviVac;261;73;334;682586;317712;1000298
2022.04_13-10-2022;Ярославская область;45_75_days;EpiVacCorona;297;115;412;682586;317712;1000298
2022.04_13-10-2022;Ярославская область;45_75_days;SputnikLite;2045;987;3032;682586;317712;1000298
2022.04_13-10-2022;Ярославская область;45_75_days;SputnikV;4538;2324;6862;682586;317712;1000298
2022.04_13-10-2022;Ярославская область;75_90_days;AllVaccines;7473;3551;11024;682586;317712;1000298
2022.04_13-10-2022;Ярославская область;75_90_days;CoviVac;204;38;242;682586;317712;1000298
2022.04_13-10-2022;Ярославская область;75_90_days;EpiVacCorona;213;89;302;682586;317712;1000298
2022.04_13-10-2022;Ярославская область;75_90_days;SputnikLite;3191;1362;4553;682586;317712;1000298
2022.04_13-10-2022;Ярославская область;75_90_days;SputnikV;3865;2062;5927;682586;317712;1000298
2022.04_13-10-2022;Ярославская область;90_105_days;AllVaccines;9564;4826;14390;682586;317712;1000298
2022.04_13-10-2022;Ярославская область;90_105_days;CoviVac;258;49;307;682586;317712;1000298
2022.04_13-10-2022;Ярославская область;90_105_days;EpiVacCorona;557;244;801;682586;317712;1000298
2022.04_13-10-2022;Ярославская область;90_105_days;SputnikLite;5052;2329;7381;682586;317712;1000298
2022.04_13-10-2022;Ярославская область;90_105_days;SputnikV;3697;2204;5901;682586;317712;1000298
2022.04_13-10-2022;г. Москва;105_165_days;AllVaccines;623025;318705;941730;7299088;3167729;10466817
2022.04_13-10-2022;г. Москва;105_165_days;CoviVac;21557;2353;23910;7299088;3167729;10466817
2022.04_13-10-2022;г. Москва;105_165_days;EpiVacCorona;1340;816;2156;7299088;3167729;10466817
2022.04_13-10-2022;г. Москва;105_165_days;SputnikLite;293277;164128;457405;7299088;3167729;10466817
2022.04_13-10-2022;г. Москва;105_165_days;SputnikV;306851;151408;458259;7299088;3167729;10466817
2022.04_13-10-2022;г. Москва;165_195_days;AllVaccines;402287;289823;692110;7299088;3167729;10466817
2022.04_13-10-2022;г. Москва;165_195_days;CoviVac;14326;2879;17205;7299088;3167729;10466817
2022.04_13-10-2022;г. Москва;165_195_days;EpiVacCorona;1354;988;2342;7299088;3167729;10466817
2022.04_13-10-2022;г. Москва;165_195_days;SputnikLite;152160;120086;272246;7299088;3167729;10466817
2022.04_13-10-2022;г. Москва;165_195_days;SputnikV;234447;165870;400317;7299088;3167729;10466817
2022.04_13-10-2022;г. Москва;21_45_days;AllVaccines;20397;12338;32735;7299088;3167729;10466817
2022.04_13-10-2022;г. Москва;21_45_days;CoviVac;631;72;703;7299088;3167729;10466817
2022.04_13-10-2022;г. Москва;21_45_days;EpiVacCorona;15;11;26;7299088;3167729;10466817
2022.04_13-10-2022;г. Москва;21_45_days;SputnikLite;4763;1278;6041;7299088;3167729;10466817
2022.04_13-10-2022;г. Москва;21_45_days;SputnikV;14988;10977;25965;7299088;3167729;10466817
2022.04_13-10-2022;г. Москва;45_75_days;AllVaccines;56782;25780;82562;7299088;3167729;10466817
2022.04_13-10-2022;г. Москва;45_75_days;CoviVac;1324;130;1454;7299088;3167729;10466817
2022.04_13-10-2022;г. Москва;45_75_days;EpiVacCorona;39;30;69;7299088;3167729;10466817
2022.04_13-10-2022;г. Москва;45_75_days;SputnikLite;13338;4828;18166;7299088;3167729;10466817
2022.04_13-10-2022;г. Москва;45_75_days;SputnikV;42081;20792;62873;7299088;3167729;10466817
2022.04_13-10-2022;г. Москва;75_90_days;AllVaccines;85040;31468;116508;7299088;3167729;10466817
2022.04_13-10-2022;г. Москва;75_90_days;CoviVac;1441;87;1528;7299088;3167729;10466817
2022.04_13-10-2022;г. Москва;75_90_days;EpiVacCorona;102;35;137;7299088;3167729;10466817
2022.04_13-10-2022;г. Москва;75_90_days;SputnikLite;37966;15423;53389;7299088;3167729;10466817
2022.04_13-10-2022;г. Москва;75_90_days;SputnikV;45531;15923;61454;7299088;3167729;10466817
2022.04_13-10-2022;г. Москва;90_105_days;AllVaccines;139918;52457;192375;7299088;3167729;10466817
2022.04_13-10-2022;г. Москва;90_105_days;CoviVac;2356;224;2580;7299088;3167729;10466817
2022.04_13-10-2022;г. Москва;90_105_days;EpiVacCorona;170;71;241;7299088;3167729;10466817
2022.04_13-10-2022;г. Москва;90_105_days;SputnikLite;81257;30749;112006;7299088;3167729;10466817
2022.04_13-10-2022;г. Москва;90_105_days;SputnikV;56135;21413;77548;7299088;3167729;10466817
2022.04_13-10-2022;г. Санкт-Петербург;105_165_days;AllVaccines;549400;203820;753220;3114778;1306302;4421080
2022.04_13-10-2022;г. Санкт-Петербург;105_165_days;CoviVac;3488;284;3772;3114778;1306302;4421080
2022.04_13-10-2022;г. Санкт-Петербург;105_165_days;EpiVacCorona;6161;2713;8874;3114778;1306302;4421080
2022.04_13-10-2022;г. Санкт-Петербург;105_165_days;SputnikLite;204499;101660;306159;3114778;1306302;4421080
2022.04_13-10-2022;г. Санкт-Петербург;105_165_days;SputnikV;335252;99163;434415;3114778;1306302;4421080
2022.04_13-10-2022;г. Санкт-Петербург;165_195_days;AllVaccines;332836;125729;458565;3114778;1306302;4421080
2022.04_13-10-2022;г. Санкт-Петербург;165_195_days;CoviVac;3633;279;3912;3114778;1306302;4421080
2022.04_13-10-2022;г. Санкт-Петербург;165_195_days;EpiVacCorona;2753;1278;4031;3114778;1306302;4421080
2022.04_13-10-2022;г. Санкт-Петербург;165_195_days;SputnikLite;134124;57882;192006;3114778;1306302;4421080
2022.04_13-10-2022;г. Санкт-Петербург;165_195_days;SputnikV;192326;66290;258616;3114778;1306302;4421080
2022.04_13-10-2022;г. Санкт-Петербург;21_45_days;AllVaccines;14055;7667;21722;3114778;1306302;4421080
2022.04_13-10-2022;г. Санкт-Петербург;21_45_days;CoviVac;659;50;709;3114778;1306302;4421080
2022.04_13-10-2022;г. Санкт-Петербург;21_45_days;EpiVacCorona;347;189;536;3114778;1306302;4421080
2022.04_13-10-2022;г. Санкт-Петербург;21_45_days;SputnikLite;4151;1660;5811;3114778;1306302;4421080
2022.04_13-10-2022;г. Санкт-Петербург;21_45_days;SputnikV;8898;5768;14666;3114778;1306302;4421080
2022.04_13-10-2022;г. Санкт-Петербург;45_75_days;AllVaccines;36066;16536;52602;3114778;1306302;4421080
2022.04_13-10-2022;г. Санкт-Петербург;45_75_days;CoviVac;608;45;653;3114778;1306302;4421080
2022.04_13-10-2022;г. Санкт-Петербург;45_75_days;EpiVacCorona;407;275;682;3114778;1306302;4421080
2022.04_13-10-2022;г. Санкт-Петербург;45_75_days;SputnikLite;12065;7275;19340;3114778;1306302;4421080
2022.04_13-10-2022;г. Санкт-Петербург;45_75_days;SputnikV;22986;8941;31927;3114778;1306302;4421080
2022.04_13-10-2022;г. Санкт-Петербург;75_90_days;AllVaccines;45439;15001;60440;3114778;1306302;4421080
2022.04_13-10-2022;г. Санкт-Петербург;75_90_days;CoviVac;644;29;673;3114778;1306302;4421080
2022.04_13-10-2022;г. Санкт-Петербург;75_90_days;EpiVacCorona;652;239;891;3114778;1306302;4421080
2022.04_13-10-2022;г. Санкт-Петербург;75_90_days;SputnikLite;16504;6514;23018;3114778;1306302;4421080
2022.04_13-10-2022;г. Санкт-Петербург;75_90_days;SputnikV;27639;8219;35858;3114778;1306302;4421080
2022.04_13-10-2022;г. Санкт-Петербург;90_105_days;AllVaccines;67115;22410;89525;3114778;1306302;4421080
2022.04_13-10-2022;г. Санкт-Петербург;90_105_days;CoviVac;1296;56;1352;3114778;1306302;4421080
2022.04_13-10-2022;г. Санкт-Петербург;90_105_days;EpiVacCorona;1506;651;2157;3114778;1306302;4421080
2022.04_13-10-2022;г. Санкт-Петербург;90_105_days;SputnikLite;25881;10673;36554;3114778;1306302;4421080
2022.04_13-10-2022;г. Санкт-Петербург;90_105_days;SputnikV;38432;11030;49462;3114778;1306302;4421080
2022.04_13-10-2022;г. Севастополь;105_165_days;AllVaccines;37417;17350;54767;293051;116400;409451
2022.04_13-10-2022;г. Севастополь;105_165_days;CoviVac;229;107;336;293051;116400;409451
2022.04_13-10-2022;г. Севастополь;105_165_days;EpiVacCorona;488;266;754;293051;116400;409451
2022.04_13-10-2022;г. Севастополь;105_165_days;SputnikLite;14996;11278;26274;293051;116400;409451
2022.04_13-10-2022;г. Севастополь;105_165_days;SputnikV;21704;5699;27403;293051;116400;409451
2022.04_13-10-2022;г. Севастополь;165_195_days;AllVaccines;44369;15497;59866;293051;116400;409451
2022.04_13-10-2022;г. Севастополь;165_195_days;CoviVac;501;132;633;293051;116400;409451
2022.04_13-10-2022;г. Севастополь;165_195_days;EpiVacCorona;937;305;1242;293051;116400;409451
2022.04_13-10-2022;г. Севастополь;165_195_days;SputnikLite;9861;8608;18469;293051;116400;409451
2022.04_13-10-2022;г. Севастополь;165_195_days;SputnikV;33070;6452;39522;293051;116400;409451
2022.04_13-10-2022;г. Севастополь;21_45_days;AllVaccines;2533;1662;4195;293051;116400;409451
2022.04_13-10-2022;г. Севастополь;21_45_days;CoviVac;13;9;22;293051;116400;409451
2022.04_13-10-2022;г. Севастополь;21_45_days;EpiVacCorona;16;28;44;293051;116400;409451
2022.04_13-10-2022;г. Севастополь;21_45_days;SputnikLite;1628;1132;2760;293051;116400;409451
2022.04_13-10-2022;г. Севастополь;21_45_days;SputnikV;876;493;1369;293051;116400;409451
2022.04_13-10-2022;г. Севастополь;45_75_days;AllVaccines;2728;1723;4451;293051;116400;409451
2022.04_13-10-2022;г. Севастополь;45_75_days;CoviVac;30;11;41;293051;116400;409451
2022.04_13-10-2022;г. Севастополь;45_75_days;EpiVacCorona;25;44;69;293051;116400;409451
2022.04_13-10-2022;г. Севастополь;45_75_days;SputnikLite;1432;925;2357;293051;116400;409451
2022.04_13-10-2022;г. Севастополь;45_75_days;SputnikV;1241;743;1984;293051;116400;409451
2022.04_13-10-2022;г. Севастополь;75_90_days;AllVaccines;3099;1515;4614;293051;116400;409451
2022.04_13-10-2022;г. Севастополь;75_90_days;CoviVac;39;19;58;293051;116400;409451
2022.04_13-10-2022;г. Севастополь;75_90_days;EpiVacCorona;26;55;81;293051;116400;409451
2022.04_13-10-2022;г. Севастополь;75_90_days;SputnikLite;1225;633;1858;293051;116400;409451
2022.04_13-10-2022;г. Севастополь;75_90_days;SputnikV;1809;808;2617;293051;116400;409451
2022.04_13-10-2022;г. Севастополь;90_105_days;AllVaccines;4095;2187;6282;293051;116400;409451
2022.04_13-10-2022;г. Севастополь;90_105_days;CoviVac;60;23;83;293051;116400;409451
2022.04_13-10-2022;г. Севастополь;90_105_days;EpiVacCorona;67;72;139;293051;116400;409451
2022.04_13-10-2022;г. Севастополь;90_105_days;SputnikLite;2406;1359;3765;293051;116400;409451
2022.04_13-10-2022;г. Севастополь;90_105_days;SputnikV;1562;733;2295;293051;116400;409451
2022.05_01-07-2022;Алтайский край;105_165_days;AllVaccines;159796;96238;256034;1240936;570412;1811348
2022.05_01-07-2022;Алтайский край;105_165_days;CoviVac;1777;407;2184;1240936;570412;1811348
2022.05_01-07-2022;Алтайский край;105_165_days;EpiVacCorona;7186;3385;10571;1240936;570412;1811348
2022.05_01-07-2022;Алтайский край;105_165_days;SputnikLite;64400;43642;108042;1240936;570412;1811348
2022.05_01-07-2022;Алтайский край;105_165_days;SputnikV;86433;48804;135237;1240936;570412;1811348
2022.05_01-07-2022;Алтайский край;165_195_days;AllVaccines;92582;54337;146919;1240936;570412;1811348
2022.05_01-07-2022;Алтайский край;165_195_days;CoviVac;2011;438;2449;1240936;570412;1811348
2022.05_01-07-2022;Алтайский край;165_195_days;EpiVacCorona;7592;3850;11442;1240936;570412;1811348
2022.05_01-07-2022;Алтайский край;165_195_days;SputnikLite;34858;22207;57065;1240936;570412;1811348
2022.05_01-07-2022;Алтайский край;165_195_days;SputnikV;48121;27842;75963;1240936;570412;1811348
2022.05_01-07-2022;Алтайский край;21_45_days;AllVaccines;7199;5460;12659;1240936;570412;1811348
2022.05_01-07-2022;Алтайский край;21_45_days;CoviVac;595;208;803;1240936;570412;1811348
2022.05_01-07-2022;Алтайский край;21_45_days;EpiVacCorona;833;643;1476;1240936;570412;1811348
2022.05_01-07-2022;Алтайский край;21_45_days;SputnikLite;784;467;1251;1240936;570412;1811348
2022.05_01-07-2022;Алтайский край;21_45_days;SputnikV;4987;4142;9129;1240936;570412;1811348
2022.05_01-07-2022;Алтайский край;45_75_days;AllVaccines;13630;7611;21241;1240936;570412;1811348
2022.05_01-07-2022;Алтайский край;45_75_days;CoviVac;709;291;1000;1240936;570412;1811348
2022.05_01-07-2022;Алтайский край;45_75_days;EpiVacCorona;1374;818;2192;1240936;570412;1811348
2022.05_01-07-2022;Алтайский край;45_75_days;SputnikLite;2561;1215;3776;1240936;570412;1811348
2022.05_01-07-2022;Алтайский край;45_75_days;SputnikV;8986;5287;14273;1240936;570412;1811348
2022.05_01-07-2022;Алтайский край;75_90_days;AllVaccines;28397;14635;43032;1240936;570412;1811348
2022.05_01-07-2022;Алтайский край;75_90_days;CoviVac;208;67;275;1240936;570412;1811348
2022.05_01-07-2022;Алтайский край;75_90_days;EpiVacCorona;914;503;1417;1240936;570412;1811348
2022.05_01-07-2022;Алтайский край;75_90_days;SputnikLite;16189;6794;22983;1240936;570412;1811348
2022.05_01-07-2022;Алтайский край;75_90_days;SputnikV;11086;7271;18357;1240936;570412;1811348
2022.05_01-07-2022;Алтайский край;90_105_days;AllVaccines;26367;15519;41886;1240936;570412;1811348
2022.05_01-07-2022;Алтайский край;90_105_days;CoviVac;259;93;352;1240936;570412;1811348
2022.05_01-07-2022;Алтайский край;90_105_days;EpiVacCorona;1196;850;2046;1240936;570412;1811348
2022.05_01-07-2022;Алтайский край;90_105_days;SputnikLite;14919;6946;21865;1240936;570412;1811348
2022.05_01-07-2022;Алтайский край;90_105_days;SputnikV;9993;7630;17623;1240936;570412;1811348
2022.05_01-07-2022;Амурская область;105_165_days;AllVaccines;68733;22593;91326;444961;159780;604741
2022.05_01-07-2022;Амурская область;105_165_days;CoviVac;624;168;792;444961;159780;604741
2022.05_01-07-2022;Амурская область;105_165_days;EpiVacCorona;4949;1692;6641;444961;159780;604741
2022.05_01-07-2022;Амурская область;105_165_days;SputnikLite;23483;10652;34135;444961;159780;604741
2022.05_01-07-2022;Амурская область;105_165_days;SputnikV;39677;10081;49758;444961;159780;604741
2022.05_01-07-2022;Амурская область;165_195_days;AllVaccines;45287;18449;63736;444961;159780;604741
2022.05_01-07-2022;Амурская область;165_195_days;CoviVac;1229;337;1566;444961;159780;604741
2022.05_01-07-2022;Амурская область;165_195_days;EpiVacCorona;3304;1433;4737;444961;159780;604741
2022.05_01-07-2022;Амурская область;165_195_days;SputnikLite;16468;8786;25254;444961;159780;604741
2022.05_01-07-2022;Амурская область;165_195_days;SputnikV;24286;7893;32179;444961;159780;604741
2022.05_01-07-2022;Амурская область;21_45_days;AllVaccines;3876;1505;5381;444961;159780;604741
2022.05_01-07-2022;Амурская область;21_45_days;CoviVac;54;8;62;444961;159780;604741
2022.05_01-07-2022;Амурская область;21_45_days;EpiVacCorona;409;166;575;444961;159780;604741
2022.05_01-07-2022;Амурская область;21_45_days;SputnikLite;1638;553;2191;444961;159780;604741
2022.05_01-07-2022;Амурская область;21_45_days;SputnikV;1775;778;2553;444961;159780;604741
2022.05_01-07-2022;Амурская область;45_75_days;AllVaccines;9708;2674;12382;444961;159780;604741
2022.05_01-07-2022;Амурская область;45_75_days;CoviVac;106;17;123;444961;159780;604741
2022.05_01-07-2022;Амурская область;45_75_days;EpiVacCorona;552;263;815;444961;159780;604741
2022.05_01-07-2022;Амурская область;45_75_days;SputnikLite;5408;1317;6725;444961;159780;604741
2022.05_01-07-2022;Амурская область;45_75_days;SputnikV;3642;1077;4719;444961;159780;604741
2022.05_01-07-2022;Амурская область;75_90_days;AllVaccines;9270;2922;12192;444961;159780;604741
2022.05_01-07-2022;Амурская область;75_90_days;CoviVac;155;32;187;444961;159780;604741
2022.05_01-07-2022;Амурская область;75_90_days;EpiVacCorona;578;220;798;444961;159780;604741
2022.05_01-07-2022;Амурская область;75_90_days;SputnikLite;4130;1233;5363;444961;159780;604741
2022.05_01-07-2022;Амурская область;75_90_days;SputnikV;4407;1437;5844;444961;159780;604741
2022.05_01-07-2022;Амурская область;90_105_days;AllVaccines;13838;4088;17926;444961;159780;604741
2022.05_01-07-2022;Амурская область;90_105_days;CoviVac;158;28;186;444961;159780;604741
2022.05_01-07-2022;Амурская область;90_105_days;EpiVacCorona;727;282;1009;444961;159780;604741
2022.05_01-07-2022;Амурская область;90_105_days;SputnikLite;8406;2332;10738;444961;159780;604741
2022.05_01-07-2022;Амурская область;90_105_days;SputnikV;4547;1446;5993;444961;159780;604741
2022.05_01-07-2022;Архангельская область;105_165_days;AllVaccines;66928;45492;112420;595439;264499;859938
2022.05_01-07-2022;Архангельская область;105_165_days;CoviVac;989;127;1116;595439;264499;859938
2022.05_01-07-2022;Архангельская область;105_165_days;EpiVacCorona;3280;1733;5013;595439;264499;859938
2022.05_01-07-2022;Архангельская область;105_165_days;SputnikLite;26105;22095;48200;595439;264499;859938
2022.05_01-07-2022;Архангельская область;105_165_days;SputnikV;36554;21537;58091;595439;264499;859938
2022.05_01-07-2022;Архангельская область;165_195_days;AllVaccines;53256;26914;80170;595439;264499;859938
2022.05_01-07-2022;Архангельская область;165_195_days;CoviVac;1011;192;1203;595439;264499;859938
2022.05_01-07-2022;Архангельская область;165_195_days;EpiVacCorona;3463;1359;4822;595439;264499;859938
2022.05_01-07-2022;Архангельская область;165_195_days;SputnikLite;19533;12198;31731;595439;264499;859938
2022.05_01-07-2022;Архангельская область;165_195_days;SputnikV;29249;13165;42414;595439;264499;859938
2022.05_01-07-2022;Архангельская область;21_45_days;AllVaccines;4633;3726;8359;595439;264499;859938
2022.05_01-07-2022;Архангельская область;21_45_days;CoviVac;151;90;241;595439;264499;859938
2022.05_01-07-2022;Архангельская область;21_45_days;EpiVacCorona;322;263;585;595439;264499;859938
2022.05_01-07-2022;Архангельская область;21_45_days;SputnikLite;723;599;1322;595439;264499;859938
2022.05_01-07-2022;Архангельская область;21_45_days;SputnikV;3437;2774;6211;595439;264499;859938
2022.05_01-07-2022;Архангельская область;45_75_days;AllVaccines;8150;5447;13597;595439;264499;859938
2022.05_01-07-2022;Архангельская область;45_75_days;CoviVac;176;33;209;595439;264499;859938
2022.05_01-07-2022;Архангельская область;45_75_days;EpiVacCorona;533;598;1131;595439;264499;859938
2022.05_01-07-2022;Архангельская область;45_75_days;SputnikLite;1131;820;1951;595439;264499;859938
2022.05_01-07-2022;Архангельская область;45_75_days;SputnikV;6310;3996;10306;595439;264499;859938
2022.05_01-07-2022;Архангельская область;75_90_days;AllVaccines;6783;3852;10635;595439;264499;859938
2022.05_01-07-2022;Архангельская область;75_90_days;CoviVac;125;25;150;595439;264499;859938
2022.05_01-07-2022;Архангельская область;75_90_days;EpiVacCorona;285;185;470;595439;264499;859938
2022.05_01-07-2022;Архангельская область;75_90_days;SputnikLite;1910;852;2762;595439;264499;859938
2022.05_01-07-2022;Архангельская область;75_90_days;SputnikV;4463;2790;7253;595439;264499;859938
2022.05_01-07-2022;Архангельская область;90_105_days;AllVaccines;7442;4255;11697;595439;264499;859938
2022.05_01-07-2022;Архангельская область;90_105_days;CoviVac;117;16;133;595439;264499;859938
2022.05_01-07-2022;Архангельская область;90_105_days;EpiVacCorona;302;235;537;595439;264499;859938
2022.05_01-07-2022;Архангельская область;90_105_days;SputnikLite;3352;1846;5198;595439;264499;859938
2022.05_01-07-2022;Архангельская область;90_105_days;SputnikV;3671;2158;5829;595439;264499;859938
2022.05_01-07-2022;Астраханская область;105_165_days;AllVaccines;66731;24118;90849;550968;219749;770717
2022.05_01-07-2022;Астраханская область;105_165_days;CoviVac;971;318;1289;550968;219749;770717
2022.05_01-07-2022;Астраханская область;105_165_days;EpiVacCorona;3177;1103;4280;550968;219749;770717
2022.05_01-07-2022;Астраханская область;105_165_days;SputnikLite;26348;11622;37970;550968;219749;770717
2022.05_01-07-2022;Астраханская область;105_165_days;SputnikV;36235;11075;47310;550968;219749;770717
2022.05_01-07-2022;Астраханская область;165_195_days;AllVaccines;47035;17735;64770;550968;219749;770717
2022.05_01-07-2022;Астраханская область;165_195_days;CoviVac;517;224;741;550968;219749;770717
2022.05_01-07-2022;Астраханская область;165_195_days;EpiVacCorona;2102;747;2849;550968;219749;770717
2022.05_01-07-2022;Астраханская область;165_195_days;SputnikLite;17542;8674;26216;550968;219749;770717
2022.05_01-07-2022;Астраханская область;165_195_days;SputnikV;26874;8090;34964;550968;219749;770717
2022.05_01-07-2022;Астраханская область;21_45_days;AllVaccines;4387;2149;6536;550968;219749;770717
2022.05_01-07-2022;Астраханская область;21_45_days;CoviVac;63;20;83;550968;219749;770717
2022.05_01-07-2022;Астраханская область;21_45_days;EpiVacCorona;114;80;194;550968;219749;770717
2022.05_01-07-2022;Астраханская область;21_45_days;SputnikLite;2626;1096;3722;550968;219749;770717
2022.05_01-07-2022;Астраханская область;21_45_days;SputnikV;1584;953;2537;550968;219749;770717
2022.05_01-07-2022;Астраханская область;45_75_days;AllVaccines;10470;3936;14406;550968;219749;770717
2022.05_01-07-2022;Астраханская область;45_75_days;CoviVac;110;25;135;550968;219749;770717
2022.05_01-07-2022;Астраханская область;45_75_days;EpiVacCorona;217;61;278;550968;219749;770717
2022.05_01-07-2022;Астраханская область;45_75_days;SputnikLite;4989;2016;7005;550968;219749;770717
2022.05_01-07-2022;Астраханская область;45_75_days;SputnikV;5154;1834;6988;550968;219749;770717
2022.05_01-07-2022;Астраханская область;75_90_days;AllVaccines;9183;3470;12653;550968;219749;770717
2022.05_01-07-2022;Астраханская область;75_90_days;CoviVac;147;108;255;550968;219749;770717
2022.05_01-07-2022;Астраханская область;75_90_days;EpiVacCorona;406;162;568;550968;219749;770717
2022.05_01-07-2022;Астраханская область;75_90_days;SputnikLite;4288;1343;5631;550968;219749;770717
2022.05_01-07-2022;Астраханская область;75_90_days;SputnikV;4342;1857;6199;550968;219749;770717
2022.05_01-07-2022;Астраханская область;90_105_days;AllVaccines;11442;4466;15908;550968;219749;770717
2022.05_01-07-2022;Астраханская область;90_105_days;CoviVac;107;49;156;550968;219749;770717
2022.05_01-07-2022;Астраханская область;90_105_days;EpiVacCorona;81;36;117;550968;219749;770717
2022.05_01-07-2022;Астраханская область;90_105_days;SputnikLite;6622;2063;8685;550968;219749;770717
2022.05_01-07-2022;Астраханская область;90_105_days;SputnikV;4632;2318;6950;550968;219749;770717
2022.05_01-07-2022;Белгородская область;105_165_days;AllVaccines;154010;64402;218412;867731;383871;1251602
2022.05_01-07-2022;Белгородская область;105_165_days;CoviVac;857;314;1171;867731;383871;1251602
2022.05_01-07-2022;Белгородская область;105_165_days;EpiVacCorona;1328;629;1957;867731;383871;1251602
2022.05_01-07-2022;Белгородская область;105_165_days;SputnikLite;80023;39257;119280;867731;383871;1251602
2022.05_01-07-2022;Белгородская область;105_165_days;SputnikV;71802;24202;96004;867731;383871;1251602
2022.05_01-07-2022;Белгородская область;165_195_days;AllVaccines;93684;48745;142429;867731;383871;1251602
2022.05_01-07-2022;Белгородская область;165_195_days;CoviVac;994;378;1372;867731;383871;1251602
2022.05_01-07-2022;Белгородская область;165_195_days;EpiVacCorona;1416;677;2093;867731;383871;1251602
2022.05_01-07-2022;Белгородская область;165_195_days;SputnikLite;43899;27344;71243;867731;383871;1251602
2022.05_01-07-2022;Белгородская область;165_195_days;SputnikV;47375;20346;67721;867731;383871;1251602
2022.05_01-07-2022;Белгородская область;21_45_days;AllVaccines;4344;3002;7346;867731;383871;1251602
2022.05_01-07-2022;Белгородская область;21_45_days;CoviVac;91;67;158;867731;383871;1251602
2022.05_01-07-2022;Белгородская область;21_45_days;EpiVacCorona;315;252;567;867731;383871;1251602
2022.05_01-07-2022;Белгородская область;21_45_days;SputnikLite;704;410;1114;867731;383871;1251602
2022.05_01-07-2022;Белгородская область;21_45_days;SputnikV;3234;2273;5507;867731;383871;1251602
2022.05_01-07-2022;Белгородская область;45_75_days;AllVaccines;9136;4250;13386;867731;383871;1251602
2022.05_01-07-2022;Белгородская область;45_75_days;CoviVac;213;69;282;867731;383871;1251602
2022.05_01-07-2022;Белгородская область;45_75_days;EpiVacCorona;380;197;577;867731;383871;1251602
2022.05_01-07-2022;Белгородская область;45_75_days;SputnikLite;4711;2325;7036;867731;383871;1251602
2022.05_01-07-2022;Белгородская область;45_75_days;SputnikV;3832;1659;5491;867731;383871;1251602
2022.05_01-07-2022;Белгородская область;75_90_days;AllVaccines;13587;5310;18897;867731;383871;1251602
2022.05_01-07-2022;Белгородская область;75_90_days;CoviVac;163;37;200;867731;383871;1251602
2022.05_01-07-2022;Белгородская область;75_90_days;EpiVacCorona;227;74;301;867731;383871;1251602
2022.05_01-07-2022;Белгородская область;75_90_days;SputnikLite;8616;3557;12173;867731;383871;1251602
2022.05_01-07-2022;Белгородская область;75_90_days;SputnikV;4581;1642;6223;867731;383871;1251602
2022.05_01-07-2022;Белгородская область;90_105_days;AllVaccines;23570;8112;31682;867731;383871;1251602
2022.05_01-07-2022;Белгородская область;90_105_days;CoviVac;163;65;228;867731;383871;1251602
2022.05_01-07-2022;Белгородская область;90_105_days;EpiVacCorona;215;107;322;867731;383871;1251602
2022.05_01-07-2022;Белгородская область;90_105_days;SputnikLite;16801;5657;22458;867731;383871;1251602
2022.05_01-07-2022;Белгородская область;90_105_days;SputnikV;6391;2283;8674;867731;383871;1251602
2022.05_01-07-2022;Брянская область;105_165_days;AllVaccines;77006;45870;122876;659625;298625;958250
2022.05_01-07-2022;Брянская область;105_165_days;CoviVac;1487;419;1906;659625;298625;958250
2022.05_01-07-2022;Брянская область;105_165_days;EpiVacCorona;4912;2472;7384;659625;298625;958250
2022.05_01-07-2022;Брянская область;105_165_days;SputnikLite;31831;22582;54413;659625;298625;958250
2022.05_01-07-2022;Брянская область;105_165_days;SputnikV;38776;20397;59173;659625;298625;958250
2022.05_01-07-2022;Брянская область;165_195_days;AllVaccines;50781;31482;82263;659625;298625;958250
2022.05_01-07-2022;Брянская область;165_195_days;CoviVac;1247;355;1602;659625;298625;958250
2022.05_01-07-2022;Брянская область;165_195_days;EpiVacCorona;4117;1792;5909;659625;298625;958250
2022.05_01-07-2022;Брянская область;165_195_days;SputnikLite;15553;12081;27634;659625;298625;958250
2022.05_01-07-2022;Брянская область;165_195_days;SputnikV;29864;17254;47118;659625;298625;958250
2022.05_01-07-2022;Брянская область;21_45_days;AllVaccines;2544;1872;4416;659625;298625;958250
2022.05_01-07-2022;Брянская область;21_45_days;CoviVac;126;61;187;659625;298625;958250
2022.05_01-07-2022;Брянская область;21_45_days;EpiVacCorona;105;40;145;659625;298625;958250
2022.05_01-07-2022;Брянская область;21_45_days;SputnikLite;886;776;1662;659625;298625;958250
2022.05_01-07-2022;Брянская область;21_45_days;SputnikV;1427;995;2422;659625;298625;958250
2022.05_01-07-2022;Брянская область;45_75_days;AllVaccines;5817;3396;9213;659625;298625;958250
2022.05_01-07-2022;Брянская область;45_75_days;CoviVac;130;40;170;659625;298625;958250
2022.05_01-07-2022;Брянская область;45_75_days;EpiVacCorona;178;99;277;659625;298625;958250
2022.05_01-07-2022;Брянская область;45_75_days;SputnikLite;2002;1361;3363;659625;298625;958250
2022.05_01-07-2022;Брянская область;45_75_days;SputnikV;3507;1896;5403;659625;298625;958250
2022.05_01-07-2022;Брянская область;75_90_days;AllVaccines;7189;3941;11130;659625;298625;958250
2022.05_01-07-2022;Брянская область;75_90_days;CoviVac;109;42;151;659625;298625;958250
2022.05_01-07-2022;Брянская область;75_90_days;EpiVacCorona;228;105;333;659625;298625;958250
2022.05_01-07-2022;Брянская область;75_90_days;SputnikLite;2678;1457;4135;659625;298625;958250
2022.05_01-07-2022;Брянская область;75_90_days;SputnikV;4174;2337;6511;659625;298625;958250
2022.05_01-07-2022;Брянская область;90_105_days;AllVaccines;10875;6182;17057;659625;298625;958250
2022.05_01-07-2022;Брянская область;90_105_days;CoviVac;236;56;292;659625;298625;958250
2022.05_01-07-2022;Брянская область;90_105_days;EpiVacCorona;284;160;444;659625;298625;958250
2022.05_01-07-2022;Брянская область;90_105_days;SputnikLite;6405;3412;9817;659625;298625;958250
2022.05_01-07-2022;Брянская область;90_105_days;SputnikV;3950;2554;6504;659625;298625;958250
2022.05_01-07-2022;Владимирская область;105_165_days;AllVaccines;82221;44075;126296;739166;354521;1093687
2022.05_01-07-2022;Владимирская область;105_165_days;CoviVac;938;287;1225;739166;354521;1093687
2022.05_01-07-2022;Владимирская область;105_165_days;EpiVacCorona;5150;3132;8282;739166;354521;1093687
2022.05_01-07-2022;Владимирская область;105_165_days;SputnikLite;28684;20974;49658;739166;354521;1093687
2022.05_01-07-2022;Владимирская область;105_165_days;SputnikV;47449;19682;67131;739166;354521;1093687
2022.05_01-07-2022;Владимирская область;165_195_days;AllVaccines;68057;35375;103432;739166;354521;1093687
2022.05_01-07-2022;Владимирская область;165_195_days;CoviVac;1688;381;2069;739166;354521;1093687
2022.05_01-07-2022;Владимирская область;165_195_days;EpiVacCorona;3340;1661;5001;739166;354521;1093687
2022.05_01-07-2022;Владимирская область;165_195_days;SputnikLite;30645;18923;49568;739166;354521;1093687
2022.05_01-07-2022;Владимирская область;165_195_days;SputnikV;32384;14410;46794;739166;354521;1093687
2022.05_01-07-2022;Владимирская область;21_45_days;AllVaccines;2159;1921;4080;739166;354521;1093687
2022.05_01-07-2022;Владимирская область;21_45_days;CoviVac;102;38;140;739166;354521;1093687
2022.05_01-07-2022;Владимирская область;21_45_days;EpiVacCorona;110;116;226;739166;354521;1093687
2022.05_01-07-2022;Владимирская область;21_45_days;SputnikLite;390;374;764;739166;354521;1093687
2022.05_01-07-2022;Владимирская область;21_45_days;SputnikV;1557;1393;2950;739166;354521;1093687
2022.05_01-07-2022;Владимирская область;45_75_days;AllVaccines;4849;2902;7751;739166;354521;1093687
2022.05_01-07-2022;Владимирская область;45_75_days;CoviVac;133;70;203;739166;354521;1093687
2022.05_01-07-2022;Владимирская область;45_75_days;EpiVacCorona;252;182;434;739166;354521;1093687
2022.05_01-07-2022;Владимирская область;45_75_days;SputnikLite;1185;886;2071;739166;354521;1093687
2022.05_01-07-2022;Владимирская область;45_75_days;SputnikV;3279;1764;5043;739166;354521;1093687
2022.05_01-07-2022;Владимирская область;75_90_days;AllVaccines;6087;3362;9449;739166;354521;1093687
2022.05_01-07-2022;Владимирская область;75_90_days;CoviVac;91;21;112;739166;354521;1093687
2022.05_01-07-2022;Владимирская область;75_90_days;EpiVacCorona;251;92;343;739166;354521;1093687
2022.05_01-07-2022;Владимирская область;75_90_days;SputnikLite;2626;1489;4115;739166;354521;1093687
2022.05_01-07-2022;Владимирская область;75_90_days;SputnikV;3119;1760;4879;739166;354521;1093687
2022.05_01-07-2022;Владимирская область;90_105_days;AllVaccines;7957;4916;12873;739166;354521;1093687
2022.05_01-07-2022;Владимирская область;90_105_days;CoviVac;138;54;192;739166;354521;1093687
2022.05_01-07-2022;Владимирская область;90_105_days;EpiVacCorona;198;190;388;739166;354521;1093687
2022.05_01-07-2022;Владимирская область;90_105_days;SputnikLite;4137;2253;6390;739166;354521;1093687
2022.05_01-07-2022;Владимирская область;90_105_days;SputnikV;3484;2419;5903;739166;354521;1093687
2022.05_01-07-2022;Волгоградская область;105_165_days;AllVaccines;187065;106074;293139;1387837;615020;2002857
2022.05_01-07-2022;Волгоградская область;105_165_days;CoviVac;1273;422;1695;1387837;615020;2002857
2022.05_01-07-2022;Волгоградская область;105_165_days;EpiVacCorona;4374;3827;8201;1387837;615020;2002857
2022.05_01-07-2022;Волгоградская область;105_165_days;SputnikLite;82088;48280;130368;1387837;615020;2002857
2022.05_01-07-2022;Волгоградская область;105_165_days;SputnikV;99330;53545;152875;1387837;615020;2002857
2022.05_01-07-2022;Волгоградская область;165_195_days;AllVaccines;128618;67836;196454;1387837;615020;2002857
2022.05_01-07-2022;Волгоградская область;165_195_days;CoviVac;636;189;825;1387837;615020;2002857
2022.05_01-07-2022;Волгоградская область;165_195_days;EpiVacCorona;3613;1573;5186;1387837;615020;2002857
2022.05_01-07-2022;Волгоградская область;165_195_days;SputnikLite;27030;17604;44634;1387837;615020;2002857
2022.05_01-07-2022;Волгоградская область;165_195_days;SputnikV;97339;48470;145809;1387837;615020;2002857
2022.05_01-07-2022;Волгоградская область;21_45_days;AllVaccines;9981;7220;17201;1387837;615020;2002857
2022.05_01-07-2022;Волгоградская область;21_45_days;CoviVac;767;345;1112;1387837;615020;2002857
2022.05_01-07-2022;Волгоградская область;21_45_days;EpiVacCorona;1050;640;1690;1387837;615020;2002857
2022.05_01-07-2022;Волгоградская область;21_45_days;SputnikLite;1823;1287;3110;1387837;615020;2002857
2022.05_01-07-2022;Волгоградская область;21_45_days;SputnikV;6341;4948;11289;1387837;615020;2002857
2022.05_01-07-2022;Волгоградская область;45_75_days;AllVaccines;18239;9667;27906;1387837;615020;2002857
2022.05_01-07-2022;Волгоградская область;45_75_days;CoviVac;479;138;617;1387837;615020;2002857
2022.05_01-07-2022;Волгоградская область;45_75_days;EpiVacCorona;1407;637;2044;1387837;615020;2002857
2022.05_01-07-2022;Волгоградская область;45_75_days;SputnikLite;6449;3085;9534;1387837;615020;2002857
2022.05_01-07-2022;Волгоградская область;45_75_days;SputnikV;9904;5807;15711;1387837;615020;2002857
2022.05_01-07-2022;Волгоградская область;75_90_days;AllVaccines;23893;11104;34997;1387837;615020;2002857
2022.05_01-07-2022;Волгоградская область;75_90_days;CoviVac;307;81;388;1387837;615020;2002857
2022.05_01-07-2022;Волгоградская область;75_90_days;EpiVacCorona;916;407;1323;1387837;615020;2002857
2022.05_01-07-2022;Волгоградская область;75_90_days;SputnikLite;11535;4429;15964;1387837;615020;2002857
2022.05_01-07-2022;Волгоградская область;75_90_days;SputnikV;11135;6187;17322;1387837;615020;2002857
2022.05_01-07-2022;Волгоградская область;90_105_days;AllVaccines;27287;13277;40564;1387837;615020;2002857
2022.05_01-07-2022;Волгоградская область;90_105_days;CoviVac;523;138;661;1387837;615020;2002857
2022.05_01-07-2022;Волгоградская область;90_105_days;EpiVacCorona;1179;536;1715;1387837;615020;2002857
2022.05_01-07-2022;Волгоградская область;90_105_days;SputnikLite;16503;7036;23539;1387837;615020;2002857
2022.05_01-07-2022;Волгоградская область;90_105_days;SputnikV;9082;5567;14649;1387837;615020;2002857
2022.05_01-07-2022;Вологодская область;105_165_days;AllVaccines;95757;46148;141905;628100;275171;903271
2022.05_01-07-2022;Вологодская область;105_165_days;CoviVac;2503;452;2955;628100;275171;903271
2022.05_01-07-2022;Вологодская область;105_165_days;EpiVacCorona;4043;1590;5633;628100;275171;903271
2022.05_01-07-2022;Вологодская область;105_165_days;SputnikLite;25990;19602;45592;628100;275171;903271
2022.05_01-07-2022;Вологодская область;105_165_days;SputnikV;63221;24504;87725;628100;275171;903271
2022.05_01-07-2022;Вологодская область;165_195_days;AllVaccines;46997;27222;74219;628100;275171;903271
2022.05_01-07-2022;Вологодская область;165_195_days;CoviVac;1581;256;1837;628100;275171;903271
2022.05_01-07-2022;Вологодская область;165_195_days;EpiVacCorona;1883;872;2755;628100;275171;903271
2022.05_01-07-2022;Вологодская область;165_195_days;SputnikLite;13952;8643;22595;628100;275171;903271
2022.05_01-07-2022;Вологодская область;165_195_days;SputnikV;29581;17451;47032;628100;275171;903271
2022.05_01-07-2022;Вологодская область;21_45_days;AllVaccines;3182;2456;5638;628100;275171;903271
2022.05_01-07-2022;Вологодская область;21_45_days;CoviVac;55;15;70;628100;275171;903271
2022.05_01-07-2022;Вологодская область;21_45_days;EpiVacCorona;134;92;226;628100;275171;903271
2022.05_01-07-2022;Вологодская область;21_45_days;SputnikLite;436;302;738;628100;275171;903271
2022.05_01-07-2022;Вологодская область;21_45_days;SputnikV;2557;2047;4604;628100;275171;903271
2022.05_01-07-2022;Вологодская область;45_75_days;AllVaccines;6908;3986;10894;628100;275171;903271
2022.05_01-07-2022;Вологодская область;45_75_days;CoviVac;121;17;138;628100;275171;903271
2022.05_01-07-2022;Вологодская область;45_75_days;EpiVacCorona;230;134;364;628100;275171;903271
2022.05_01-07-2022;Вологодская область;45_75_days;SputnikLite;1499;567;2066;628100;275171;903271
2022.05_01-07-2022;Вологодская область;45_75_days;SputnikV;5058;3268;8326;628100;275171;903271
2022.05_01-07-2022;Вологодская область;75_90_days;AllVaccines;7038;3464;10502;628100;275171;903271
2022.05_01-07-2022;Вологодская область;75_90_days;CoviVac;176;37;213;628100;275171;903271
2022.05_01-07-2022;Вологодская область;75_90_days;EpiVacCorona;259;150;409;628100;275171;903271
2022.05_01-07-2022;Вологодская область;75_90_days;SputnikLite;1640;674;2314;628100;275171;903271
2022.05_01-07-2022;Вологодская область;75_90_days;SputnikV;4963;2603;7566;628100;275171;903271
2022.05_01-07-2022;Вологодская область;90_105_days;AllVaccines;8198;4023;12221;628100;275171;903271
2022.05_01-07-2022;Вологодская область;90_105_days;CoviVac;204;79;283;628100;275171;903271
2022.05_01-07-2022;Вологодская область;90_105_days;EpiVacCorona;394;185;579;628100;275171;903271
2022.05_01-07-2022;Вологодская область;90_105_days;SputnikLite;3042;1290;4332;628100;275171;903271
2022.05_01-07-2022;Вологодская область;90_105_days;SputnikV;4558;2469;7027;628100;275171;903271
2022.05_01-07-2022;Воронежская область;105_165_days;AllVaccines;158016;79500;237516;1293123;602333;1895456
2022.05_01-07-2022;Воронежская область;105_165_days;CoviVac;1152;386;1538;1293123;602333;1895456
2022.05_01-07-2022;Воронежская область;105_165_days;EpiVacCorona;6560;3764;10324;1293123;602333;1895456
2022.05_01-07-2022;Воронежская область;105_165_days;SputnikLite;58822;39809;98631;1293123;602333;1895456
2022.05_01-07-2022;Воронежская область;105_165_days;SputnikV;91482;35541;127023;1293123;602333;1895456
2022.05_01-07-2022;Воронежская область;165_195_days;AllVaccines;168740;63095;231835;1293123;602333;1895456
2022.05_01-07-2022;Воронежская область;165_195_days;CoviVac;996;300;1296;1293123;602333;1895456
2022.05_01-07-2022;Воронежская область;165_195_days;EpiVacCorona;5704;2135;7839;1293123;602333;1895456
2022.05_01-07-2022;Воронежская область;165_195_days;SputnikLite;32917;25503;58420;1293123;602333;1895456
2022.05_01-07-2022;Воронежская область;165_195_days;SputnikV;129123;35157;164280;1293123;602333;1895456
2022.05_01-07-2022;Воронежская область;21_45_days;AllVaccines;9326;8076;17402;1293123;602333;1895456
2022.05_01-07-2022;Воронежская область;21_45_days;CoviVac;390;166;556;1293123;602333;1895456
2022.05_01-07-2022;Воронежская область;21_45_days;EpiVacCorona;1251;1535;2786;1293123;602333;1895456
2022.05_01-07-2022;Воронежская область;21_45_days;SputnikLite;1443;1095;2538;1293123;602333;1895456
2022.05_01-07-2022;Воронежская область;21_45_days;SputnikV;6242;5280;11522;1293123;602333;1895456
2022.05_01-07-2022;Воронежская область;45_75_days;AllVaccines;14053;9398;23451;1293123;602333;1895456
2022.05_01-07-2022;Воронежская область;45_75_days;CoviVac;357;216;573;1293123;602333;1895456
2022.05_01-07-2022;Воронежская область;45_75_days;EpiVacCorona;1157;896;2053;1293123;602333;1895456
2022.05_01-07-2022;Воронежская область;45_75_days;SputnikLite;3870;2751;6621;1293123;602333;1895456
2022.05_01-07-2022;Воронежская область;45_75_days;SputnikV;8669;5535;14204;1293123;602333;1895456
2022.05_01-07-2022;Воронежская область;75_90_days;AllVaccines;15375;8741;24116;1293123;602333;1895456
2022.05_01-07-2022;Воронежская область;75_90_days;CoviVac;172;50;222;1293123;602333;1895456
2022.05_01-07-2022;Воронежская область;75_90_days;EpiVacCorona;611;356;967;1293123;602333;1895456
2022.05_01-07-2022;Воронежская область;75_90_days;SputnikLite;6793;3211;10004;1293123;602333;1895456
2022.05_01-07-2022;Воронежская область;75_90_days;SputnikV;7799;5124;12923;1293123;602333;1895456
2022.05_01-07-2022;Воронежская область;90_105_days;AllVaccines;20944;11029;31973;1293123;602333;1895456
2022.05_01-07-2022;Воронежская область;90_105_days;CoviVac;297;99;396;1293123;602333;1895456
2022.05_01-07-2022;Воронежская область;90_105_days;EpiVacCorona;408;263;671;1293123;602333;1895456
2022.05_01-07-2022;Воронежская область;90_105_days;SputnikLite;12859;5560;18419;1293123;602333;1895456
2022.05_01-07-2022;Воронежская область;90_105_days;SputnikV;7380;5107;12487;1293123;602333;1895456
2022.05_01-07-2022;Еврейская автономная область;105_165_days;AllVaccines;17263;5272;22535;88207;31969;120176
2022.05_01-07-2022;Еврейская автономная область;105_165_days;CoviVac;668;124;792;88207;31969;120176
2022.05_01-07-2022;Еврейская автономная область;105_165_days;EpiVacCorona;1616;400;2016;88207;31969;120176
2022.05_01-07-2022;Еврейская автономная область;105_165_days;SputnikLite;4564;2359;6923;88207;31969;120176
2022.05_01-07-2022;Еврейская автономная область;105_165_days;SputnikV;10415;2389;12804;88207;31969;120176
2022.05_01-07-2022;Еврейская автономная область;165_195_days;AllVaccines;6948;2250;9198;88207;31969;120176
2022.05_01-07-2022;Еврейская автономная область;165_195_days;CoviVac;6;1;7;88207;31969;120176
2022.05_01-07-2022;Еврейская автономная область;165_195_days;EpiVacCorona;1121;157;1278;88207;31969;120176
2022.05_01-07-2022;Еврейская автономная область;165_195_days;SputnikLite;2034;1093;3127;88207;31969;120176
2022.05_01-07-2022;Еврейская автономная область;165_195_days;SputnikV;3787;999;4786;88207;31969;120176
2022.05_01-07-2022;Еврейская автономная область;21_45_days;AllVaccines;548;230;778;88207;31969;120176
2022.05_01-07-2022;Еврейская автономная область;21_45_days;CoviVac;100;13;113;88207;31969;120176
2022.05_01-07-2022;Еврейская автономная область;21_45_days;EpiVacCorona;129;56;185;88207;31969;120176
2022.05_01-07-2022;Еврейская автономная область;21_45_days;SputnikLite;2;2;4;88207;31969;120176
2022.05_01-07-2022;Еврейская автономная область;21_45_days;SputnikV;317;159;476;88207;31969;120176
2022.05_01-07-2022;Еврейская автономная область;45_75_days;AllVaccines;878;275;1153;88207;31969;120176
2022.05_01-07-2022;Еврейская автономная область;45_75_days;CoviVac;33;2;35;88207;31969;120176
2022.05_01-07-2022;Еврейская автономная область;45_75_days;EpiVacCorona;296;85;381;88207;31969;120176
2022.05_01-07-2022;Еврейская автономная область;45_75_days;SputnikLite;160;77;237;88207;31969;120176
2022.05_01-07-2022;Еврейская автономная область;45_75_days;SputnikV;389;111;500;88207;31969;120176
2022.05_01-07-2022;Еврейская автономная область;75_90_days;AllVaccines;2042;600;2642;88207;31969;120176
2022.05_01-07-2022;Еврейская автономная область;75_90_days;CoviVac;98;11;109;88207;31969;120176
2022.05_01-07-2022;Еврейская автономная область;75_90_days;EpiVacCorona;206;69;275;88207;31969;120176
2022.05_01-07-2022;Еврейская автономная область;75_90_days;SputnikLite;993;285;1278;88207;31969;120176
2022.05_01-07-2022;Еврейская автономная область;75_90_days;SputnikV;745;235;980;88207;31969;120176
2022.05_01-07-2022;Еврейская автономная область;90_105_days;AllVaccines;2875;1131;4006;88207;31969;120176
2022.05_01-07-2022;Еврейская автономная область;90_105_days;CoviVac;175;34;209;88207;31969;120176
2022.05_01-07-2022;Еврейская автономная область;90_105_days;EpiVacCorona;317;194;511;88207;31969;120176
2022.05_01-07-2022;Еврейская автономная область;90_105_days;SputnikLite;1801;716;2517;88207;31969;120176
2022.05_01-07-2022;Еврейская автономная область;90_105_days;SputnikV;582;187;769;88207;31969;120176
2022.05_01-07-2022;Забайкальский край;105_165_days;AllVaccines;93918;33855;127773;596322;191826;788148
2022.05_01-07-2022;Забайкальский край;105_165_days;CoviVac;873;86;959;596322;191826;788148
2022.05_01-07-2022;Забайкальский край;105_165_days;EpiVacCorona;7097;2323;9420;596322;191826;788148
2022.05_01-07-2022;Забайкальский край;105_165_days;SputnikLite;35293;13824;49117;596322;191826;788148
2022.05_01-07-2022;Забайкальский край;105_165_days;SputnikV;50655;17622;68277;596322;191826;788148
2022.05_01-07-2022;Забайкальский край;165_195_days;AllVaccines;57401;24635;82036;596322;191826;788148
2022.05_01-07-2022;Забайкальский край;165_195_days;CoviVac;763;75;838;596322;191826;788148
2022.05_01-07-2022;Забайкальский край;165_195_days;EpiVacCorona;1841;669;2510;596322;191826;788148
2022.05_01-07-2022;Забайкальский край;165_195_days;SputnikLite;26555;11709;38264;596322;191826;788148
2022.05_01-07-2022;Забайкальский край;165_195_days;SputnikV;28242;12182;40424;596322;191826;788148
2022.05_01-07-2022;Забайкальский край;21_45_days;AllVaccines;7596;3051;10647;596322;191826;788148
2022.05_01-07-2022;Забайкальский край;21_45_days;CoviVac;776;146;922;596322;191826;788148
2022.05_01-07-2022;Забайкальский край;21_45_days;EpiVacCorona;961;333;1294;596322;191826;788148
2022.05_01-07-2022;Забайкальский край;21_45_days;SputnikLite;685;226;911;596322;191826;788148
2022.05_01-07-2022;Забайкальский край;21_45_days;SputnikV;5174;2346;7520;596322;191826;788148
2022.05_01-07-2022;Забайкальский край;45_75_days;AllVaccines;16360;5121;21481;596322;191826;788148
2022.05_01-07-2022;Забайкальский край;45_75_days;CoviVac;679;94;773;596322;191826;788148
2022.05_01-07-2022;Забайкальский край;45_75_days;EpiVacCorona;2396;622;3018;596322;191826;788148
2022.05_01-07-2022;Забайкальский край;45_75_days;SputnikLite;1632;336;1968;596322;191826;788148
2022.05_01-07-2022;Забайкальский край;45_75_days;SputnikV;11653;4069;15722;596322;191826;788148
2022.05_01-07-2022;Забайкальский край;75_90_days;AllVaccines;13260;3771;17031;596322;191826;788148
2022.05_01-07-2022;Забайкальский край;75_90_days;CoviVac;491;53;544;596322;191826;788148
2022.05_01-07-2022;Забайкальский край;75_90_days;EpiVacCorona;1609;544;2153;596322;191826;788148
2022.05_01-07-2022;Забайкальский край;75_90_days;SputnikLite;2502;387;2889;596322;191826;788148
2022.05_01-07-2022;Забайкальский край;75_90_days;SputnikV;8658;2787;11445;596322;191826;788148
2022.05_01-07-2022;Забайкальский край;90_105_days;AllVaccines;15010;4405;19415;596322;191826;788148
2022.05_01-07-2022;Забайкальский край;90_105_days;CoviVac;332;76;408;596322;191826;788148
2022.05_01-07-2022;Забайкальский край;90_105_days;EpiVacCorona;1451;475;1926;596322;191826;788148
2022.05_01-07-2022;Забайкальский край;90_105_days;SputnikLite;6015;1003;7018;596322;191826;788148
2022.05_01-07-2022;Забайкальский край;90_105_days;SputnikV;7212;2851;10063;596322;191826;788148
2022.05_01-07-2022;Ивановская область;105_165_days;AllVaccines;37231;25934;63165;549803;255947;805750
2022.05_01-07-2022;Ивановская область;105_165_days;CoviVac;523;85;608;549803;255947;805750
2022.05_01-07-2022;Ивановская область;105_165_days;EpiVacCorona;1826;1382;3208;549803;255947;805750
2022.05_01-07-2022;Ивановская область;105_165_days;SputnikLite;19114;13367;32481;549803;255947;805750
2022.05_01-07-2022;Ивановская область;105_165_days;SputnikV;15768;11100;26868;549803;255947;805750
2022.05_01-07-2022;Ивановская область;165_195_days;AllVaccines;31470;25037;56507;549803;255947;805750
2022.05_01-07-2022;Ивановская область;165_195_days;CoviVac;325;68;393;549803;255947;805750
2022.05_01-07-2022;Ивановская область;165_195_days;EpiVacCorona;575;442;1017;549803;255947;805750
2022.05_01-07-2022;Ивановская область;165_195_days;SputnikLite;15428;13525;28953;549803;255947;805750
2022.05_01-07-2022;Ивановская область;165_195_days;SputnikV;15142;11002;26144;549803;255947;805750
2022.05_01-07-2022;Ивановская область;21_45_days;AllVaccines;1649;1704;3353;549803;255947;805750
2022.05_01-07-2022;Ивановская область;21_45_days;CoviVac;75;29;104;549803;255947;805750
2022.05_01-07-2022;Ивановская область;21_45_days;EpiVacCorona;60;78;138;549803;255947;805750
2022.05_01-07-2022;Ивановская область;21_45_days;SputnikLite;530;631;1161;549803;255947;805750
2022.05_01-07-2022;Ивановская область;21_45_days;SputnikV;984;966;1950;549803;255947;805750
2022.05_01-07-2022;Ивановская область;45_75_days;AllVaccines;4593;2971;7564;549803;255947;805750
2022.05_01-07-2022;Ивановская область;45_75_days;CoviVac;127;16;143;549803;255947;805750
2022.05_01-07-2022;Ивановская область;45_75_days;EpiVacCorona;201;114;315;549803;255947;805750
2022.05_01-07-2022;Ивановская область;45_75_days;SputnikLite;1721;1421;3142;549803;255947;805750
2022.05_01-07-2022;Ивановская область;45_75_days;SputnikV;2544;1420;3964;549803;255947;805750
2022.05_01-07-2022;Ивановская область;75_90_days;AllVaccines;5270;2408;7678;549803;255947;805750
2022.05_01-07-2022;Ивановская область;75_90_days;CoviVac;118;22;140;549803;255947;805750
2022.05_01-07-2022;Ивановская область;75_90_days;EpiVacCorona;185;40;225;549803;255947;805750
2022.05_01-07-2022;Ивановская область;75_90_days;SputnikLite;2290;902;3192;549803;255947;805750
2022.05_01-07-2022;Ивановская область;75_90_days;SputnikV;2677;1444;4121;549803;255947;805750
2022.05_01-07-2022;Ивановская область;90_105_days;AllVaccines;7190;3643;10833;549803;255947;805750
2022.05_01-07-2022;Ивановская область;90_105_days;CoviVac;125;17;142;549803;255947;805750
2022.05_01-07-2022;Ивановская область;90_105_days;EpiVacCorona;187;137;324;549803;255947;805750
2022.05_01-07-2022;Ивановская область;90_105_days;SputnikLite;4157;1685;5842;549803;255947;805750
2022.05_01-07-2022;Ивановская область;90_105_days;SputnikV;2721;1804;4525;549803;255947;805750
2022.05_01-07-2022;Иркутская область;105_165_days;AllVaccines;242737;83000;325737;1316761;480655;1797416
2022.05_01-07-2022;Иркутская область;105_165_days;CoviVac;2127;486;2613;1316761;480655;1797416
2022.05_01-07-2022;Иркутская область;105_165_days;EpiVacCorona;4752;1902;6654;1316761;480655;1797416
2022.05_01-07-2022;Иркутская область;105_165_days;SputnikLite;70811;47069;117880;1316761;480655;1797416
2022.05_01-07-2022;Иркутская область;105_165_days;SputnikV;165047;33543;198590;1316761;480655;1797416
2022.05_01-07-2022;Иркутская область;165_195_days;AllVaccines;141947;47516;189463;1316761;480655;1797416
2022.05_01-07-2022;Иркутская область;165_195_days;CoviVac;2363;469;2832;1316761;480655;1797416
2022.05_01-07-2022;Иркутская область;165_195_days;EpiVacCorona;3339;1008;4347;1316761;480655;1797416
2022.05_01-07-2022;Иркутская область;165_195_days;SputnikLite;33126;23691;56817;1316761;480655;1797416
2022.05_01-07-2022;Иркутская область;165_195_days;SputnikV;103119;22348;125467;1316761;480655;1797416
2022.05_01-07-2022;Иркутская область;21_45_days;AllVaccines;6420;3289;9709;1316761;480655;1797416
2022.05_01-07-2022;Иркутская область;21_45_days;CoviVac;207;41;248;1316761;480655;1797416
2022.05_01-07-2022;Иркутская область;21_45_days;EpiVacCorona;474;302;776;1316761;480655;1797416
2022.05_01-07-2022;Иркутская область;21_45_days;SputnikLite;878;370;1248;1316761;480655;1797416
2022.05_01-07-2022;Иркутская область;21_45_days;SputnikV;4861;2576;7437;1316761;480655;1797416
2022.05_01-07-2022;Иркутская область;45_75_days;AllVaccines;14107;5297;19404;1316761;480655;1797416
2022.05_01-07-2022;Иркутская область;45_75_days;CoviVac;329;72;401;1316761;480655;1797416
2022.05_01-07-2022;Иркутская область;45_75_days;EpiVacCorona;604;242;846;1316761;480655;1797416
2022.05_01-07-2022;Иркутская область;45_75_days;SputnikLite;2208;657;2865;1316761;480655;1797416
2022.05_01-07-2022;Иркутская область;45_75_days;SputnikV;10966;4326;15292;1316761;480655;1797416
2022.05_01-07-2022;Иркутская область;75_90_days;AllVaccines;18593;8226;26819;1316761;480655;1797416
2022.05_01-07-2022;Иркутская область;75_90_days;CoviVac;202;129;331;1316761;480655;1797416
2022.05_01-07-2022;Иркутская область;75_90_days;EpiVacCorona;646;760;1406;1316761;480655;1797416
2022.05_01-07-2022;Иркутская область;75_90_days;SputnikLite;6202;2507;8709;1316761;480655;1797416
2022.05_01-07-2022;Иркутская область;75_90_days;SputnikV;11543;4830;16373;1316761;480655;1797416
2022.05_01-07-2022;Иркутская область;90_105_days;AllVaccines;22506;9757;32263;1316761;480655;1797416
2022.05_01-07-2022;Иркутская область;90_105_days;CoviVac;253;99;352;1316761;480655;1797416
2022.05_01-07-2022;Иркутская область;90_105_days;EpiVacCorona;649;330;979;1316761;480655;1797416
2022.05_01-07-2022;Иркутская область;90_105_days;SputnikLite;10926;5292;16218;1316761;480655;1797416
2022.05_01-07-2022;Иркутская область;90_105_days;SputnikV;10678;4036;14714;1316761;480655;1797416
2022.05_01-07-2022;Кабардино-Балкарская Республика;105_165_days;AllVaccines;33678;12311;45989;502388;159241;661629
2022.05_01-07-2022;Кабардино-Балкарская Республика;105_165_days;CoviVac;275;92;367;502388;159241;661629
2022.05_01-07-2022;Кабардино-Балкарская Республика;105_165_days;EpiVacCorona;1757;469;2226;502388;159241;661629
2022.05_01-07-2022;Кабардино-Балкарская Республика;105_165_days;SputnikLite;19719;6932;26651;502388;159241;661629
2022.05_01-07-2022;Кабардино-Балкарская Республика;105_165_days;SputnikV;11927;4818;16745;502388;159241;661629
2022.05_01-07-2022;Кабардино-Балкарская Республика;165_195_days;AllVaccines;32781;9541;42322;502388;159241;661629
2022.05_01-07-2022;Кабардино-Балкарская Республика;165_195_days;CoviVac;158;40;198;502388;159241;661629
2022.05_01-07-2022;Кабардино-Балкарская Республика;165_195_days;EpiVacCorona;581;151;732;502388;159241;661629
2022.05_01-07-2022;Кабардино-Балкарская Республика;165_195_days;SputnikLite;20417;5502;25919;502388;159241;661629
2022.05_01-07-2022;Кабардино-Балкарская Республика;165_195_days;SputnikV;11625;3848;15473;502388;159241;661629
2022.05_01-07-2022;Кабардино-Балкарская Республика;21_45_days;AllVaccines;1784;695;2479;502388;159241;661629
2022.05_01-07-2022;Кабардино-Балкарская Республика;21_45_days;CoviVac;94;41;135;502388;159241;661629
2022.05_01-07-2022;Кабардино-Балкарская Республика;21_45_days;EpiVacCorona;73;15;88;502388;159241;661629
2022.05_01-07-2022;Кабардино-Балкарская Республика;21_45_days;SputnikLite;550;146;696;502388;159241;661629
2022.05_01-07-2022;Кабардино-Балкарская Республика;21_45_days;SputnikV;1067;493;1560;502388;159241;661629
2022.05_01-07-2022;Кабардино-Балкарская Республика;45_75_days;AllVaccines;2929;1324;4253;502388;159241;661629
2022.05_01-07-2022;Кабардино-Балкарская Республика;45_75_days;CoviVac;73;12;85;502388;159241;661629
2022.05_01-07-2022;Кабардино-Балкарская Республика;45_75_days;EpiVacCorona;358;110;468;502388;159241;661629
2022.05_01-07-2022;Кабардино-Балкарская Республика;45_75_days;SputnikLite;713;299;1012;502388;159241;661629
2022.05_01-07-2022;Кабардино-Балкарская Республика;45_75_days;SputnikV;1785;903;2688;502388;159241;661629
2022.05_01-07-2022;Кабардино-Балкарская Республика;75_90_days;AllVaccines;5676;2172;7848;502388;159241;661629
2022.05_01-07-2022;Кабардино-Балкарская Республика;75_90_days;CoviVac;44;8;52;502388;159241;661629
2022.05_01-07-2022;Кабардино-Балкарская Республика;75_90_days;EpiVacCorona;284;107;391;502388;159241;661629
2022.05_01-07-2022;Кабардино-Балкарская Республика;75_90_days;SputnikLite;3063;923;3986;502388;159241;661629
2022.05_01-07-2022;Кабардино-Балкарская Республика;75_90_days;SputnikV;2285;1134;3419;502388;159241;661629
2022.05_01-07-2022;Кабардино-Балкарская Республика;90_105_days;AllVaccines;5507;2329;7836;502388;159241;661629
2022.05_01-07-2022;Кабардино-Балкарская Республика;90_105_days;CoviVac;183;40;223;502388;159241;661629
2022.05_01-07-2022;Кабардино-Балкарская Республика;90_105_days;EpiVacCorona;312;86;398;502388;159241;661629
2022.05_01-07-2022;Кабардино-Балкарская Республика;90_105_days;SputnikLite;2707;912;3619;502388;159241;661629
2022.05_01-07-2022;Кабардино-Балкарская Республика;90_105_days;SputnikV;2305;1291;3596;502388;159241;661629
2022.05_01-07-2022;Калининградская область;105_165_days;AllVaccines;77703;40400;118103;585700;231702;817402
2022.05_01-07-2022;Калининградская область;105_165_days;CoviVac;1390;397;1787;585700;231702;817402
2022.05_01-07-2022;Калининградская область;105_165_days;EpiVacCorona;2333;865;3198;585700;231702;817402
2022.05_01-07-2022;Калининградская область;105_165_days;SputnikLite;26642;20002;46644;585700;231702;817402
2022.05_01-07-2022;Калининградская область;105_165_days;SputnikV;47338;19136;66474;585700;231702;817402
2022.05_01-07-2022;Калининградская область;165_195_days;AllVaccines;59831;28488;88319;585700;231702;817402
2022.05_01-07-2022;Калининградская область;165_195_days;CoviVac;669;146;815;585700;231702;817402
2022.05_01-07-2022;Калининградская область;165_195_days;EpiVacCorona;1871;700;2571;585700;231702;817402
2022.05_01-07-2022;Калининградская область;165_195_days;SputnikLite;11456;10385;21841;585700;231702;817402
2022.05_01-07-2022;Калининградская область;165_195_days;SputnikV;45835;17257;63092;585700;231702;817402
2022.05_01-07-2022;Калининградская область;21_45_days;AllVaccines;3083;2703;5786;585700;231702;817402
2022.05_01-07-2022;Калининградская область;21_45_days;CoviVac;97;45;142;585700;231702;817402
2022.05_01-07-2022;Калининградская область;21_45_days;EpiVacCorona;89;50;139;585700;231702;817402
2022.05_01-07-2022;Калининградская область;21_45_days;SputnikLite;858;832;1690;585700;231702;817402
2022.05_01-07-2022;Калининградская область;21_45_days;SputnikV;2039;1776;3815;585700;231702;817402
2022.05_01-07-2022;Калининградская область;45_75_days;AllVaccines;5996;3548;9544;585700;231702;817402
2022.05_01-07-2022;Калининградская область;45_75_days;CoviVac;113;44;157;585700;231702;817402
2022.05_01-07-2022;Калининградская область;45_75_days;EpiVacCorona;145;89;234;585700;231702;817402
2022.05_01-07-2022;Калининградская область;45_75_days;SputnikLite;1272;958;2230;585700;231702;817402
2022.05_01-07-2022;Калининградская область;45_75_days;SputnikV;4466;2457;6923;585700;231702;817402
2022.05_01-07-2022;Калининградская область;75_90_days;AllVaccines;5670;2520;8190;585700;231702;817402
2022.05_01-07-2022;Калининградская область;75_90_days;CoviVac;95;20;115;585700;231702;817402
2022.05_01-07-2022;Калининградская область;75_90_days;EpiVacCorona;139;70;209;585700;231702;817402
2022.05_01-07-2022;Калининградская область;75_90_days;SputnikLite;1374;588;1962;585700;231702;817402
2022.05_01-07-2022;Калининградская область;75_90_days;SputnikV;4062;1842;5904;585700;231702;817402
2022.05_01-07-2022;Калининградская область;90_105_days;AllVaccines;9791;4872;14663;585700;231702;817402
2022.05_01-07-2022;Калининградская область;90_105_days;CoviVac;130;44;174;585700;231702;817402
2022.05_01-07-2022;Калининградская область;90_105_days;EpiVacCorona;362;165;527;585700;231702;817402
2022.05_01-07-2022;Калининградская область;90_105_days;SputnikLite;4367;2069;6436;585700;231702;817402
2022.05_01-07-2022;Калининградская область;90_105_days;SputnikV;4932;2594;7526;585700;231702;817402
2022.05_01-07-2022;Калужская область;105_165_days;AllVaccines;94480;39506;133986;559789;253023;812812
2022.05_01-07-2022;Калужская область;105_165_days;CoviVac;756;211;967;559789;253023;812812
2022.05_01-07-2022;Калужская область;105_165_days;EpiVacCorona;3363;1348;4711;559789;253023;812812
2022.05_01-07-2022;Калужская область;105_165_days;SputnikLite;24852;18428;43280;559789;253023;812812
2022.05_01-07-2022;Калужская область;105_165_days;SputnikV;65509;19519;85028;559789;253023;812812
2022.05_01-07-2022;Калужская область;165_195_days;AllVaccines;75822;24423;100245;559789;253023;812812
2022.05_01-07-2022;Калужская область;165_195_days;CoviVac;2439;578;3017;559789;253023;812812
2022.05_01-07-2022;Калужская область;165_195_days;EpiVacCorona;3317;1067;4384;559789;253023;812812
2022.05_01-07-2022;Калужская область;165_195_days;SputnikLite;12188;7754;19942;559789;253023;812812
2022.05_01-07-2022;Калужская область;165_195_days;SputnikV;57878;15024;72902;559789;253023;812812
2022.05_01-07-2022;Калужская область;21_45_days;AllVaccines;2551;1726;4277;559789;253023;812812
2022.05_01-07-2022;Калужская область;21_45_days;CoviVac;61;44;105;559789;253023;812812
2022.05_01-07-2022;Калужская область;21_45_days;EpiVacCorona;130;67;197;559789;253023;812812
2022.05_01-07-2022;Калужская область;21_45_days;SputnikLite;542;409;951;559789;253023;812812
2022.05_01-07-2022;Калужская область;21_45_days;SputnikV;1818;1206;3024;559789;253023;812812
2022.05_01-07-2022;Калужская область;45_75_days;AllVaccines;5931;3149;9080;559789;253023;812812
2022.05_01-07-2022;Калужская область;45_75_days;CoviVac;173;57;230;559789;253023;812812
2022.05_01-07-2022;Калужская область;45_75_days;EpiVacCorona;388;172;560;559789;253023;812812
2022.05_01-07-2022;Калужская область;45_75_days;SputnikLite;1274;1071;2345;559789;253023;812812
2022.05_01-07-2022;Калужская область;45_75_days;SputnikV;4096;1849;5945;559789;253023;812812
2022.05_01-07-2022;Калужская область;75_90_days;AllVaccines;5014;2220;7234;559789;253023;812812
2022.05_01-07-2022;Калужская область;75_90_days;CoviVac;85;37;122;559789;253023;812812
2022.05_01-07-2022;Калужская область;75_90_days;EpiVacCorona;175;82;257;559789;253023;812812
2022.05_01-07-2022;Калужская область;75_90_days;SputnikLite;1405;720;2125;559789;253023;812812
2022.05_01-07-2022;Калужская область;75_90_days;SputnikV;3349;1381;4730;559789;253023;812812
2022.05_01-07-2022;Калужская область;90_105_days;AllVaccines;8161;4372;12533;559789;253023;812812
2022.05_01-07-2022;Калужская область;90_105_days;CoviVac;153;54;207;559789;253023;812812
2022.05_01-07-2022;Калужская область;90_105_days;EpiVacCorona;211;112;323;559789;253023;812812
2022.05_01-07-2022;Калужская область;90_105_days;SputnikLite;3682;2160;5842;559789;253023;812812
2022.05_01-07-2022;Калужская область;90_105_days;SputnikV;4115;2046;6161;559789;253023;812812
2022.05_01-07-2022;Камчатский край;105_165_days;AllVaccines;21557;6426;27983;189425;56856;246281
2022.05_01-07-2022;Камчатский край;105_165_days;CoviVac;230;60;290;189425;56856;246281
2022.05_01-07-2022;Камчатский край;105_165_days;EpiVacCorona;618;249;867;189425;56856;246281
2022.05_01-07-2022;Камчатский край;105_165_days;SputnikLite;9844;3769;13613;189425;56856;246281
2022.05_01-07-2022;Камчатский край;105_165_days;SputnikV;10865;2348;13213;189425;56856;246281
2022.05_01-07-2022;Камчатский край;165_195_days;AllVaccines;16756;5272;22028;189425;56856;246281
2022.05_01-07-2022;Камчатский край;165_195_days;CoviVac;221;30;251;189425;56856;246281
2022.05_01-07-2022;Камчатский край;165_195_days;EpiVacCorona;451;123;574;189425;56856;246281
2022.05_01-07-2022;Камчатский край;165_195_days;SputnikLite;9789;3576;13365;189425;56856;246281
2022.05_01-07-2022;Камчатский край;165_195_days;SputnikV;6295;1543;7838;189425;56856;246281
2022.05_01-07-2022;Камчатский край;21_45_days;AllVaccines;1710;456;2166;189425;56856;246281
2022.05_01-07-2022;Камчатский край;21_45_days;CoviVac;20;10;30;189425;56856;246281
2022.05_01-07-2022;Камчатский край;21_45_days;EpiVacCorona;67;17;84;189425;56856;246281
2022.05_01-07-2022;Камчатский край;21_45_days;SputnikLite;447;84;531;189425;56856;246281
2022.05_01-07-2022;Камчатский край;21_45_days;SputnikV;1176;345;1521;189425;56856;246281
2022.05_01-07-2022;Камчатский край;45_75_days;AllVaccines;3111;953;4064;189425;56856;246281
2022.05_01-07-2022;Камчатский край;45_75_days;CoviVac;62;12;74;189425;56856;246281
2022.05_01-07-2022;Камчатский край;45_75_days;EpiVacCorona;326;104;430;189425;56856;246281
2022.05_01-07-2022;Камчатский край;45_75_days;SputnikLite;563;192;755;189425;56856;246281
2022.05_01-07-2022;Камчатский край;45_75_days;SputnikV;2160;645;2805;189425;56856;246281
2022.05_01-07-2022;Камчатский край;75_90_days;AllVaccines;2430;562;2992;189425;56856;246281
2022.05_01-07-2022;Камчатский край;75_90_days;CoviVac;19;3;22;189425;56856;246281
2022.05_01-07-2022;Камчатский край;75_90_days;EpiVacCorona;163;35;198;189425;56856;246281
2022.05_01-07-2022;Камчатский край;75_90_days;SputnikLite;696;139;835;189425;56856;246281
2022.05_01-07-2022;Камчатский край;75_90_days;SputnikV;1552;385;1937;189425;56856;246281
2022.05_01-07-2022;Камчатский край;90_105_days;AllVaccines;2059;646;2705;189425;56856;246281
2022.05_01-07-2022;Камчатский край;90_105_days;CoviVac;26;2;28;189425;56856;246281
2022.05_01-07-2022;Камчатский край;90_105_days;EpiVacCorona;103;48;151;189425;56856;246281
2022.05_01-07-2022;Камчатский край;90_105_days;SputnikLite;931;332;1263;189425;56856;246281
2022.05_01-07-2022;Камчатский край;90_105_days;SputnikV;999;264;1263;189425;56856;246281
2022.05_01-07-2022;Карачаево-Черкесская Республика;105_165_days;AllVaccines;22888;7801;30689;266261;94005;360266
2022.05_01-07-2022;Карачаево-Черкесская Республика;105_165_days;CoviVac;258;85;343;266261;94005;360266
2022.05_01-07-2022;Карачаево-Черкесская Республика;105_165_days;EpiVacCorona;735;206;941;266261;94005;360266
2022.05_01-07-2022;Карачаево-Черкесская Республика;105_165_days;SputnikLite;13680;4715;18395;266261;94005;360266
2022.05_01-07-2022;Карачаево-Черкесская Республика;105_165_days;SputnikV;8215;2795;11010;266261;94005;360266
2022.05_01-07-2022;Карачаево-Черкесская Республика;165_195_days;AllVaccines;15070;5640;20710;266261;94005;360266
2022.05_01-07-2022;Карачаево-Черкесская Республика;165_195_days;CoviVac;38;15;53;266261;94005;360266
2022.05_01-07-2022;Карачаево-Черкесская Республика;165_195_days;EpiVacCorona;94;33;127;266261;94005;360266
2022.05_01-07-2022;Карачаево-Черкесская Республика;165_195_days;SputnikLite;10537;3370;13907;266261;94005;360266
2022.05_01-07-2022;Карачаево-Черкесская Республика;165_195_days;SputnikV;4401;2222;6623;266261;94005;360266
2022.05_01-07-2022;Карачаево-Черкесская Республика;21_45_days;AllVaccines;4768;2273;7041;266261;94005;360266
2022.05_01-07-2022;Карачаево-Черкесская Республика;21_45_days;CoviVac;504;139;643;266261;94005;360266
2022.05_01-07-2022;Карачаево-Черкесская Республика;21_45_days;EpiVacCorona;1112;673;1785;266261;94005;360266
2022.05_01-07-2022;Карачаево-Черкесская Республика;21_45_days;SputnikLite;771;358;1129;266261;94005;360266
2022.05_01-07-2022;Карачаево-Черкесская Республика;21_45_days;SputnikV;2381;1103;3484;266261;94005;360266
2022.05_01-07-2022;Карачаево-Черкесская Республика;45_75_days;AllVaccines;5669;1890;7559;266261;94005;360266
2022.05_01-07-2022;Карачаево-Черкесская Республика;45_75_days;CoviVac;312;106;418;266261;94005;360266
2022.05_01-07-2022;Карачаево-Черкесская Республика;45_75_days;EpiVacCorona;839;242;1081;266261;94005;360266
2022.05_01-07-2022;Карачаево-Черкесская Республика;45_75_days;SputnikLite;1468;555;2023;266261;94005;360266
2022.05_01-07-2022;Карачаево-Черкесская Республика;45_75_days;SputnikV;3050;987;4037;266261;94005;360266
2022.05_01-07-2022;Карачаево-Черкесская Республика;75_90_days;AllVaccines;5119;2128;7247;266261;94005;360266
2022.05_01-07-2022;Карачаево-Черкесская Республика;75_90_days;CoviVac;17;4;21;266261;94005;360266
2022.05_01-07-2022;Карачаево-Черкесская Республика;75_90_days;EpiVacCorona;397;112;509;266261;94005;360266
2022.05_01-07-2022;Карачаево-Черкесская Республика;75_90_days;SputnikLite;948;310;1258;266261;94005;360266
2022.05_01-07-2022;Карачаево-Черкесская Республика;75_90_days;SputnikV;3757;1702;5459;266261;94005;360266
2022.05_01-07-2022;Карачаево-Черкесская Республика;90_105_days;AllVaccines;2373;964;3337;266261;94005;360266
2022.05_01-07-2022;Карачаево-Черкесская Республика;90_105_days;CoviVac;42;25;67;266261;94005;360266
2022.05_01-07-2022;Карачаево-Черкесская Республика;90_105_days;EpiVacCorona;283;61;344;266261;94005;360266
2022.05_01-07-2022;Карачаево-Черкесская Республика;90_105_days;SputnikLite;1077;405;1482;266261;94005;360266
2022.05_01-07-2022;Карачаево-Черкесская Республика;90_105_days;SputnikV;971;473;1444;266261;94005;360266
2022.05_01-07-2022;Кемеровская область;105_165_days;AllVaccines;214932;92033;306965;1453976;610256;2064232
2022.05_01-07-2022;Кемеровская область;105_165_days;CoviVac;2012;437;2449;1453976;610256;2064232
2022.05_01-07-2022;Кемеровская область;105_165_days;EpiVacCorona;10715;5188;15903;1453976;610256;2064232
2022.05_01-07-2022;Кемеровская область;105_165_days;SputnikLite;68447;41157;109604;1453976;610256;2064232
2022.05_01-07-2022;Кемеровская область;105_165_days;SputnikV;133758;45251;179009;1453976;610256;2064232
2022.05_01-07-2022;Кемеровская область;165_195_days;AllVaccines;74497;45087;119584;1453976;610256;2064232
2022.05_01-07-2022;Кемеровская область;165_195_days;CoviVac;1354;242;1596;1453976;610256;2064232
2022.05_01-07-2022;Кемеровская область;165_195_days;EpiVacCorona;3190;1758;4948;1453976;610256;2064232
2022.05_01-07-2022;Кемеровская область;165_195_days;SputnikLite;22700;20594;43294;1453976;610256;2064232
2022.05_01-07-2022;Кемеровская область;165_195_days;SputnikV;47253;22493;69746;1453976;610256;2064232
2022.05_01-07-2022;Кемеровская область;21_45_days;AllVaccines;7617;3325;10942;1453976;610256;2064232
2022.05_01-07-2022;Кемеровская область;21_45_days;CoviVac;299;49;348;1453976;610256;2064232
2022.05_01-07-2022;Кемеровская область;21_45_days;EpiVacCorona;777;308;1085;1453976;610256;2064232
2022.05_01-07-2022;Кемеровская область;21_45_days;SputnikLite;338;193;531;1453976;610256;2064232
2022.05_01-07-2022;Кемеровская область;21_45_days;SputnikV;6203;2775;8978;1453976;610256;2064232
2022.05_01-07-2022;Кемеровская область;45_75_days;AllVaccines;16891;5891;22782;1453976;610256;2064232
2022.05_01-07-2022;Кемеровская область;45_75_days;CoviVac;423;136;559;1453976;610256;2064232
2022.05_01-07-2022;Кемеровская область;45_75_days;EpiVacCorona;1051;497;1548;1453976;610256;2064232
2022.05_01-07-2022;Кемеровская область;45_75_days;SputnikLite;2786;975;3761;1453976;610256;2064232
2022.05_01-07-2022;Кемеровская область;45_75_days;SputnikV;12631;4283;16914;1453976;610256;2064232
2022.05_01-07-2022;Кемеровская область;75_90_days;AllVaccines;33484;12482;45966;1453976;610256;2064232
2022.05_01-07-2022;Кемеровская область;75_90_days;CoviVac;291;73;364;1453976;610256;2064232
2022.05_01-07-2022;Кемеровская область;75_90_days;EpiVacCorona;970;560;1530;1453976;610256;2064232
2022.05_01-07-2022;Кемеровская область;75_90_days;SputnikLite;13731;4671;18402;1453976;610256;2064232
2022.05_01-07-2022;Кемеровская область;75_90_days;SputnikV;18492;7178;25670;1453976;610256;2064232
2022.05_01-07-2022;Кемеровская область;90_105_days;AllVaccines;37620;15285;52905;1453976;610256;2064232
2022.05_01-07-2022;Кемеровская область;90_105_days;CoviVac;392;105;497;1453976;610256;2064232
2022.05_01-07-2022;Кемеровская область;90_105_days;EpiVacCorona;1885;994;2879;1453976;610256;2064232
2022.05_01-07-2022;Кемеровская область;90_105_days;SputnikLite;19697;7505;27202;1453976;610256;2064232
2022.05_01-07-2022;Кемеровская область;90_105_days;SputnikV;15646;6681;22327;1453976;610256;2064232
2022.05_01-07-2022;Кировская область;105_165_days;AllVaccines;101542;62699;164241;663621;334585;998206
2022.05_01-07-2022;Кировская область;105_165_days;CoviVac;1753;289;2042;663621;334585;998206
2022.05_01-07-2022;Кировская область;105_165_days;EpiVacCorona;4863;2143;7006;663621;334585;998206
2022.05_01-07-2022;Кировская область;105_165_days;SputnikLite;44653;29831;74484;663621;334585;998206
2022.05_01-07-2022;Кировская область;105_165_days;SputnikV;50273;30436;80709;663621;334585;998206
2022.05_01-07-2022;Кировская область;165_195_days;AllVaccines;88531;46650;135181;663621;334585;998206
2022.05_01-07-2022;Кировская область;165_195_days;CoviVac;2862;294;3156;663621;334585;998206
2022.05_01-07-2022;Кировская область;165_195_days;EpiVacCorona;3883;1401;5284;663621;334585;998206
2022.05_01-07-2022;Кировская область;165_195_days;SputnikLite;35221;21762;56983;663621;334585;998206
2022.05_01-07-2022;Кировская область;165_195_days;SputnikV;46565;23193;69758;663621;334585;998206
2022.05_01-07-2022;Кировская область;21_45_days;AllVaccines;3314;3349;6663;663621;334585;998206
2022.05_01-07-2022;Кировская область;21_45_days;CoviVac;57;20;77;663621;334585;998206
2022.05_01-07-2022;Кировская область;21_45_days;EpiVacCorona;211;140;351;663621;334585;998206
2022.05_01-07-2022;Кировская область;21_45_days;SputnikLite;1275;956;2231;663621;334585;998206
2022.05_01-07-2022;Кировская область;21_45_days;SputnikV;1771;2233;4004;663621;334585;998206
2022.05_01-07-2022;Кировская область;45_75_days;AllVaccines;6682;5922;12604;663621;334585;998206
2022.05_01-07-2022;Кировская область;45_75_days;CoviVac;73;10;83;663621;334585;998206
2022.05_01-07-2022;Кировская область;45_75_days;EpiVacCorona;167;88;255;663621;334585;998206
2022.05_01-07-2022;Кировская область;45_75_days;SputnikLite;3165;2815;5980;663621;334585;998206
2022.05_01-07-2022;Кировская область;45_75_days;SputnikV;3277;3009;6286;663621;334585;998206
2022.05_01-07-2022;Кировская область;75_90_days;AllVaccines;7705;5343;13048;663621;334585;998206
2022.05_01-07-2022;Кировская область;75_90_days;CoviVac;112;21;133;663621;334585;998206
2022.05_01-07-2022;Кировская область;75_90_days;EpiVacCorona;161;90;251;663621;334585;998206
2022.05_01-07-2022;Кировская область;75_90_days;SputnikLite;3720;2071;5791;663621;334585;998206
2022.05_01-07-2022;Кировская область;75_90_days;SputnikV;3712;3161;6873;663621;334585;998206
2022.05_01-07-2022;Кировская область;90_105_days;AllVaccines;11500;6996;18496;663621;334585;998206
2022.05_01-07-2022;Кировская область;90_105_days;CoviVac;236;31;267;663621;334585;998206
2022.05_01-07-2022;Кировская область;90_105_days;EpiVacCorona;305;171;476;663621;334585;998206
2022.05_01-07-2022;Кировская область;90_105_days;SputnikLite;7509;3688;11197;663621;334585;998206
2022.05_01-07-2022;Кировская область;90_105_days;SputnikV;3450;3106;6556;663621;334585;998206
2022.05_01-07-2022;Костромская область;105_165_days;AllVaccines;39050;20966;60016;339046;160543;499589
2022.05_01-07-2022;Костромская область;105_165_days;CoviVac;517;138;655;339046;160543;499589
2022.05_01-07-2022;Костромская область;105_165_days;EpiVacCorona;4659;1838;6497;339046;160543;499589
2022.05_01-07-2022;Костромская область;105_165_days;SputnikLite;17454;10312;27766;339046;160543;499589
2022.05_01-07-2022;Костромская область;105_165_days;SputnikV;16420;8678;25098;339046;160543;499589
2022.05_01-07-2022;Костромская область;165_195_days;AllVaccines;36648;18498;55146;339046;160543;499589
2022.05_01-07-2022;Костромская область;165_195_days;CoviVac;815;231;1046;339046;160543;499589
2022.05_01-07-2022;Костромская область;165_195_days;EpiVacCorona;1059;521;1580;339046;160543;499589
2022.05_01-07-2022;Костромская область;165_195_days;SputnikLite;22442;10304;32746;339046;160543;499589
2022.05_01-07-2022;Костромская область;165_195_days;SputnikV;12332;7442;19774;339046;160543;499589
2022.05_01-07-2022;Костромская область;21_45_days;AllVaccines;1314;1113;2427;339046;160543;499589
2022.05_01-07-2022;Костромская область;21_45_days;CoviVac;83;26;109;339046;160543;499589
2022.05_01-07-2022;Костромская область;21_45_days;EpiVacCorona;218;178;396;339046;160543;499589
2022.05_01-07-2022;Костромская область;21_45_days;SputnikLite;40;46;86;339046;160543;499589
2022.05_01-07-2022;Костромская область;21_45_days;SputnikV;973;863;1836;339046;160543;499589
2022.05_01-07-2022;Костромская область;45_75_days;AllVaccines;3140;1842;4982;339046;160543;499589
2022.05_01-07-2022;Костромская область;45_75_days;CoviVac;143;35;178;339046;160543;499589
2022.05_01-07-2022;Костромская область;45_75_days;EpiVacCorona;434;250;684;339046;160543;499589
2022.05_01-07-2022;Костромская область;45_75_days;SputnikLite;361;233;594;339046;160543;499589
2022.05_01-07-2022;Костромская область;45_75_days;SputnikV;2202;1324;3526;339046;160543;499589
2022.05_01-07-2022;Костромская область;75_90_days;AllVaccines;4563;2589;7152;339046;160543;499589
2022.05_01-07-2022;Костромская область;75_90_days;CoviVac;110;45;155;339046;160543;499589
2022.05_01-07-2022;Костромская область;75_90_days;EpiVacCorona;365;199;564;339046;160543;499589
2022.05_01-07-2022;Костромская область;75_90_days;SputnikLite;1352;627;1979;339046;160543;499589
2022.05_01-07-2022;Костромская область;75_90_days;SputnikV;2736;1718;4454;339046;160543;499589
2022.05_01-07-2022;Костромская область;90_105_days;AllVaccines;6816;3679;10495;339046;160543;499589
2022.05_01-07-2022;Костромская область;90_105_days;CoviVac;298;115;413;339046;160543;499589
2022.05_01-07-2022;Костромская область;90_105_days;EpiVacCorona;329;179;508;339046;160543;499589
2022.05_01-07-2022;Костромская область;90_105_days;SputnikLite;3900;1880;5780;339046;160543;499589
2022.05_01-07-2022;Костромская область;90_105_days;SputnikV;2289;1505;3794;339046;160543;499589
2022.05_01-07-2022;Краснодарский край;105_165_days;AllVaccines;470971;229418;700389;3157155;1334085;4491240
2022.05_01-07-2022;Краснодарский край;105_165_days;CoviVac;3078;1014;4092;3157155;1334085;4491240
2022.05_01-07-2022;Краснодарский край;105_165_days;EpiVacCorona;8468;4538;13006;3157155;1334085;4491240
2022.05_01-07-2022;Краснодарский край;105_165_days;SputnikLite;115648;83393;199041;3157155;1334085;4491240
2022.05_01-07-2022;Краснодарский край;105_165_days;SputnikV;343777;140473;484250;3157155;1334085;4491240
2022.05_01-07-2022;Краснодарский край;165_195_days;AllVaccines;249533;120686;370219;3157155;1334085;4491240
2022.05_01-07-2022;Краснодарский край;165_195_days;CoviVac;3638;1131;4769;3157155;1334085;4491240
2022.05_01-07-2022;Краснодарский край;165_195_days;EpiVacCorona;4975;2740;7715;3157155;1334085;4491240
2022.05_01-07-2022;Краснодарский край;165_195_days;SputnikLite;39520;41806;81326;3157155;1334085;4491240
2022.05_01-07-2022;Краснодарский край;165_195_days;SputnikV;201400;75009;276409;3157155;1334085;4491240
2022.05_01-07-2022;Краснодарский край;21_45_days;AllVaccines;25225;27815;53040;3157155;1334085;4491240
2022.05_01-07-2022;Краснодарский край;21_45_days;CoviVac;775;451;1226;3157155;1334085;4491240
2022.05_01-07-2022;Краснодарский край;21_45_days;EpiVacCorona;1786;1657;3443;3157155;1334085;4491240
2022.05_01-07-2022;Краснодарский край;21_45_days;SputnikLite;1672;1202;2874;3157155;1334085;4491240
2022.05_01-07-2022;Краснодарский край;21_45_days;SputnikV;20992;24505;45497;3157155;1334085;4491240
2022.05_01-07-2022;Краснодарский край;45_75_days;AllVaccines;59011;58919;117930;3157155;1334085;4491240
2022.05_01-07-2022;Краснодарский край;45_75_days;CoviVac;424;157;581;3157155;1334085;4491240
2022.05_01-07-2022;Краснодарский край;45_75_days;EpiVacCorona;7739;6835;14574;3157155;1334085;4491240
2022.05_01-07-2022;Краснодарский край;45_75_days;SputnikLite;4920;3798;8718;3157155;1334085;4491240
2022.05_01-07-2022;Краснодарский край;45_75_days;SputnikV;45928;48129;94057;3157155;1334085;4491240
2022.05_01-07-2022;Краснодарский край;75_90_days;AllVaccines;46083;30641;76724;3157155;1334085;4491240
2022.05_01-07-2022;Краснодарский край;75_90_days;CoviVac;416;90;506;3157155;1334085;4491240
2022.05_01-07-2022;Краснодарский край;75_90_days;EpiVacCorona;2277;1541;3818;3157155;1334085;4491240
2022.05_01-07-2022;Краснодарский край;75_90_days;SputnikLite;7208;3190;10398;3157155;1334085;4491240
2022.05_01-07-2022;Краснодарский край;75_90_days;SputnikV;36182;25820;62002;3157155;1334085;4491240
2022.05_01-07-2022;Краснодарский край;90_105_days;AllVaccines;55503;32258;87761;3157155;1334085;4491240
2022.05_01-07-2022;Краснодарский край;90_105_days;CoviVac;625;211;836;3157155;1334085;4491240
2022.05_01-07-2022;Краснодарский край;90_105_days;EpiVacCorona;1672;2375;4047;3157155;1334085;4491240
2022.05_01-07-2022;Краснодарский край;90_105_days;SputnikLite;19304;7111;26415;3157155;1334085;4491240
2022.05_01-07-2022;Краснодарский край;90_105_days;SputnikV;33902;22561;56463;3157155;1334085;4491240
2022.05_01-07-2022;Красноярский край;105_165_days;AllVaccines;261216;102521;363737;1637377;585822;2223199
2022.05_01-07-2022;Красноярский край;105_165_days;CoviVac;2847;704;3551;1637377;585822;2223199
2022.05_01-07-2022;Красноярский край;105_165_days;EpiVacCorona;10459;5526;15985;1637377;585822;2223199
2022.05_01-07-2022;Красноярский край;105_165_days;SputnikLite;92065;47734;139799;1637377;585822;2223199
2022.05_01-07-2022;Красноярский край;105_165_days;SputnikV;155845;48557;204402;1637377;585822;2223199
2022.05_01-07-2022;Красноярский край;165_195_days;AllVaccines;117992;50395;168387;1637377;585822;2223199
2022.05_01-07-2022;Красноярский край;165_195_days;CoviVac;2026;466;2492;1637377;585822;2223199
2022.05_01-07-2022;Красноярский край;165_195_days;EpiVacCorona;4763;2534;7297;1637377;585822;2223199
2022.05_01-07-2022;Красноярский край;165_195_days;SputnikLite;42947;19505;62452;1637377;585822;2223199
2022.05_01-07-2022;Красноярский край;165_195_days;SputnikV;68256;27890;96146;1637377;585822;2223199
2022.05_01-07-2022;Красноярский край;21_45_days;AllVaccines;15877;6656;22533;1637377;585822;2223199
2022.05_01-07-2022;Красноярский край;21_45_days;CoviVac;605;244;849;1637377;585822;2223199
2022.05_01-07-2022;Красноярский край;21_45_days;EpiVacCorona;1011;604;1615;1637377;585822;2223199
2022.05_01-07-2022;Красноярский край;21_45_days;SputnikLite;3977;485;4462;1637377;585822;2223199
2022.05_01-07-2022;Красноярский край;21_45_days;SputnikV;10284;5323;15607;1637377;585822;2223199
2022.05_01-07-2022;Красноярский край;45_75_days;AllVaccines;26655;9265;35920;1637377;585822;2223199
2022.05_01-07-2022;Красноярский край;45_75_days;CoviVac;612;353;965;1637377;585822;2223199
2022.05_01-07-2022;Красноярский край;45_75_days;EpiVacCorona;1331;656;1987;1637377;585822;2223199
2022.05_01-07-2022;Красноярский край;45_75_days;SputnikLite;5374;997;6371;1637377;585822;2223199
2022.05_01-07-2022;Красноярский край;45_75_days;SputnikV;19338;7259;26597;1637377;585822;2223199
2022.05_01-07-2022;Красноярский край;75_90_days;AllVaccines;36537;13110;49647;1637377;585822;2223199
2022.05_01-07-2022;Красноярский край;75_90_days;CoviVac;505;192;697;1637377;585822;2223199
2022.05_01-07-2022;Красноярский край;75_90_days;EpiVacCorona;935;557;1492;1637377;585822;2223199
2022.05_01-07-2022;Красноярский край;75_90_days;SputnikLite;16088;4735;20823;1637377;585822;2223199
2022.05_01-07-2022;Красноярский край;75_90_days;SputnikV;19009;7626;26635;1637377;585822;2223199
2022.05_01-07-2022;Красноярский край;90_105_days;AllVaccines;40966;16072;57038;1637377;585822;2223199
2022.05_01-07-2022;Красноярский край;90_105_days;CoviVac;669;282;951;1637377;585822;2223199
2022.05_01-07-2022;Красноярский край;90_105_days;EpiVacCorona;1156;789;1945;1637377;585822;2223199
2022.05_01-07-2022;Красноярский край;90_105_days;SputnikLite;21692;7709;29401;1637377;585822;2223199
2022.05_01-07-2022;Красноярский край;90_105_days;SputnikV;17449;7292;24741;1637377;585822;2223199
2022.05_01-07-2022;Курганская область;105_165_days;AllVaccines;59972;37322;97294;425081;217502;642583
2022.05_01-07-2022;Курганская область;105_165_days;CoviVac;823;287;1110;425081;217502;642583
2022.05_01-07-2022;Курганская область;105_165_days;EpiVacCorona;1923;1327;3250;425081;217502;642583
2022.05_01-07-2022;Курганская область;105_165_days;SputnikLite;26357;21523;47880;425081;217502;642583
2022.05_01-07-2022;Курганская область;105_165_days;SputnikV;30869;14185;45054;425081;217502;642583
2022.05_01-07-2022;Курганская область;165_195_days;AllVaccines;71456;30357;101813;425081;217502;642583
2022.05_01-07-2022;Курганская область;165_195_days;CoviVac;1177;364;1541;425081;217502;642583
2022.05_01-07-2022;Курганская область;165_195_days;EpiVacCorona;759;296;1055;425081;217502;642583
2022.05_01-07-2022;Курганская область;165_195_days;SputnikLite;12571;14036;26607;425081;217502;642583
2022.05_01-07-2022;Курганская область;165_195_days;SputnikV;56949;15661;72610;425081;217502;642583
2022.05_01-07-2022;Курганская область;21_45_days;AllVaccines;2645;2184;4829;425081;217502;642583
2022.05_01-07-2022;Курганская область;21_45_days;CoviVac;48;93;141;425081;217502;642583
2022.05_01-07-2022;Курганская область;21_45_days;EpiVacCorona;316;285;601;425081;217502;642583
2022.05_01-07-2022;Курганская область;21_45_days;SputnikLite;586;295;881;425081;217502;642583
2022.05_01-07-2022;Курганская область;21_45_days;SputnikV;1695;1511;3206;425081;217502;642583
2022.05_01-07-2022;Курганская область;45_75_days;AllVaccines;6187;4151;10338;425081;217502;642583
2022.05_01-07-2022;Курганская область;45_75_days;CoviVac;77;15;92;425081;217502;642583
2022.05_01-07-2022;Курганская область;45_75_days;EpiVacCorona;751;513;1264;425081;217502;642583
2022.05_01-07-2022;Курганская область;45_75_days;SputnikLite;2805;1810;4615;425081;217502;642583
2022.05_01-07-2022;Курганская область;45_75_days;SputnikV;2554;1813;4367;425081;217502;642583
2022.05_01-07-2022;Курганская область;75_90_days;AllVaccines;8045;5070;13115;425081;217502;642583
2022.05_01-07-2022;Курганская область;75_90_days;CoviVac;105;25;130;425081;217502;642583
2022.05_01-07-2022;Курганская область;75_90_days;EpiVacCorona;504;419;923;425081;217502;642583
2022.05_01-07-2022;Курганская область;75_90_days;SputnikLite;3840;2251;6091;425081;217502;642583
2022.05_01-07-2022;Курганская область;75_90_days;SputnikV;3596;2375;5971;425081;217502;642583
2022.05_01-07-2022;Курганская область;90_105_days;AllVaccines;15447;8880;24327;425081;217502;642583
2022.05_01-07-2022;Курганская область;90_105_days;CoviVac;88;25;113;425081;217502;642583
2022.05_01-07-2022;Курганская область;90_105_days;EpiVacCorona;861;578;1439;425081;217502;642583
2022.05_01-07-2022;Курганская область;90_105_days;SputnikLite;11243;6018;17261;425081;217502;642583
2022.05_01-07-2022;Курганская область;90_105_days;SputnikV;3255;2259;5514;425081;217502;642583
2022.05_01-07-2022;Курская область;105_165_days;AllVaccines;77238;38637;115875;604409;285634;890043
2022.05_01-07-2022;Курская область;105_165_days;CoviVac;2117;496;2613;604409;285634;890043
2022.05_01-07-2022;Курская область;105_165_days;EpiVacCorona;4800;2374;7174;604409;285634;890043
2022.05_01-07-2022;Курская область;105_165_days;SputnikLite;37119;19565;56684;604409;285634;890043
2022.05_01-07-2022;Курская область;105_165_days;SputnikV;33202;16202;49404;604409;285634;890043
2022.05_01-07-2022;Курская область;165_195_days;AllVaccines;62539;35502;98041;604409;285634;890043
2022.05_01-07-2022;Курская область;165_195_days;CoviVac;878;195;1073;604409;285634;890043
2022.05_01-07-2022;Курская область;165_195_days;EpiVacCorona;2499;1137;3636;604409;285634;890043
2022.05_01-07-2022;Курская область;165_195_days;SputnikLite;23474;18844;42318;604409;285634;890043
2022.05_01-07-2022;Курская область;165_195_days;SputnikV;35688;15326;51014;604409;285634;890043
2022.05_01-07-2022;Курская область;21_45_days;AllVaccines;6088;2917;9005;604409;285634;890043
2022.05_01-07-2022;Курская область;21_45_days;CoviVac;214;25;239;604409;285634;890043
2022.05_01-07-2022;Курская область;21_45_days;EpiVacCorona;416;212;628;604409;285634;890043
2022.05_01-07-2022;Курская область;21_45_days;SputnikLite;1366;338;1704;604409;285634;890043
2022.05_01-07-2022;Курская область;21_45_days;SputnikV;4092;2342;6434;604409;285634;890043
2022.05_01-07-2022;Курская область;45_75_days;AllVaccines;9638;3510;13148;604409;285634;890043
2022.05_01-07-2022;Курская область;45_75_days;CoviVac;508;104;612;604409;285634;890043
2022.05_01-07-2022;Курская область;45_75_days;EpiVacCorona;648;240;888;604409;285634;890043
2022.05_01-07-2022;Курская область;45_75_days;SputnikLite;2544;704;3248;604409;285634;890043
2022.05_01-07-2022;Курская область;45_75_days;SputnikV;5938;2462;8400;604409;285634;890043
2022.05_01-07-2022;Курская область;75_90_days;AllVaccines;9824;3820;13644;604409;285634;890043
2022.05_01-07-2022;Курская область;75_90_days;CoviVac;197;36;233;604409;285634;890043
2022.05_01-07-2022;Курская область;75_90_days;EpiVacCorona;610;240;850;604409;285634;890043
2022.05_01-07-2022;Курская область;75_90_days;SputnikLite;5438;1844;7282;604409;285634;890043
2022.05_01-07-2022;Курская область;75_90_days;SputnikV;3579;1700;5279;604409;285634;890043
2022.05_01-07-2022;Курская область;90_105_days;AllVaccines;13978;5424;19402;604409;285634;890043
2022.05_01-07-2022;Курская область;90_105_days;CoviVac;305;62;367;604409;285634;890043
2022.05_01-07-2022;Курская область;90_105_days;EpiVacCorona;666;368;1034;604409;285634;890043
2022.05_01-07-2022;Курская область;90_105_days;SputnikLite;9968;3419;13387;604409;285634;890043
2022.05_01-07-2022;Курская область;90_105_days;SputnikV;3039;1575;4614;604409;285634;890043
2022.05_01-07-2022;Ленинградская область;105_165_days;AllVaccines;135188;71026;206214;1100343;462742;1563085
2022.05_01-07-2022;Ленинградская область;105_165_days;CoviVac;1486;231;1717;1100343;462742;1563085
2022.05_01-07-2022;Ленинградская область;105_165_days;EpiVacCorona;3387;2014;5401;1100343;462742;1563085
2022.05_01-07-2022;Ленинградская область;105_165_days;SputnikLite;39307;31684;70991;1100343;462742;1563085
2022.05_01-07-2022;Ленинградская область;105_165_days;SputnikV;91008;37097;128105;1100343;462742;1563085
2022.05_01-07-2022;Ленинградская область;165_195_days;AllVaccines;86771;41308;128079;1100343;462742;1563085
2022.05_01-07-2022;Ленинградская область;165_195_days;CoviVac;1384;212;1596;1100343;462742;1563085
2022.05_01-07-2022;Ленинградская область;165_195_days;EpiVacCorona;1930;882;2812;1100343;462742;1563085
2022.05_01-07-2022;Ленинградская область;165_195_days;SputnikLite;26536;16736;43272;1100343;462742;1563085
2022.05_01-07-2022;Ленинградская область;165_195_days;SputnikV;56921;23478;80399;1100343;462742;1563085
2022.05_01-07-2022;Ленинградская область;21_45_days;AllVaccines;4399;3129;7528;1100343;462742;1563085
2022.05_01-07-2022;Ленинградская область;21_45_days;CoviVac;249;93;342;1100343;462742;1563085
2022.05_01-07-2022;Ленинградская область;21_45_days;EpiVacCorona;151;36;187;1100343;462742;1563085
2022.05_01-07-2022;Ленинградская область;21_45_days;SputnikLite;888;648;1536;1100343;462742;1563085
2022.05_01-07-2022;Ленинградская область;21_45_days;SputnikV;3111;2352;5463;1100343;462742;1563085
2022.05_01-07-2022;Ленинградская область;45_75_days;AllVaccines;10575;5570;16145;1100343;462742;1563085
2022.05_01-07-2022;Ленинградская область;45_75_days;CoviVac;213;22;235;1100343;462742;1563085
2022.05_01-07-2022;Ленинградская область;45_75_days;EpiVacCorona;197;86;283;1100343;462742;1563085
2022.05_01-07-2022;Ленинградская область;45_75_days;SputnikLite;2405;1653;4058;1100343;462742;1563085
2022.05_01-07-2022;Ленинградская область;45_75_days;SputnikV;7760;3809;11569;1100343;462742;1563085
2022.05_01-07-2022;Ленинградская область;75_90_days;AllVaccines;11665;5789;17454;1100343;462742;1563085
2022.05_01-07-2022;Ленинградская область;75_90_days;CoviVac;165;41;206;1100343;462742;1563085
2022.05_01-07-2022;Ленинградская область;75_90_days;EpiVacCorona;259;74;333;1100343;462742;1563085
2022.05_01-07-2022;Ленинградская область;75_90_days;SputnikLite;3587;1915;5502;1100343;462742;1563085
2022.05_01-07-2022;Ленинградская область;75_90_days;SputnikV;7654;3759;11413;1100343;462742;1563085
2022.05_01-07-2022;Ленинградская область;90_105_days;AllVaccines;16808;8242;25050;1100343;462742;1563085
2022.05_01-07-2022;Ленинградская область;90_105_days;CoviVac;177;31;208;1100343;462742;1563085
2022.05_01-07-2022;Ленинградская область;90_105_days;EpiVacCorona;278;195;473;1100343;462742;1563085
2022.05_01-07-2022;Ленинградская область;90_105_days;SputnikLite;6342;3747;10089;1100343;462742;1563085
2022.05_01-07-2022;Ленинградская область;90_105_days;SputnikV;10011;4269;14280;1100343;462742;1563085
2022.05_01-07-2022;Липецкая область;105_165_days;AllVaccines;81586;36232;117818;621641;290878;912519
2022.05_01-07-2022;Липецкая область;105_165_days;CoviVac;554;66;620;621641;290878;912519
2022.05_01-07-2022;Липецкая область;105_165_days;EpiVacCorona;5983;2103;8086;621641;290878;912519
2022.05_01-07-2022;Липецкая область;105_165_days;SputnikLite;25888;18889;44777;621641;290878;912519
2022.05_01-07-2022;Липецкая область;105_165_days;SputnikV;49161;15174;64335;621641;290878;912519
2022.05_01-07-2022;Липецкая область;165_195_days;AllVaccines;104166;36287;140453;621641;290878;912519
2022.05_01-07-2022;Липецкая область;165_195_days;CoviVac;278;39;317;621641;290878;912519
2022.05_01-07-2022;Липецкая область;165_195_days;EpiVacCorona;4401;778;5179;621641;290878;912519
2022.05_01-07-2022;Липецкая область;165_195_days;SputnikLite;23311;19443;42754;621641;290878;912519
2022.05_01-07-2022;Липецкая область;165_195_days;SputnikV;76176;16027;92203;621641;290878;912519
2022.05_01-07-2022;Липецкая область;21_45_days;AllVaccines;8522;5339;13861;621641;290878;912519
2022.05_01-07-2022;Липецкая область;21_45_days;CoviVac;635;77;712;621641;290878;912519
2022.05_01-07-2022;Липецкая область;21_45_days;EpiVacCorona;494;609;1103;621641;290878;912519
2022.05_01-07-2022;Липецкая область;21_45_days;SputnikLite;629;285;914;621641;290878;912519
2022.05_01-07-2022;Липецкая область;21_45_days;SputnikV;6764;4368;11132;621641;290878;912519
2022.05_01-07-2022;Липецкая область;45_75_days;AllVaccines;12756;5299;18055;621641;290878;912519
2022.05_01-07-2022;Липецкая область;45_75_days;CoviVac;654;27;681;621641;290878;912519
2022.05_01-07-2022;Липецкая область;45_75_days;EpiVacCorona;1015;640;1655;621641;290878;912519
2022.05_01-07-2022;Липецкая область;45_75_days;SputnikLite;2312;1079;3391;621641;290878;912519
2022.05_01-07-2022;Липецкая область;45_75_days;SputnikV;8775;3553;12328;621641;290878;912519
2022.05_01-07-2022;Липецкая область;75_90_days;AllVaccines;8979;3728;12707;621641;290878;912519
2022.05_01-07-2022;Липецкая область;75_90_days;CoviVac;248;16;264;621641;290878;912519
2022.05_01-07-2022;Липецкая область;75_90_days;EpiVacCorona;1075;658;1733;621641;290878;912519
2022.05_01-07-2022;Липецкая область;75_90_days;SputnikLite;2510;949;3459;621641;290878;912519
2022.05_01-07-2022;Липецкая область;75_90_days;SputnikV;5146;2105;7251;621641;290878;912519
2022.05_01-07-2022;Липецкая область;90_105_days;AllVaccines;12066;5108;17174;621641;290878;912519
2022.05_01-07-2022;Липецкая область;90_105_days;CoviVac;171;11;182;621641;290878;912519
2022.05_01-07-2022;Липецкая область;90_105_days;EpiVacCorona;458;189;647;621641;290878;912519
2022.05_01-07-2022;Липецкая область;90_105_days;SputnikLite;6720;2810;9530;621641;290878;912519
2022.05_01-07-2022;Липецкая область;90_105_days;SputnikV;4717;2098;6815;621641;290878;912519
2022.05_01-07-2022;Магаданская область;105_165_days;AllVaccines;13376;3601;16977;83196;26810;110006
2022.05_01-07-2022;Магаданская область;105_165_days;CoviVac;194;35;229;83196;26810;110006
2022.05_01-07-2022;Магаданская область;105_165_days;EpiVacCorona;1259;174;1433;83196;26810;110006
2022.05_01-07-2022;Магаданская область;105_165_days;SputnikLite;7026;2393;9419;83196;26810;110006
2022.05_01-07-2022;Магаданская область;105_165_days;SputnikV;4897;999;5896;83196;26810;110006
2022.05_01-07-2022;Магаданская область;165_195_days;AllVaccines;6779;2413;9192;83196;26810;110006
2022.05_01-07-2022;Магаданская область;165_195_days;CoviVac;168;46;214;83196;26810;110006
2022.05_01-07-2022;Магаданская область;165_195_days;EpiVacCorona;443;66;509;83196;26810;110006
2022.05_01-07-2022;Магаданская область;165_195_days;SputnikLite;4132;1779;5911;83196;26810;110006
2022.05_01-07-2022;Магаданская область;165_195_days;SputnikV;2036;522;2558;83196;26810;110006
2022.05_01-07-2022;Магаданская область;21_45_days;AllVaccines;1055;337;1392;83196;26810;110006
2022.05_01-07-2022;Магаданская область;21_45_days;CoviVac;1;0;1;83196;26810;110006
2022.05_01-07-2022;Магаданская область;21_45_days;EpiVacCorona;28;10;38;83196;26810;110006
2022.05_01-07-2022;Магаданская область;21_45_days;SputnikLite;763;250;1013;83196;26810;110006
2022.05_01-07-2022;Магаданская область;21_45_days;SputnikV;263;77;340;83196;26810;110006
2022.05_01-07-2022;Магаданская область;45_75_days;AllVaccines;1805;556;2361;83196;26810;110006
2022.05_01-07-2022;Магаданская область;45_75_days;CoviVac;12;4;16;83196;26810;110006
2022.05_01-07-2022;Магаданская область;45_75_days;EpiVacCorona;79;17;96;83196;26810;110006
2022.05_01-07-2022;Магаданская область;45_75_days;SputnikLite;1046;351;1397;83196;26810;110006
2022.05_01-07-2022;Магаданская область;45_75_days;SputnikV;668;184;852;83196;26810;110006
2022.05_01-07-2022;Магаданская область;75_90_days;AllVaccines;2109;505;2614;83196;26810;110006
2022.05_01-07-2022;Магаданская область;75_90_days;CoviVac;77;5;82;83196;26810;110006
2022.05_01-07-2022;Магаданская область;75_90_days;EpiVacCorona;111;34;145;83196;26810;110006
2022.05_01-07-2022;Магаданская область;75_90_days;SputnikLite;1135;245;1380;83196;26810;110006
2022.05_01-07-2022;Магаданская область;75_90_days;SputnikV;786;221;1007;83196;26810;110006
2022.05_01-07-2022;Магаданская область;90_105_days;AllVaccines;2372;627;2999;83196;26810;110006
2022.05_01-07-2022;Магаданская область;90_105_days;CoviVac;78;14;92;83196;26810;110006
2022.05_01-07-2022;Магаданская область;90_105_days;EpiVacCorona;128;31;159;83196;26810;110006
2022.05_01-07-2022;Магаданская область;90_105_days;SputnikLite;1519;384;1903;83196;26810;110006
2022.05_01-07-2022;Магаданская область;90_105_days;SputnikV;647;198;845;83196;26810;110006
2022.05_01-07-2022;Московская область;105_165_days;AllVaccines;454247;216655;670902;4485323;1674471;6159794
2022.05_01-07-2022;Московская область;105_165_days;CoviVac;4872;1896;6768;4485323;1674471;6159794
2022.05_01-07-2022;Московская область;105_165_days;EpiVacCorona;6538;5323;11861;4485323;1674471;6159794
2022.05_01-07-2022;Московская область;105_165_days;SputnikLite;157637;103000;260637;4485323;1674471;6159794
2022.05_01-07-2022;Московская область;105_165_days;SputnikV;285200;106436;391636;4485323;1674471;6159794
2022.05_01-07-2022;Московская область;165_195_days;AllVaccines;319489;165726;485215;4485323;1674471;6159794
2022.05_01-07-2022;Московская область;165_195_days;CoviVac;3645;1582;5227;4485323;1674471;6159794
2022.05_01-07-2022;Московская область;165_195_days;EpiVacCorona;5203;4306;9509;4485323;1674471;6159794
2022.05_01-07-2022;Московская область;165_195_days;SputnikLite;72260;65260;137520;4485323;1674471;6159794
2022.05_01-07-2022;Московская область;165_195_days;SputnikV;238381;94578;332959;4485323;1674471;6159794
2022.05_01-07-2022;Московская область;21_45_days;AllVaccines;32165;16388;48553;4485323;1674471;6159794
2022.05_01-07-2022;Московская область;21_45_days;CoviVac;398;103;501;4485323;1674471;6159794
2022.05_01-07-2022;Московская область;21_45_days;EpiVacCorona;1206;806;2012;4485323;1674471;6159794
2022.05_01-07-2022;Московская область;21_45_days;SputnikLite;13006;8541;21547;4485323;1674471;6159794
2022.05_01-07-2022;Московская область;21_45_days;SputnikV;17555;6938;24493;4485323;1674471;6159794
2022.05_01-07-2022;Московская область;45_75_days;AllVaccines;71212;29240;100452;4485323;1674471;6159794
2022.05_01-07-2022;Московская область;45_75_days;CoviVac;684;209;893;4485323;1674471;6159794
2022.05_01-07-2022;Московская область;45_75_days;EpiVacCorona;1593;1159;2752;4485323;1674471;6159794
2022.05_01-07-2022;Московская область;45_75_days;SputnikLite;25390;14913;40303;4485323;1674471;6159794
2022.05_01-07-2022;Московская область;45_75_days;SputnikV;43545;12959;56504;4485323;1674471;6159794
2022.05_01-07-2022;Московская область;75_90_days;AllVaccines;72792;25967;98759;4485323;1674471;6159794
2022.05_01-07-2022;Московская область;75_90_days;CoviVac;645;165;810;4485323;1674471;6159794
2022.05_01-07-2022;Московская область;75_90_days;EpiVacCorona;1433;607;2040;4485323;1674471;6159794
2022.05_01-07-2022;Московская область;75_90_days;SputnikLite;29397;13302;42699;4485323;1674471;6159794
2022.05_01-07-2022;Московская область;75_90_days;SputnikV;41317;11893;53210;4485323;1674471;6159794
2022.05_01-07-2022;Московская область;90_105_days;AllVaccines;90663;35092;125755;4485323;1674471;6159794
2022.05_01-07-2022;Московская область;90_105_days;CoviVac;1240;385;1625;4485323;1674471;6159794
2022.05_01-07-2022;Московская область;90_105_days;EpiVacCorona;1335;897;2232;4485323;1674471;6159794
2022.05_01-07-2022;Московская область;90_105_days;SputnikLite;42317;18193;60510;4485323;1674471;6159794
2022.05_01-07-2022;Московская область;90_105_days;SputnikV;45771;15617;61388;4485323;1674471;6159794
2022.05_01-07-2022;Мурманская область;105_165_days;AllVaccines;64759;21855;86614;436555;144366;580921
2022.05_01-07-2022;Мурманская область;105_165_days;CoviVac;1068;124;1192;436555;144366;580921
2022.05_01-07-2022;Мурманская область;105_165_days;EpiVacCorona;2628;835;3463;436555;144366;580921
2022.05_01-07-2022;Мурманская область;105_165_days;SputnikLite;28530;12001;40531;436555;144366;580921
2022.05_01-07-2022;Мурманская область;105_165_days;SputnikV;32533;8895;41428;436555;144366;580921
2022.05_01-07-2022;Мурманская область;165_195_days;AllVaccines;38656;14088;52744;436555;144366;580921
2022.05_01-07-2022;Мурманская область;165_195_days;CoviVac;579;87;666;436555;144366;580921
2022.05_01-07-2022;Мурманская область;165_195_days;EpiVacCorona;845;460;1305;436555;144366;580921
2022.05_01-07-2022;Мурманская область;165_195_days;SputnikLite;24710;8916;33626;436555;144366;580921
2022.05_01-07-2022;Мурманская область;165_195_days;SputnikV;12522;4625;17147;436555;144366;580921
2022.05_01-07-2022;Мурманская область;21_45_days;AllVaccines;4713;1915;6628;436555;144366;580921
2022.05_01-07-2022;Мурманская область;21_45_days;CoviVac;150;32;182;436555;144366;580921
2022.05_01-07-2022;Мурманская область;21_45_days;EpiVacCorona;31;30;61;436555;144366;580921
2022.05_01-07-2022;Мурманская область;21_45_days;SputnikLite;2775;1233;4008;436555;144366;580921
2022.05_01-07-2022;Мурманская область;21_45_days;SputnikV;1757;620;2377;436555;144366;580921
2022.05_01-07-2022;Мурманская область;45_75_days;AllVaccines;7639;2956;10595;436555;144366;580921
2022.05_01-07-2022;Мурманская область;45_75_days;CoviVac;195;38;233;436555;144366;580921
2022.05_01-07-2022;Мурманская область;45_75_days;EpiVacCorona;42;15;57;436555;144366;580921
2022.05_01-07-2022;Мурманская область;45_75_days;SputnikLite;4040;1853;5893;436555;144366;580921
2022.05_01-07-2022;Мурманская область;45_75_days;SputnikV;3362;1050;4412;436555;144366;580921
2022.05_01-07-2022;Мурманская область;75_90_days;AllVaccines;6956;2474;9430;436555;144366;580921
2022.05_01-07-2022;Мурманская область;75_90_days;CoviVac;106;5;111;436555;144366;580921
2022.05_01-07-2022;Мурманская область;75_90_days;EpiVacCorona;60;32;92;436555;144366;580921
2022.05_01-07-2022;Мурманская область;75_90_days;SputnikLite;3824;1365;5189;436555;144366;580921
2022.05_01-07-2022;Мурманская область;75_90_days;SputnikV;2966;1072;4038;436555;144366;580921
2022.05_01-07-2022;Мурманская область;90_105_days;AllVaccines;8447;3494;11941;436555;144366;580921
2022.05_01-07-2022;Мурманская область;90_105_days;CoviVac;195;35;230;436555;144366;580921
2022.05_01-07-2022;Мурманская область;90_105_days;EpiVacCorona;85;42;127;436555;144366;580921
2022.05_01-07-2022;Мурманская область;90_105_days;SputnikLite;5214;2137;7351;436555;144366;580921
2022.05_01-07-2022;Мурманская область;90_105_days;SputnikV;2953;1280;4233;436555;144366;580921
2022.05_01-07-2022;Ненецкий автономный округ;105_165_days;AllVaccines;2708;911;3619;24931;7449;32380
2022.05_01-07-2022;Ненецкий автономный округ;105_165_days;EpiVacCorona;97;14;111;24931;7449;32380
2022.05_01-07-2022;Ненецкий автономный округ;105_165_days;SputnikLite;2038;808;2846;24931;7449;32380
2022.05_01-07-2022;Ненецкий автономный округ;105_165_days;SputnikV;573;89;662;24931;7449;32380
2022.05_01-07-2022;Ненецкий автономный округ;165_195_days;AllVaccines;2642;855;3497;24931;7449;32380
2022.05_01-07-2022;Ненецкий автономный округ;165_195_days;CoviVac;3;0;3;24931;7449;32380
2022.05_01-07-2022;Ненецкий автономный округ;165_195_days;EpiVacCorona;51;5;56;24931;7449;32380
2022.05_01-07-2022;Ненецкий автономный округ;165_195_days;SputnikLite;2230;769;2999;24931;7449;32380
2022.05_01-07-2022;Ненецкий автономный округ;165_195_days;SputnikV;358;81;439;24931;7449;32380
2022.05_01-07-2022;Ненецкий автономный округ;21_45_days;AllVaccines;140;64;204;24931;7449;32380
2022.05_01-07-2022;Ненецкий автономный округ;21_45_days;EpiVacCorona;4;0;4;24931;7449;32380
2022.05_01-07-2022;Ненецкий автономный округ;21_45_days;SputnikLite;123;62;185;24931;7449;32380
2022.05_01-07-2022;Ненецкий автономный округ;21_45_days;SputnikV;13;2;15;24931;7449;32380
2022.05_01-07-2022;Ненецкий автономный округ;45_75_days;AllVaccines;297;153;450;24931;7449;32380
2022.05_01-07-2022;Ненецкий автономный округ;45_75_days;EpiVacCorona;3;0;3;24931;7449;32380
2022.05_01-07-2022;Ненецкий автономный округ;45_75_days;SputnikLite;242;128;370;24931;7449;32380
2022.05_01-07-2022;Ненецкий автономный округ;45_75_days;SputnikV;52;25;77;24931;7449;32380
2022.05_01-07-2022;Ненецкий автономный округ;75_90_days;AllVaccines;211;104;315;24931;7449;32380
2022.05_01-07-2022;Ненецкий автономный округ;75_90_days;EpiVacCorona;1;0;1;24931;7449;32380
2022.05_01-07-2022;Ненецкий автономный округ;75_90_days;SputnikLite;148;84;232;24931;7449;32380
2022.05_01-07-2022;Ненецкий автономный округ;75_90_days;SputnikV;62;20;82;24931;7449;32380
2022.05_01-07-2022;Ненецкий автономный округ;90_105_days;AllVaccines;293;137;430;24931;7449;32380
2022.05_01-07-2022;Ненецкий автономный округ;90_105_days;SputnikLite;215;121;336;24931;7449;32380
2022.05_01-07-2022;Ненецкий автономный округ;90_105_days;SputnikV;78;16;94;24931;7449;32380
2022.05_01-07-2022;Нижегородская область;105_165_days;AllVaccines;205447;126831;332278;1769909;800663;2570572
2022.05_01-07-2022;Нижегородская область;105_165_days;CoviVac;969;311;1280;1769909;800663;2570572
2022.05_01-07-2022;Нижегородская область;105_165_days;EpiVacCorona;5773;4585;10358;1769909;800663;2570572
2022.05_01-07-2022;Нижегородская область;105_165_days;SputnikLite;82516;61352;143868;1769909;800663;2570572
2022.05_01-07-2022;Нижегородская область;105_165_days;SputnikV;116189;60583;176772;1769909;800663;2570572
2022.05_01-07-2022;Нижегородская область;165_195_days;AllVaccines;168230;89170;257400;1769909;800663;2570572
2022.05_01-07-2022;Нижегородская область;165_195_days;CoviVac;1026;189;1215;1769909;800663;2570572
2022.05_01-07-2022;Нижегородская область;165_195_days;EpiVacCorona;3298;1783;5081;1769909;800663;2570572
2022.05_01-07-2022;Нижегородская область;165_195_days;SputnikLite;47266;40028;87294;1769909;800663;2570572
2022.05_01-07-2022;Нижегородская область;165_195_days;SputnikV;116640;47170;163810;1769909;800663;2570572
2022.05_01-07-2022;Нижегородская область;21_45_days;AllVaccines;8258;6763;15021;1769909;800663;2570572
2022.05_01-07-2022;Нижегородская область;21_45_days;CoviVac;244;78;322;1769909;800663;2570572
2022.05_01-07-2022;Нижегородская область;21_45_days;EpiVacCorona;652;489;1141;1769909;800663;2570572
2022.05_01-07-2022;Нижегородская область;21_45_days;SputnikLite;1178;760;1938;1769909;800663;2570572
2022.05_01-07-2022;Нижегородская область;21_45_days;SputnikV;6184;5436;11620;1769909;800663;2570572
2022.05_01-07-2022;Нижегородская область;45_75_days;AllVaccines;15701;7879;23580;1769909;800663;2570572
2022.05_01-07-2022;Нижегородская область;45_75_days;CoviVac;451;133;584;1769909;800663;2570572
2022.05_01-07-2022;Нижегородская область;45_75_days;EpiVacCorona;1320;897;2217;1769909;800663;2570572
2022.05_01-07-2022;Нижегородская область;45_75_days;SputnikLite;2967;1903;4870;1769909;800663;2570572
2022.05_01-07-2022;Нижегородская область;45_75_days;SputnikV;10963;4946;15909;1769909;800663;2570572
2022.05_01-07-2022;Нижегородская область;75_90_days;AllVaccines;18111;7876;25987;1769909;800663;2570572
2022.05_01-07-2022;Нижегородская область;75_90_days;CoviVac;334;75;409;1769909;800663;2570572
2022.05_01-07-2022;Нижегородская область;75_90_days;EpiVacCorona;646;426;1072;1769909;800663;2570572
2022.05_01-07-2022;Нижегородская область;75_90_days;SputnikLite;7644;3069;10713;1769909;800663;2570572
2022.05_01-07-2022;Нижегородская область;75_90_days;SputnikV;9487;4306;13793;1769909;800663;2570572
2022.05_01-07-2022;Нижегородская область;90_105_days;AllVaccines;26186;12222;38408;1769909;800663;2570572
2022.05_01-07-2022;Нижегородская область;90_105_days;CoviVac;476;154;630;1769909;800663;2570572
2022.05_01-07-2022;Нижегородская область;90_105_days;EpiVacCorona;629;473;1102;1769909;800663;2570572
2022.05_01-07-2022;Нижегородская область;90_105_days;SputnikLite;15935;6650;22585;1769909;800663;2570572
2022.05_01-07-2022;Нижегородская область;90_105_days;SputnikV;9146;4945;14091;1769909;800663;2570572
2022.05_01-07-2022;Новгородская область;105_165_days;AllVaccines;32527;21832;54359;317276;158308;475584
2022.05_01-07-2022;Новгородская область;105_165_days;CoviVac;1192;437;1629;317276;158308;475584
2022.05_01-07-2022;Новгородская область;105_165_days;EpiVacCorona;2745;1536;4281;317276;158308;475584
2022.05_01-07-2022;Новгородская область;105_165_days;SputnikLite;10319;9254;19573;317276;158308;475584
2022.05_01-07-2022;Новгородская область;105_165_days;SputnikV;18271;10605;28876;317276;158308;475584
2022.05_01-07-2022;Новгородская область;165_195_days;AllVaccines;24995;15506;40501;317276;158308;475584
2022.05_01-07-2022;Новгородская область;165_195_days;CoviVac;356;104;460;317276;158308;475584
2022.05_01-07-2022;Новгородская область;165_195_days;EpiVacCorona;870;352;1222;317276;158308;475584
2022.05_01-07-2022;Новгородская область;165_195_days;SputnikLite;11645;8718;20363;317276;158308;475584
2022.05_01-07-2022;Новгородская область;165_195_days;SputnikV;12124;6332;18456;317276;158308;475584
2022.05_01-07-2022;Новгородская область;21_45_days;AllVaccines;1344;1202;2546;317276;158308;475584
2022.05_01-07-2022;Новгородская область;21_45_days;CoviVac;106;33;139;317276;158308;475584
2022.05_01-07-2022;Новгородская область;21_45_days;EpiVacCorona;77;85;162;317276;158308;475584
2022.05_01-07-2022;Новгородская область;21_45_days;SputnikLite;327;317;644;317276;158308;475584
2022.05_01-07-2022;Новгородская область;21_45_days;SputnikV;834;767;1601;317276;158308;475584
2022.05_01-07-2022;Новгородская область;45_75_days;AllVaccines;2762;2152;4914;317276;158308;475584
2022.05_01-07-2022;Новгородская область;45_75_days;CoviVac;171;51;222;317276;158308;475584
2022.05_01-07-2022;Новгородская область;45_75_days;EpiVacCorona;163;165;328;317276;158308;475584
2022.05_01-07-2022;Новгородская область;45_75_days;SputnikLite;456;512;968;317276;158308;475584
2022.05_01-07-2022;Новгородская область;45_75_days;SputnikV;1972;1424;3396;317276;158308;475584
2022.05_01-07-2022;Новгородская область;75_90_days;AllVaccines;2971;1923;4894;317276;158308;475584
2022.05_01-07-2022;Новгородская область;75_90_days;CoviVac;118;60;178;317276;158308;475584
2022.05_01-07-2022;Новгородская область;75_90_days;EpiVacCorona;221;171;392;317276;158308;475584
2022.05_01-07-2022;Новгородская область;75_90_days;SputnikLite;685;405;1090;317276;158308;475584
2022.05_01-07-2022;Новгородская область;75_90_days;SputnikV;1947;1287;3234;317276;158308;475584
2022.05_01-07-2022;Новгородская область;90_105_days;AllVaccines;4453;3401;7854;317276;158308;475584
2022.05_01-07-2022;Новгородская область;90_105_days;CoviVac;202;83;285;317276;158308;475584
2022.05_01-07-2022;Новгородская область;90_105_days;EpiVacCorona;328;276;604;317276;158308;475584
2022.05_01-07-2022;Новгородская область;90_105_days;SputnikLite;1782;1244;3026;317276;158308;475584
2022.05_01-07-2022;Новгородская область;90_105_days;SputnikV;2141;1798;3939;317276;158308;475584
2022.05_01-07-2022;Новосибирская область;105_165_days;AllVaccines;287044;128036;415080;1571829;624100;2195929
2022.05_01-07-2022;Новосибирская область;105_165_days;CoviVac;1315;343;1658;1571829;624100;2195929
2022.05_01-07-2022;Новосибирская область;105_165_days;EpiVacCorona;6705;2976;9681;1571829;624100;2195929
2022.05_01-07-2022;Новосибирская область;105_165_days;SputnikLite;89882;68377;158259;1571829;624100;2195929
2022.05_01-07-2022;Новосибирская область;105_165_days;SputnikV;189142;56340;245482;1571829;624100;2195929
2022.05_01-07-2022;Новосибирская область;165_195_days;AllVaccines;141989;53551;195540;1571829;624100;2195929
2022.05_01-07-2022;Новосибирская область;165_195_days;CoviVac;1166;143;1309;1571829;624100;2195929
2022.05_01-07-2022;Новосибирская область;165_195_days;EpiVacCorona;4531;1410;5941;1571829;624100;2195929
2022.05_01-07-2022;Новосибирская область;165_195_days;SputnikLite;28957;19286;48243;1571829;624100;2195929
2022.05_01-07-2022;Новосибирская область;165_195_days;SputnikV;107335;32712;140047;1571829;624100;2195929
2022.05_01-07-2022;Новосибирская область;21_45_days;AllVaccines;8398;5884;14282;1571829;624100;2195929
2022.05_01-07-2022;Новосибирская область;21_45_days;CoviVac;447;131;578;1571829;624100;2195929
2022.05_01-07-2022;Новосибирская область;21_45_days;EpiVacCorona;430;410;840;1571829;624100;2195929
2022.05_01-07-2022;Новосибирская область;21_45_days;SputnikLite;693;411;1104;1571829;624100;2195929
2022.05_01-07-2022;Новосибирская область;21_45_days;SputnikV;6828;4932;11760;1571829;624100;2195929
2022.05_01-07-2022;Новосибирская область;45_75_days;AllVaccines;13653;7198;20851;1571829;624100;2195929
2022.05_01-07-2022;Новосибирская область;45_75_days;CoviVac;590;156;746;1571829;624100;2195929
2022.05_01-07-2022;Новосибирская область;45_75_days;EpiVacCorona;564;282;846;1571829;624100;2195929
2022.05_01-07-2022;Новосибирская область;45_75_days;SputnikLite;945;618;1563;1571829;624100;2195929
2022.05_01-07-2022;Новосибирская область;45_75_days;SputnikV;11554;6142;17696;1571829;624100;2195929
2022.05_01-07-2022;Новосибирская область;75_90_days;AllVaccines;25604;12230;37834;1571829;624100;2195929
2022.05_01-07-2022;Новосибирская область;75_90_days;CoviVac;397;83;480;1571829;624100;2195929
2022.05_01-07-2022;Новосибирская область;75_90_days;EpiVacCorona;589;336;925;1571829;624100;2195929
2022.05_01-07-2022;Новосибирская область;75_90_days;SputnikLite;12314;5552;17866;1571829;624100;2195929
2022.05_01-07-2022;Новосибирская область;75_90_days;SputnikV;12304;6259;18563;1571829;624100;2195929
2022.05_01-07-2022;Новосибирская область;90_105_days;AllVaccines;31574;15935;47509;1571829;624100;2195929
2022.05_01-07-2022;Новосибирская область;90_105_days;CoviVac;693;159;852;1571829;624100;2195929
2022.05_01-07-2022;Новосибирская область;90_105_days;EpiVacCorona;810;616;1426;1571829;624100;2195929
2022.05_01-07-2022;Новосибирская область;90_105_days;SputnikLite;15976;8127;24103;1571829;624100;2195929
2022.05_01-07-2022;Новосибирская область;90_105_days;SputnikV;14095;7033;21128;1571829;624100;2195929
2022.05_01-07-2022;Омская область;105_165_days;AllVaccines;171307;73734;245041;1058291;431046;1489337
2022.05_01-07-2022;Омская область;105_165_days;CoviVac;1188;312;1500;1058291;431046;1489337
2022.05_01-07-2022;Омская область;105_165_days;EpiVacCorona;4901;1850;6751;1058291;431046;1489337
2022.05_01-07-2022;Омская область;105_165_days;SputnikLite;50326;29622;79948;1058291;431046;1489337
2022.05_01-07-2022;Омская область;105_165_days;SputnikV;114892;41950;156842;1058291;431046;1489337
2022.05_01-07-2022;Омская область;165_195_days;AllVaccines;96179;40634;136813;1058291;431046;1489337
2022.05_01-07-2022;Омская область;165_195_days;CoviVac;983;233;1216;1058291;431046;1489337
2022.05_01-07-2022;Омская область;165_195_days;EpiVacCorona;3083;961;4044;1058291;431046;1489337
2022.05_01-07-2022;Омская область;165_195_days;SputnikLite;21167;13170;34337;1058291;431046;1489337
2022.05_01-07-2022;Омская область;165_195_days;SputnikV;70946;26270;97216;1058291;431046;1489337
2022.05_01-07-2022;Омская область;21_45_days;AllVaccines;8305;3862;12167;1058291;431046;1489337
2022.05_01-07-2022;Омская область;21_45_days;CoviVac;321;82;403;1058291;431046;1489337
2022.05_01-07-2022;Омская область;21_45_days;EpiVacCorona;861;346;1207;1058291;431046;1489337
2022.05_01-07-2022;Омская область;21_45_days;SputnikLite;1628;721;2349;1058291;431046;1489337
2022.05_01-07-2022;Омская область;21_45_days;SputnikV;5495;2713;8208;1058291;431046;1489337
2022.05_01-07-2022;Омская область;45_75_days;AllVaccines;18864;6987;25851;1058291;431046;1489337
2022.05_01-07-2022;Омская область;45_75_days;CoviVac;384;78;462;1058291;431046;1489337
2022.05_01-07-2022;Омская область;45_75_days;EpiVacCorona;1078;449;1527;1058291;431046;1489337
2022.05_01-07-2022;Омская область;45_75_days;SputnikLite;5809;2078;7887;1058291;431046;1489337
2022.05_01-07-2022;Омская область;45_75_days;SputnikV;11593;4382;15975;1058291;431046;1489337
2022.05_01-07-2022;Омская область;75_90_days;AllVaccines;19412;6973;26385;1058291;431046;1489337
2022.05_01-07-2022;Омская область;75_90_days;CoviVac;243;60;303;1058291;431046;1489337
2022.05_01-07-2022;Омская область;75_90_days;EpiVacCorona;596;243;839;1058291;431046;1489337
2022.05_01-07-2022;Омская область;75_90_days;SputnikLite;7475;2066;9541;1058291;431046;1489337
2022.05_01-07-2022;Омская область;75_90_days;SputnikV;11098;4604;15702;1058291;431046;1489337
2022.05_01-07-2022;Омская область;90_105_days;AllVaccines;22804;8819;31623;1058291;431046;1489337
2022.05_01-07-2022;Омская область;90_105_days;CoviVac;300;60;360;1058291;431046;1489337
2022.05_01-07-2022;Омская область;90_105_days;EpiVacCorona;715;365;1080;1058291;431046;1489337
2022.05_01-07-2022;Омская область;90_105_days;SputnikLite;10847;3601;14448;1058291;431046;1489337
2022.05_01-07-2022;Омская область;90_105_days;SputnikV;10942;4793;15735;1058291;431046;1489337
2022.05_01-07-2022;Оренбургская область;105_165_days;AllVaccines;141058;67445;208503;1068899;440686;1509585
2022.05_01-07-2022;Оренбургская область;105_165_days;CoviVac;1528;221;1749;1068899;440686;1509585
2022.05_01-07-2022;Оренбургская область;105_165_days;EpiVacCorona;8064;3565;11629;1068899;440686;1509585
2022.05_01-07-2022;Оренбургская область;105_165_days;SputnikLite;69708;37689;107397;1068899;440686;1509585
2022.05_01-07-2022;Оренбургская область;105_165_days;SputnikV;61758;25970;87728;1068899;440686;1509585
2022.05_01-07-2022;Оренбургская область;165_195_days;AllVaccines;124064;57024;181088;1068899;440686;1509585
2022.05_01-07-2022;Оренбургская область;165_195_days;CoviVac;1332;221;1553;1068899;440686;1509585
2022.05_01-07-2022;Оренбургская область;165_195_days;EpiVacCorona;4433;1523;5956;1068899;440686;1509585
2022.05_01-07-2022;Оренбургская область;165_195_days;SputnikLite;26603;27390;53993;1068899;440686;1509585
2022.05_01-07-2022;Оренбургская область;165_195_days;SputnikV;91696;27890;119586;1068899;440686;1509585
2022.05_01-07-2022;Оренбургская область;21_45_days;AllVaccines;8999;4343;13342;1068899;440686;1509585
2022.05_01-07-2022;Оренбургская область;21_45_days;CoviVac;619;43;662;1068899;440686;1509585
2022.05_01-07-2022;Оренбургская область;21_45_days;EpiVacCorona;484;215;699;1068899;440686;1509585
2022.05_01-07-2022;Оренбургская область;21_45_days;SputnikLite;122;61;183;1068899;440686;1509585
2022.05_01-07-2022;Оренбургская область;21_45_days;SputnikV;7774;4024;11798;1068899;440686;1509585
2022.05_01-07-2022;Оренбургская область;45_75_days;AllVaccines;12812;4293;17105;1068899;440686;1509585
2022.05_01-07-2022;Оренбургская область;45_75_days;CoviVac;592;51;643;1068899;440686;1509585
2022.05_01-07-2022;Оренбургская область;45_75_days;EpiVacCorona;699;236;935;1068899;440686;1509585
2022.05_01-07-2022;Оренбургская область;45_75_days;SputnikLite;1028;296;1324;1068899;440686;1509585
2022.05_01-07-2022;Оренбургская область;45_75_days;SputnikV;10493;3710;14203;1068899;440686;1509585
2022.05_01-07-2022;Оренбургская область;75_90_days;AllVaccines;25516;8354;33870;1068899;440686;1509585
2022.05_01-07-2022;Оренбургская область;75_90_days;CoviVac;321;27;348;1068899;440686;1509585
2022.05_01-07-2022;Оренбургская область;75_90_days;EpiVacCorona;721;300;1021;1068899;440686;1509585
2022.05_01-07-2022;Оренбургская область;75_90_days;SputnikLite;13711;4376;18087;1068899;440686;1509585
2022.05_01-07-2022;Оренбургская область;75_90_days;SputnikV;10763;3651;14414;1068899;440686;1509585
2022.05_01-07-2022;Оренбургская область;90_105_days;AllVaccines;35731;12618;48349;1068899;440686;1509585
2022.05_01-07-2022;Оренбургская область;90_105_days;CoviVac;509;38;547;1068899;440686;1509585
2022.05_01-07-2022;Оренбургская область;90_105_days;EpiVacCorona;1302;526;1828;1068899;440686;1509585
2022.05_01-07-2022;Оренбургская область;90_105_days;SputnikLite;24692;8342;33034;1068899;440686;1509585
2022.05_01-07-2022;Оренбургская область;90_105_days;SputnikV;9228;3712;12940;1068899;440686;1509585
2022.05_01-07-2022;Орловская область;105_165_days;AllVaccines;65412;31253;96665;398663;193123;591786
2022.05_01-07-2022;Орловская область;105_165_days;CoviVac;2085;569;2654;398663;193123;591786
2022.05_01-07-2022;Орловская область;105_165_days;EpiVacCorona;1283;587;1870;398663;193123;591786
2022.05_01-07-2022;Орловская область;105_165_days;SputnikLite;18467;14264;32731;398663;193123;591786
2022.05_01-07-2022;Орловская область;105_165_days;SputnikV;43577;15833;59410;398663;193123;591786
2022.05_01-07-2022;Орловская область;165_195_days;AllVaccines;42368;19996;62364;398663;193123;591786
2022.05_01-07-2022;Орловская область;165_195_days;CoviVac;894;190;1084;398663;193123;591786
2022.05_01-07-2022;Орловская область;165_195_days;EpiVacCorona;431;246;677;398663;193123;591786
2022.05_01-07-2022;Орловская область;165_195_days;SputnikLite;12713;10176;22889;398663;193123;591786
2022.05_01-07-2022;Орловская область;165_195_days;SputnikV;28330;9384;37714;398663;193123;591786
2022.05_01-07-2022;Орловская область;21_45_days;AllVaccines;1976;1272;3248;398663;193123;591786
2022.05_01-07-2022;Орловская область;21_45_days;CoviVac;73;6;79;398663;193123;591786
2022.05_01-07-2022;Орловская область;21_45_days;EpiVacCorona;191;55;246;398663;193123;591786
2022.05_01-07-2022;Орловская область;21_45_days;SputnikLite;114;73;187;398663;193123;591786
2022.05_01-07-2022;Орловская область;21_45_days;SputnikV;1598;1138;2736;398663;193123;591786
2022.05_01-07-2022;Орловская область;45_75_days;AllVaccines;3796;1614;5410;398663;193123;591786
2022.05_01-07-2022;Орловская область;45_75_days;CoviVac;157;23;180;398663;193123;591786
2022.05_01-07-2022;Орловская область;45_75_days;EpiVacCorona;383;114;497;398663;193123;591786
2022.05_01-07-2022;Орловская область;45_75_days;SputnikLite;384;187;571;398663;193123;591786
2022.05_01-07-2022;Орловская область;45_75_days;SputnikV;2872;1290;4162;398663;193123;591786
2022.05_01-07-2022;Орловская область;75_90_days;AllVaccines;3521;1732;5253;398663;193123;591786
2022.05_01-07-2022;Орловская область;75_90_days;CoviVac;82;8;90;398663;193123;591786
2022.05_01-07-2022;Орловская область;75_90_days;EpiVacCorona;251;78;329;398663;193123;591786
2022.05_01-07-2022;Орловская область;75_90_days;SputnikLite;1338;711;2049;398663;193123;591786
2022.05_01-07-2022;Орловская область;75_90_days;SputnikV;1850;935;2785;398663;193123;591786
2022.05_01-07-2022;Орловская область;90_105_days;AllVaccines;6415;3322;9737;398663;193123;591786
2022.05_01-07-2022;Орловская область;90_105_days;CoviVac;127;28;155;398663;193123;591786
2022.05_01-07-2022;Орловская область;90_105_days;EpiVacCorona;242;108;350;398663;193123;591786
2022.05_01-07-2022;Орловская область;90_105_days;SputnikLite;4118;2146;6264;398663;193123;591786
2022.05_01-07-2022;Орловская область;90_105_days;SputnikV;1928;1040;2968;398663;193123;591786
2022.05_01-07-2022;Пензенская область;105_165_days;AllVaccines;95672;73716;169388;710438;350687;1061125
2022.05_01-07-2022;Пензенская область;105_165_days;CoviVac;1149;412;1561;710438;350687;1061125
2022.05_01-07-2022;Пензенская область;105_165_days;EpiVacCorona;2125;4486;6611;710438;350687;1061125
2022.05_01-07-2022;Пензенская область;105_165_days;SputnikLite;38317;22761;61078;710438;350687;1061125
2022.05_01-07-2022;Пензенская область;105_165_days;SputnikV;54081;46057;100138;710438;350687;1061125
2022.05_01-07-2022;Пензенская область;165_195_days;AllVaccines;123983;45283;169266;710438;350687;1061125
2022.05_01-07-2022;Пензенская область;165_195_days;CoviVac;1459;199;1658;710438;350687;1061125
2022.05_01-07-2022;Пензенская область;165_195_days;EpiVacCorona;2470;567;3037;710438;350687;1061125
2022.05_01-07-2022;Пензенская область;165_195_days;SputnikLite;8523;5087;13610;710438;350687;1061125
2022.05_01-07-2022;Пензенская область;165_195_days;SputnikV;111531;39430;150961;710438;350687;1061125
2022.05_01-07-2022;Пензенская область;21_45_days;AllVaccines;16413;31518;47931;710438;350687;1061125
2022.05_01-07-2022;Пензенская область;21_45_days;CoviVac;444;285;729;710438;350687;1061125
2022.05_01-07-2022;Пензенская область;21_45_days;EpiVacCorona;914;1896;2810;710438;350687;1061125
2022.05_01-07-2022;Пензенская область;21_45_days;SputnikLite;658;376;1034;710438;350687;1061125
2022.05_01-07-2022;Пензенская область;21_45_days;SputnikV;14397;28961;43358;710438;350687;1061125
2022.05_01-07-2022;Пензенская область;45_75_days;AllVaccines;21008;29960;50968;710438;350687;1061125
2022.05_01-07-2022;Пензенская область;45_75_days;CoviVac;925;511;1436;710438;350687;1061125
2022.05_01-07-2022;Пензенская область;45_75_days;EpiVacCorona;1770;4492;6262;710438;350687;1061125
2022.05_01-07-2022;Пензенская область;45_75_days;SputnikLite;5356;3102;8458;710438;350687;1061125
2022.05_01-07-2022;Пензенская область;45_75_days;SputnikV;12957;21855;34812;710438;350687;1061125
2022.05_01-07-2022;Пензенская область;75_90_days;AllVaccines;15462;12404;27866;710438;350687;1061125
2022.05_01-07-2022;Пензенская область;75_90_days;CoviVac;206;83;289;710438;350687;1061125
2022.05_01-07-2022;Пензенская область;75_90_days;EpiVacCorona;936;1482;2418;710438;350687;1061125
2022.05_01-07-2022;Пензенская область;75_90_days;SputnikLite;7137;3915;11052;710438;350687;1061125
2022.05_01-07-2022;Пензенская область;75_90_days;SputnikV;7183;6924;14107;710438;350687;1061125
2022.05_01-07-2022;Пензенская область;90_105_days;AllVaccines;15876;11684;27560;710438;350687;1061125
2022.05_01-07-2022;Пензенская область;90_105_days;CoviVac;252;101;353;710438;350687;1061125
2022.05_01-07-2022;Пензенская область;90_105_days;EpiVacCorona;580;666;1246;710438;350687;1061125
2022.05_01-07-2022;Пензенская область;90_105_days;SputnikLite;8949;3654;12603;710438;350687;1061125
2022.05_01-07-2022;Пензенская область;90_105_days;SputnikV;6095;7263;13358;710438;350687;1061125
2022.05_01-07-2022;Пермский край;105_165_days;AllVaccines;194706;96729;291435;1423011;574038;1997049
2022.05_01-07-2022;Пермский край;105_165_days;CoviVac;2207;470;2677;1423011;574038;1997049
2022.05_01-07-2022;Пермский край;105_165_days;EpiVacCorona;2670;994;3664;1423011;574038;1997049
2022.05_01-07-2022;Пермский край;105_165_days;SputnikLite;63576;50924;114500;1423011;574038;1997049
2022.05_01-07-2022;Пермский край;105_165_days;SputnikV;126253;44341;170594;1423011;574038;1997049
2022.05_01-07-2022;Пермский край;165_195_days;AllVaccines;128632;55808;184440;1423011;574038;1997049
2022.05_01-07-2022;Пермский край;165_195_days;CoviVac;1298;272;1570;1423011;574038;1997049
2022.05_01-07-2022;Пермский край;165_195_days;EpiVacCorona;2175;769;2944;1423011;574038;1997049
2022.05_01-07-2022;Пермский край;165_195_days;SputnikLite;21312;19217;40529;1423011;574038;1997049
2022.05_01-07-2022;Пермский край;165_195_days;SputnikV;103847;35550;139397;1423011;574038;1997049
2022.05_01-07-2022;Пермский край;21_45_days;AllVaccines;5849;4891;10740;1423011;574038;1997049
2022.05_01-07-2022;Пермский край;21_45_days;CoviVac;203;106;309;1423011;574038;1997049
2022.05_01-07-2022;Пермский край;21_45_days;EpiVacCorona;295;255;550;1423011;574038;1997049
2022.05_01-07-2022;Пермский край;21_45_days;SputnikLite;973;486;1459;1423011;574038;1997049
2022.05_01-07-2022;Пермский край;21_45_days;SputnikV;4378;4044;8422;1423011;574038;1997049
2022.05_01-07-2022;Пермский край;45_75_days;AllVaccines;12715;6526;19241;1423011;574038;1997049
2022.05_01-07-2022;Пермский край;45_75_days;CoviVac;348;66;414;1423011;574038;1997049
2022.05_01-07-2022;Пермский край;45_75_days;EpiVacCorona;576;312;888;1423011;574038;1997049
2022.05_01-07-2022;Пермский край;45_75_days;SputnikLite;3024;1501;4525;1423011;574038;1997049
2022.05_01-07-2022;Пермский край;45_75_days;SputnikV;8767;4647;13414;1423011;574038;1997049
2022.05_01-07-2022;Пермский край;75_90_days;AllVaccines;16263;7902;24165;1423011;574038;1997049
2022.05_01-07-2022;Пермский край;75_90_days;CoviVac;270;45;315;1423011;574038;1997049
2022.05_01-07-2022;Пермский край;75_90_days;EpiVacCorona;326;184;510;1423011;574038;1997049
2022.05_01-07-2022;Пермский край;75_90_days;SputnikLite;6961;3471;10432;1423011;574038;1997049
2022.05_01-07-2022;Пермский край;75_90_days;SputnikV;8706;4202;12908;1423011;574038;1997049
2022.05_01-07-2022;Пермский край;90_105_days;AllVaccines;22006;11609;33615;1423011;574038;1997049
2022.05_01-07-2022;Пермский край;90_105_days;CoviVac;475;96;571;1423011;574038;1997049
2022.05_01-07-2022;Пермский край;90_105_days;EpiVacCorona;511;318;829;1423011;574038;1997049
2022.05_01-07-2022;Пермский край;90_105_days;SputnikLite;12011;6595;18606;1423011;574038;1997049
2022.05_01-07-2022;Пермский край;90_105_days;SputnikV;9009;4600;13609;1423011;574038;1997049
2022.05_01-07-2022;Приморский край;105_165_days;AllVaccines;210519;73834;284353;1086430;416518;1502948
2022.05_01-07-2022;Приморский край;105_165_days;CoviVac;1445;136;1581;1086430;416518;1502948
2022.05_01-07-2022;Приморский край;105_165_days;EpiVacCorona;2983;1590;4573;1086430;416518;1502948
2022.05_01-07-2022;Приморский край;105_165_days;SputnikLite;47652;36409;84061;1086430;416518;1502948
2022.05_01-07-2022;Приморский край;105_165_days;SputnikV;158439;35699;194138;1086430;416518;1502948
2022.05_01-07-2022;Приморский край;165_195_days;AllVaccines;150064;36524;186588;1086430;416518;1502948
2022.05_01-07-2022;Приморский край;165_195_days;CoviVac;3166;279;3445;1086430;416518;1502948
2022.05_01-07-2022;Приморский край;165_195_days;EpiVacCorona;2183;616;2799;1086430;416518;1502948
2022.05_01-07-2022;Приморский край;165_195_days;SputnikLite;26610;13671;40281;1086430;416518;1502948
2022.05_01-07-2022;Приморский край;165_195_days;SputnikV;118105;21958;140063;1086430;416518;1502948
2022.05_01-07-2022;Приморский край;21_45_days;AllVaccines;6307;3112;9419;1086430;416518;1502948
2022.05_01-07-2022;Приморский край;21_45_days;CoviVac;252;54;306;1086430;416518;1502948
2022.05_01-07-2022;Приморский край;21_45_days;EpiVacCorona;504;378;882;1086430;416518;1502948
2022.05_01-07-2022;Приморский край;21_45_days;SputnikLite;3484;1870;5354;1086430;416518;1502948
2022.05_01-07-2022;Приморский край;21_45_days;SputnikV;2067;810;2877;1086430;416518;1502948
2022.05_01-07-2022;Приморский край;45_75_days;AllVaccines;16242;6729;22971;1086430;416518;1502948
2022.05_01-07-2022;Приморский край;45_75_days;CoviVac;280;18;298;1086430;416518;1502948
2022.05_01-07-2022;Приморский край;45_75_days;EpiVacCorona;1488;793;2281;1086430;416518;1502948
2022.05_01-07-2022;Приморский край;45_75_days;SputnikLite;8633;4091;12724;1086430;416518;1502948
2022.05_01-07-2022;Приморский край;45_75_days;SputnikV;5841;1827;7668;1086430;416518;1502948
2022.05_01-07-2022;Приморский край;75_90_days;AllVaccines;14437;5644;20081;1086430;416518;1502948
2022.05_01-07-2022;Приморский край;75_90_days;CoviVac;171;18;189;1086430;416518;1502948
2022.05_01-07-2022;Приморский край;75_90_days;EpiVacCorona;1100;450;1550;1086430;416518;1502948
2022.05_01-07-2022;Приморский край;75_90_days;SputnikLite;7264;3184;10448;1086430;416518;1502948
2022.05_01-07-2022;Приморский край;75_90_days;SputnikV;5902;1992;7894;1086430;416518;1502948
2022.05_01-07-2022;Приморский край;90_105_days;AllVaccines;19595;9294;28889;1086430;416518;1502948
2022.05_01-07-2022;Приморский край;90_105_days;CoviVac;141;19;160;1086430;416518;1502948
2022.05_01-07-2022;Приморский край;90_105_days;EpiVacCorona;741;376;1117;1086430;416518;1502948
2022.05_01-07-2022;Приморский край;90_105_days;SputnikLite;11913;6540;18453;1086430;416518;1502948
2022.05_01-07-2022;Приморский край;90_105_days;SputnikV;6800;2359;9159;1086430;416518;1502948
2022.05_01-07-2022;Псковская область;105_165_days;AllVaccines;38811;22431;61242;337881;166663;504544
2022.05_01-07-2022;Псковская область;105_165_days;CoviVac;821;110;931;337881;166663;504544
2022.05_01-07-2022;Псковская область;105_165_days;EpiVacCorona;1405;732;2137;337881;166663;504544
2022.05_01-07-2022;Псковская область;105_165_days;SputnikLite;14370;12225;26595;337881;166663;504544
2022.05_01-07-2022;Псковская область;105_165_days;SputnikV;22215;9364;31579;337881;166663;504544
2022.05_01-07-2022;Псковская область;165_195_days;AllVaccines;23815;15700;39515;337881;166663;504544
2022.05_01-07-2022;Псковская область;165_195_days;CoviVac;659;127;786;337881;166663;504544
2022.05_01-07-2022;Псковская область;165_195_days;EpiVacCorona;955;429;1384;337881;166663;504544
2022.05_01-07-2022;Псковская область;165_195_days;SputnikLite;7810;8820;16630;337881;166663;504544
2022.05_01-07-2022;Псковская область;165_195_days;SputnikV;14391;6324;20715;337881;166663;504544
2022.05_01-07-2022;Псковская область;21_45_days;AllVaccines;1585;1352;2937;337881;166663;504544
2022.05_01-07-2022;Псковская область;21_45_days;CoviVac;37;9;46;337881;166663;504544
2022.05_01-07-2022;Псковская область;21_45_days;EpiVacCorona;161;88;249;337881;166663;504544
2022.05_01-07-2022;Псковская область;21_45_days;SputnikLite;62;14;76;337881;166663;504544
2022.05_01-07-2022;Псковская область;21_45_days;SputnikV;1325;1241;2566;337881;166663;504544
2022.05_01-07-2022;Псковская область;45_75_days;AllVaccines;3570;1690;5260;337881;166663;504544
2022.05_01-07-2022;Псковская область;45_75_days;CoviVac;107;7;114;337881;166663;504544
2022.05_01-07-2022;Псковская область;45_75_days;EpiVacCorona;244;128;372;337881;166663;504544
2022.05_01-07-2022;Псковская область;45_75_days;SputnikLite;198;132;330;337881;166663;504544
2022.05_01-07-2022;Псковская область;45_75_days;SputnikV;3021;1423;4444;337881;166663;504544
2022.05_01-07-2022;Псковская область;75_90_days;AllVaccines;4188;1990;6178;337881;166663;504544
2022.05_01-07-2022;Псковская область;75_90_days;CoviVac;98;9;107;337881;166663;504544
2022.05_01-07-2022;Псковская область;75_90_days;EpiVacCorona;277;136;413;337881;166663;504544
2022.05_01-07-2022;Псковская область;75_90_days;SputnikLite;823;435;1258;337881;166663;504544
2022.05_01-07-2022;Псковская область;75_90_days;SputnikV;2990;1410;4400;337881;166663;504544
2022.05_01-07-2022;Псковская область;90_105_days;AllVaccines;7220;3891;11111;337881;166663;504544
2022.05_01-07-2022;Псковская область;90_105_days;CoviVac;167;20;187;337881;166663;504544
2022.05_01-07-2022;Псковская область;90_105_days;EpiVacCorona;330;251;581;337881;166663;504544
2022.05_01-07-2022;Псковская область;90_105_days;SputnikLite;2868;1431;4299;337881;166663;504544
2022.05_01-07-2022;Псковская область;90_105_days;SputnikV;3855;2189;6044;337881;166663;504544
2022.05_01-07-2022;РФ;105_165_days;AllVaccines;10819411;4983996;15803407;82332898;33454776;115787674
2022.05_01-07-2022;РФ;105_165_days;CoviVac;128837;29150;157987;82332898;33454776;115787674
2022.05_01-07-2022;РФ;105_165_days;EpiVacCorona;317926;157792;475718;82332898;33454776;115787674
2022.05_01-07-2022;РФ;105_165_days;SputnikLite;4006725;2358568;6365293;82332898;33454776;115787674
2022.05_01-07-2022;РФ;105_165_days;SputnikV;6365923;2438486;8804409;82332898;33454776;115787674
2022.05_01-07-2022;РФ;165_195_days;AllVaccines;7976149;3386467;11362616;82332898;33454776;115787674
2022.05_01-07-2022;РФ;165_195_days;CoviVac;108186;23181;131367;82332898;33454776;115787674
2022.05_01-07-2022;РФ;165_195_days;EpiVacCorona;211445;85505;296950;82332898;33454776;115787674
2022.05_01-07-2022;РФ;165_195_days;SputnikLite;2091818;1339758;3431576;82332898;33454776;115787674
2022.05_01-07-2022;РФ;165_195_days;SputnikV;5564700;1938023;7502723;82332898;33454776;115787674
2022.05_01-07-2022;РФ;21_45_days;AllVaccines;621500;395077;1016577;82332898;33454776;115787674
2022.05_01-07-2022;РФ;21_45_days;CoviVac;27427;8784;36211;82332898;33454776;115787674
2022.05_01-07-2022;РФ;21_45_days;EpiVacCorona;51742;33911;85653;82332898;33454776;115787674
2022.05_01-07-2022;РФ;21_45_days;SputnikLite;131884;66836;198720;82332898;33454776;115787674
2022.05_01-07-2022;РФ;21_45_days;SputnikV;410447;285546;695993;82332898;33454776;115787674
2022.05_01-07-2022;РФ;45_75_days;AllVaccines;1210064;602157;1812221;82332898;33454776;115787674
2022.05_01-07-2022;РФ;45_75_days;CoviVac;31504;9231;40735;82332898;33454776;115787674
2022.05_01-07-2022;РФ;45_75_days;EpiVacCorona;81813;49606;131419;82332898;33454776;115787674
2022.05_01-07-2022;РФ;45_75_days;SputnikLite;308207;144690;452897;82332898;33454776;115787674
2022.05_01-07-2022;РФ;45_75_days;SputnikV;788540;398630;1187170;82332898;33454776;115787674
2022.05_01-07-2022;РФ;75_90_days;AllVaccines;1289226;551929;1841155;82332898;33454776;115787674
2022.05_01-07-2022;РФ;75_90_days;CoviVac;17771;3856;21627;82332898;33454776;115787674
2022.05_01-07-2022;РФ;75_90_days;EpiVacCorona;61220;31067;92287;82332898;33454776;115787674
2022.05_01-07-2022;РФ;75_90_days;SputnikLite;504419;194676;699095;82332898;33454776;115787674
2022.05_01-07-2022;РФ;75_90_days;SputnikV;705816;322330;1028146;82332898;33454776;115787674
2022.05_01-07-2022;РФ;90_105_days;AllVaccines;1669909;728220;2398129;82332898;33454776;115787674
2022.05_01-07-2022;РФ;90_105_days;CoviVac;23949;6005;29954;82332898;33454776;115787674
2022.05_01-07-2022;РФ;90_105_days;EpiVacCorona;60689;37437;98126;82332898;33454776;115787674
2022.05_01-07-2022;РФ;90_105_days;SputnikLite;842931;332089;1175020;82332898;33454776;115787674
2022.05_01-07-2022;РФ;90_105_days;SputnikV;742340;352689;1095029;82332898;33454776;115787674
2022.05_01-07-2022;Республика Адыгея;105_165_days;AllVaccines;23298;11876;35174;256368;104563;360931
2022.05_01-07-2022;Республика Адыгея;105_165_days;CoviVac;207;57;264;256368;104563;360931
2022.05_01-07-2022;Республика Адыгея;105_165_days;EpiVacCorona;801;421;1222;256368;104563;360931
2022.05_01-07-2022;Республика Адыгея;105_165_days;SputnikLite;12203;7019;19222;256368;104563;360931
2022.05_01-07-2022;Республика Адыгея;105_165_days;SputnikV;10087;4379;14466;256368;104563;360931
2022.05_01-07-2022;Республика Адыгея;165_195_days;AllVaccines;19780;8696;28476;256368;104563;360931
2022.05_01-07-2022;Республика Адыгея;165_195_days;CoviVac;360;91;451;256368;104563;360931
2022.05_01-07-2022;Республика Адыгея;165_195_days;EpiVacCorona;508;222;730;256368;104563;360931
2022.05_01-07-2022;Республика Адыгея;165_195_days;SputnikLite;8120;4527;12647;256368;104563;360931
2022.05_01-07-2022;Республика Адыгея;165_195_days;SputnikV;10792;3856;14648;256368;104563;360931
2022.05_01-07-2022;Республика Адыгея;21_45_days;AllVaccines;1026;700;1726;256368;104563;360931
2022.05_01-07-2022;Республика Адыгея;21_45_days;CoviVac;4;1;5;256368;104563;360931
2022.05_01-07-2022;Республика Адыгея;21_45_days;EpiVacCorona;2;4;6;256368;104563;360931
2022.05_01-07-2022;Республика Адыгея;21_45_days;SputnikLite;701;429;1130;256368;104563;360931
2022.05_01-07-2022;Республика Адыгея;21_45_days;SputnikV;319;266;585;256368;104563;360931
2022.05_01-07-2022;Республика Адыгея;45_75_days;AllVaccines;2161;1446;3607;256368;104563;360931
2022.05_01-07-2022;Республика Адыгея;45_75_days;CoviVac;17;1;18;256368;104563;360931
2022.05_01-07-2022;Республика Адыгея;45_75_days;EpiVacCorona;9;9;18;256368;104563;360931
2022.05_01-07-2022;Республика Адыгея;45_75_days;SputnikLite;1286;918;2204;256368;104563;360931
2022.05_01-07-2022;Республика Адыгея;45_75_days;SputnikV;849;518;1367;256368;104563;360931
2022.05_01-07-2022;Республика Адыгея;75_90_days;AllVaccines;3242;1462;4704;256368;104563;360931
2022.05_01-07-2022;Республика Адыгея;75_90_days;CoviVac;19;4;23;256368;104563;360931
2022.05_01-07-2022;Республика Адыгея;75_90_days;EpiVacCorona;40;16;56;256368;104563;360931
2022.05_01-07-2022;Республика Адыгея;75_90_days;SputnikLite;1417;576;1993;256368;104563;360931
2022.05_01-07-2022;Республика Адыгея;75_90_days;SputnikV;1766;866;2632;256368;104563;360931
2022.05_01-07-2022;Республика Адыгея;90_105_days;AllVaccines;3878;1833;5711;256368;104563;360931
2022.05_01-07-2022;Республика Адыгея;90_105_days;CoviVac;29;9;38;256368;104563;360931
2022.05_01-07-2022;Республика Адыгея;90_105_days;EpiVacCorona;81;45;126;256368;104563;360931
2022.05_01-07-2022;Республика Адыгея;90_105_days;SputnikLite;2434;950;3384;256368;104563;360931
2022.05_01-07-2022;Республика Адыгея;90_105_days;SputnikV;1334;829;2163;256368;104563;360931
2022.05_01-07-2022;Республика Алтай;105_165_days;AllVaccines;18886;6493;25379;117210;36468;153678
2022.05_01-07-2022;Республика Алтай;105_165_days;CoviVac;266;55;321;117210;36468;153678
2022.05_01-07-2022;Республика Алтай;105_165_days;EpiVacCorona;476;160;636;117210;36468;153678
2022.05_01-07-2022;Республика Алтай;105_165_days;SputnikLite;12345;4367;16712;117210;36468;153678
2022.05_01-07-2022;Республика Алтай;105_165_days;SputnikV;5799;1911;7710;117210;36468;153678
2022.05_01-07-2022;Республика Алтай;165_195_days;AllVaccines;9995;4782;14777;117210;36468;153678
2022.05_01-07-2022;Республика Алтай;165_195_days;CoviVac;5;6;11;117210;36468;153678
2022.05_01-07-2022;Республика Алтай;165_195_days;EpiVacCorona;152;51;203;117210;36468;153678
2022.05_01-07-2022;Республика Алтай;165_195_days;SputnikLite;7337;3522;10859;117210;36468;153678
2022.05_01-07-2022;Республика Алтай;165_195_days;SputnikV;2501;1203;3704;117210;36468;153678
2022.05_01-07-2022;Республика Алтай;21_45_days;AllVaccines;1537;861;2398;117210;36468;153678
2022.05_01-07-2022;Республика Алтай;21_45_days;CoviVac;175;95;270;117210;36468;153678
2022.05_01-07-2022;Республика Алтай;21_45_days;EpiVacCorona;268;66;334;117210;36468;153678
2022.05_01-07-2022;Республика Алтай;21_45_days;SputnikLite;289;142;431;117210;36468;153678
2022.05_01-07-2022;Республика Алтай;21_45_days;SputnikV;805;558;1363;117210;36468;153678
2022.05_01-07-2022;Республика Алтай;45_75_days;AllVaccines;2490;936;3426;117210;36468;153678
2022.05_01-07-2022;Республика Алтай;45_75_days;CoviVac;142;21;163;117210;36468;153678
2022.05_01-07-2022;Республика Алтай;45_75_days;EpiVacCorona;182;42;224;117210;36468;153678
2022.05_01-07-2022;Республика Алтай;45_75_days;SputnikLite;1023;337;1360;117210;36468;153678
2022.05_01-07-2022;Республика Алтай;45_75_days;SputnikV;1143;536;1679;117210;36468;153678
2022.05_01-07-2022;Республика Алтай;75_90_days;AllVaccines;2410;783;3193;117210;36468;153678
2022.05_01-07-2022;Республика Алтай;75_90_days;CoviVac;104;13;117;117210;36468;153678
2022.05_01-07-2022;Республика Алтай;75_90_days;EpiVacCorona;152;25;177;117210;36468;153678
2022.05_01-07-2022;Республика Алтай;75_90_days;SputnikLite;828;145;973;117210;36468;153678
2022.05_01-07-2022;Республика Алтай;75_90_days;SputnikV;1326;600;1926;117210;36468;153678
2022.05_01-07-2022;Республика Алтай;90_105_days;AllVaccines;3390;1033;4423;117210;36468;153678
2022.05_01-07-2022;Республика Алтай;90_105_days;CoviVac;76;24;100;117210;36468;153678
2022.05_01-07-2022;Республика Алтай;90_105_days;EpiVacCorona;127;47;174;117210;36468;153678
2022.05_01-07-2022;Республика Алтай;90_105_days;SputnikLite;1870;430;2300;117210;36468;153678
2022.05_01-07-2022;Республика Алтай;90_105_days;SputnikV;1317;532;1849;117210;36468;153678
2022.05_01-07-2022;Республика Башкортостан;105_165_days;AllVaccines;320150;124517;444667;2235962;869874;3105836
2022.05_01-07-2022;Республика Башкортостан;105_165_days;CoviVac;8787;2182;10969;2235962;869874;3105836
2022.05_01-07-2022;Республика Башкортостан;105_165_days;EpiVacCorona;10997;6164;17161;2235962;869874;3105836
2022.05_01-07-2022;Республика Башкортостан;105_165_days;SputnikLite;107893;48400;156293;2235962;869874;3105836
2022.05_01-07-2022;Республика Башкортостан;105_165_days;SputnikV;192473;67771;260244;2235962;869874;3105836
2022.05_01-07-2022;Республика Башкортостан;165_195_days;AllVaccines;297138;103813;400951;2235962;869874;3105836
2022.05_01-07-2022;Республика Башкортостан;165_195_days;CoviVac;825;198;1023;2235962;869874;3105836
2022.05_01-07-2022;Республика Башкортостан;165_195_days;EpiVacCorona;7885;3695;11580;2235962;869874;3105836
2022.05_01-07-2022;Республика Башкортостан;165_195_days;SputnikLite;31408;19842;51250;2235962;869874;3105836
2022.05_01-07-2022;Республика Башкортостан;165_195_days;SputnikV;257020;80078;337098;2235962;869874;3105836
2022.05_01-07-2022;Республика Башкортостан;21_45_days;AllVaccines;23839;15186;39025;2235962;869874;3105836
2022.05_01-07-2022;Республика Башкортостан;21_45_days;CoviVac;2253;1136;3389;2235962;869874;3105836
2022.05_01-07-2022;Республика Башкортостан;21_45_days;EpiVacCorona;2386;2031;4417;2235962;869874;3105836
2022.05_01-07-2022;Республика Башкортостан;21_45_days;SputnikLite;5996;1714;7710;2235962;869874;3105836
2022.05_01-07-2022;Республика Башкортостан;21_45_days;SputnikV;13204;10305;23509;2235962;869874;3105836
2022.05_01-07-2022;Республика Башкортостан;45_75_days;AllVaccines;52055;27887;79942;2235962;869874;3105836
2022.05_01-07-2022;Республика Башкортостан;45_75_days;CoviVac;921;344;1265;2235962;869874;3105836
2022.05_01-07-2022;Республика Башкортостан;45_75_days;EpiVacCorona;5710;4249;9959;2235962;869874;3105836
2022.05_01-07-2022;Республика Башкортостан;45_75_days;SputnikLite;13848;4778;18626;2235962;869874;3105836
2022.05_01-07-2022;Республика Башкортостан;45_75_days;SputnikV;31576;18516;50092;2235962;869874;3105836
2022.05_01-07-2022;Республика Башкортостан;75_90_days;AllVaccines;40241;19386;59627;2235962;869874;3105836
2022.05_01-07-2022;Республика Башкортостан;75_90_days;CoviVac;254;59;313;2235962;869874;3105836
2022.05_01-07-2022;Республика Башкортостан;75_90_days;EpiVacCorona;1999;1214;3213;2235962;869874;3105836
2022.05_01-07-2022;Республика Башкортостан;75_90_days;SputnikLite;10607;3103;13710;2235962;869874;3105836
2022.05_01-07-2022;Республика Башкортостан;75_90_days;SputnikV;27381;15010;42391;2235962;869874;3105836
2022.05_01-07-2022;Республика Башкортостан;90_105_days;AllVaccines;44554;22112;66666;2235962;869874;3105836
2022.05_01-07-2022;Республика Башкортостан;90_105_days;CoviVac;363;78;441;2235962;869874;3105836
2022.05_01-07-2022;Республика Башкортостан;90_105_days;EpiVacCorona;1874;1562;3436;2235962;869874;3105836
2022.05_01-07-2022;Республика Башкортостан;90_105_days;SputnikLite;18021;6139;24160;2235962;869874;3105836
2022.05_01-07-2022;Республика Башкортостан;90_105_days;SputnikV;24296;14333;38629;2235962;869874;3105836
2022.05_01-07-2022;Республика Бурятия;105_165_days;AllVaccines;83064;33887;116951;542372;176777;719149
2022.05_01-07-2022;Республика Бурятия;105_165_days;CoviVac;1021;318;1339;542372;176777;719149
2022.05_01-07-2022;Республика Бурятия;105_165_days;EpiVacCorona;1459;881;2340;542372;176777;719149
2022.05_01-07-2022;Республика Бурятия;105_165_days;SputnikLite;34725;17114;51839;542372;176777;719149
2022.05_01-07-2022;Республика Бурятия;105_165_days;SputnikV;45859;15574;61433;542372;176777;719149
2022.05_01-07-2022;Республика Бурятия;165_195_days;AllVaccines;45898;17940;63838;542372;176777;719149
2022.05_01-07-2022;Республика Бурятия;165_195_days;CoviVac;645;132;777;542372;176777;719149
2022.05_01-07-2022;Республика Бурятия;165_195_days;EpiVacCorona;918;476;1394;542372;176777;719149
2022.05_01-07-2022;Республика Бурятия;165_195_days;SputnikLite;14516;7700;22216;542372;176777;719149
2022.05_01-07-2022;Республика Бурятия;165_195_days;SputnikV;29819;9632;39451;542372;176777;719149
2022.05_01-07-2022;Республика Бурятия;21_45_days;AllVaccines;5100;2338;7438;542372;176777;719149
2022.05_01-07-2022;Республика Бурятия;21_45_days;CoviVac;380;165;545;542372;176777;719149
2022.05_01-07-2022;Республика Бурятия;21_45_days;EpiVacCorona;939;593;1532;542372;176777;719149
2022.05_01-07-2022;Республика Бурятия;21_45_days;SputnikLite;566;194;760;542372;176777;719149
2022.05_01-07-2022;Республика Бурятия;21_45_days;SputnikV;3215;1386;4601;542372;176777;719149
2022.05_01-07-2022;Республика Бурятия;45_75_days;AllVaccines;12641;4691;17332;542372;176777;719149
2022.05_01-07-2022;Республика Бурятия;45_75_days;CoviVac;270;89;359;542372;176777;719149
2022.05_01-07-2022;Республика Бурятия;45_75_days;EpiVacCorona;960;426;1386;542372;176777;719149
2022.05_01-07-2022;Республика Бурятия;45_75_days;SputnikLite;3441;1226;4667;542372;176777;719149
2022.05_01-07-2022;Республика Бурятия;45_75_days;SputnikV;7970;2950;10920;542372;176777;719149
2022.05_01-07-2022;Республика Бурятия;75_90_days;AllVaccines;13433;5141;18574;542372;176777;719149
2022.05_01-07-2022;Республика Бурятия;75_90_days;CoviVac;118;36;154;542372;176777;719149
2022.05_01-07-2022;Республика Бурятия;75_90_days;EpiVacCorona;385;194;579;542372;176777;719149
2022.05_01-07-2022;Республика Бурятия;75_90_days;SputnikLite;4519;1524;6043;542372;176777;719149
2022.05_01-07-2022;Республика Бурятия;75_90_days;SputnikV;8411;3387;11798;542372;176777;719149
2022.05_01-07-2022;Республика Бурятия;90_105_days;AllVaccines;15735;6463;22198;542372;176777;719149
2022.05_01-07-2022;Республика Бурятия;90_105_days;CoviVac;125;53;178;542372;176777;719149
2022.05_01-07-2022;Республика Бурятия;90_105_days;EpiVacCorona;575;307;882;542372;176777;719149
2022.05_01-07-2022;Республика Бурятия;90_105_days;SputnikLite;6736;2231;8967;542372;176777;719149
2022.05_01-07-2022;Республика Бурятия;90_105_days;SputnikV;8299;3872;12171;542372;176777;719149
2022.05_01-07-2022;Республика Дагестан;105_165_days;AllVaccines;176796;37243;214039;1856109;394621;2250730
2022.05_01-07-2022;Республика Дагестан;105_165_days;CoviVac;2357;428;2785;1856109;394621;2250730
2022.05_01-07-2022;Республика Дагестан;105_165_days;EpiVacCorona;18396;3300;21696;1856109;394621;2250730
2022.05_01-07-2022;Республика Дагестан;105_165_days;SputnikLite;43986;9604;53590;1856109;394621;2250730
2022.05_01-07-2022;Республика Дагестан;105_165_days;SputnikV;112057;23911;135968;1856109;394621;2250730
2022.05_01-07-2022;Республика Дагестан;165_195_days;AllVaccines;101849;16382;118231;1856109;394621;2250730
2022.05_01-07-2022;Республика Дагестан;165_195_days;CoviVac;758;145;903;1856109;394621;2250730
2022.05_01-07-2022;Республика Дагестан;165_195_days;EpiVacCorona;5898;743;6641;1856109;394621;2250730
2022.05_01-07-2022;Республика Дагестан;165_195_days;SputnikLite;20189;3378;23567;1856109;394621;2250730
2022.05_01-07-2022;Республика Дагестан;165_195_days;SputnikV;75004;12116;87120;1856109;394621;2250730
2022.05_01-07-2022;Республика Дагестан;21_45_days;AllVaccines;43095;14462;57557;1856109;394621;2250730
2022.05_01-07-2022;Республика Дагестан;21_45_days;CoviVac;2677;874;3551;1856109;394621;2250730
2022.05_01-07-2022;Республика Дагестан;21_45_days;EpiVacCorona;5743;3023;8766;1856109;394621;2250730
2022.05_01-07-2022;Республика Дагестан;21_45_days;SputnikLite;331;69;400;1856109;394621;2250730
2022.05_01-07-2022;Республика Дагестан;21_45_days;SputnikV;34344;10496;44840;1856109;394621;2250730
2022.05_01-07-2022;Республика Дагестан;45_75_days;AllVaccines;97510;26742;124252;1856109;394621;2250730
2022.05_01-07-2022;Республика Дагестан;45_75_days;CoviVac;3907;1397;5304;1856109;394621;2250730
2022.05_01-07-2022;Республика Дагестан;45_75_days;EpiVacCorona;12712;3686;16398;1856109;394621;2250730
2022.05_01-07-2022;Республика Дагестан;45_75_days;SputnikLite;4670;1204;5874;1856109;394621;2250730
2022.05_01-07-2022;Республика Дагестан;45_75_days;SputnikV;76221;20455;96676;1856109;394621;2250730
2022.05_01-07-2022;Республика Дагестан;75_90_days;AllVaccines;65910;18750;84660;1856109;394621;2250730
2022.05_01-07-2022;Республика Дагестан;75_90_days;CoviVac;2075;351;2426;1856109;394621;2250730
2022.05_01-07-2022;Республика Дагестан;75_90_days;EpiVacCorona;7803;2042;9845;1856109;394621;2250730
2022.05_01-07-2022;Республика Дагестан;75_90_days;SputnikLite;5557;1473;7030;1856109;394621;2250730
2022.05_01-07-2022;Республика Дагестан;75_90_days;SputnikV;50475;14884;65359;1856109;394621;2250730
2022.05_01-07-2022;Республика Дагестан;90_105_days;AllVaccines;101660;28607;130267;1856109;394621;2250730
2022.05_01-07-2022;Республика Дагестан;90_105_days;CoviVac;988;198;1186;1856109;394621;2250730
2022.05_01-07-2022;Республика Дагестан;90_105_days;EpiVacCorona;3858;799;4657;1856109;394621;2250730
2022.05_01-07-2022;Республика Дагестан;90_105_days;SputnikLite;10217;1730;11947;1856109;394621;2250730
2022.05_01-07-2022;Республика Дагестан;90_105_days;SputnikV;86597;25880;112477;1856109;394621;2250730
2022.05_01-07-2022;Республика Ингушетия;105_165_days;AllVaccines;67849;14140;81989;295583;61477;357060
2022.05_01-07-2022;Республика Ингушетия;105_165_days;CoviVac;382;188;570;295583;61477;357060
2022.05_01-07-2022;Республика Ингушетия;105_165_days;EpiVacCorona;593;148;741;295583;61477;357060
2022.05_01-07-2022;Республика Ингушетия;105_165_days;SputnikLite;37207;7230;44437;295583;61477;357060
2022.05_01-07-2022;Республика Ингушетия;105_165_days;SputnikV;29667;6574;36241;295583;61477;357060
2022.05_01-07-2022;Республика Ингушетия;165_195_days;AllVaccines;15790;3574;19364;295583;61477;357060
2022.05_01-07-2022;Республика Ингушетия;165_195_days;CoviVac;9;7;16;295583;61477;357060
2022.05_01-07-2022;Республика Ингушетия;165_195_days;SputnikLite;7938;2187;10125;295583;61477;357060
2022.05_01-07-2022;Республика Ингушетия;165_195_days;SputnikV;7843;1380;9223;295583;61477;357060
2022.05_01-07-2022;Республика Ингушетия;21_45_days;AllVaccines;8586;1332;9918;295583;61477;357060
2022.05_01-07-2022;Республика Ингушетия;21_45_days;CoviVac;197;22;219;295583;61477;357060
2022.05_01-07-2022;Республика Ингушетия;21_45_days;EpiVacCorona;5307;898;6205;295583;61477;357060
2022.05_01-07-2022;Республика Ингушетия;21_45_days;SputnikLite;349;63;412;295583;61477;357060
2022.05_01-07-2022;Республика Ингушетия;21_45_days;SputnikV;2733;349;3082;295583;61477;357060
2022.05_01-07-2022;Республика Ингушетия;45_75_days;AllVaccines;7063;1147;8210;295583;61477;357060
2022.05_01-07-2022;Республика Ингушетия;45_75_days;CoviVac;69;4;73;295583;61477;357060
2022.05_01-07-2022;Республика Ингушетия;45_75_days;EpiVacCorona;2208;443;2651;295583;61477;357060
2022.05_01-07-2022;Республика Ингушетия;45_75_days;SputnikLite;1711;219;1930;295583;61477;357060
2022.05_01-07-2022;Республика Ингушетия;45_75_days;SputnikV;3075;481;3556;295583;61477;357060
2022.05_01-07-2022;Республика Ингушетия;75_90_days;AllVaccines;10008;1642;11650;295583;61477;357060
2022.05_01-07-2022;Республика Ингушетия;75_90_days;CoviVac;27;5;32;295583;61477;357060
2022.05_01-07-2022;Республика Ингушетия;75_90_days;EpiVacCorona;2881;529;3410;295583;61477;357060
2022.05_01-07-2022;Республика Ингушетия;75_90_days;SputnikLite;3789;551;4340;295583;61477;357060
2022.05_01-07-2022;Республика Ингушетия;75_90_days;SputnikV;3311;557;3868;295583;61477;357060
2022.05_01-07-2022;Республика Ингушетия;90_105_days;AllVaccines;8497;1312;9809;295583;61477;357060
2022.05_01-07-2022;Республика Ингушетия;90_105_days;CoviVac;11;0;11;295583;61477;357060
2022.05_01-07-2022;Республика Ингушетия;90_105_days;EpiVacCorona;42;8;50;295583;61477;357060
2022.05_01-07-2022;Республика Ингушетия;90_105_days;SputnikLite;3588;534;4122;295583;61477;357060
2022.05_01-07-2022;Республика Ингушетия;90_105_days;SputnikV;4856;770;5626;295583;61477;357060
2022.05_01-07-2022;Республика Калмыкия;105_165_days;AllVaccines;17277;7030;24307;150440;54890;205330
2022.05_01-07-2022;Республика Калмыкия;105_165_days;CoviVac;400;102;502;150440;54890;205330
2022.05_01-07-2022;Республика Калмыкия;105_165_days;EpiVacCorona;418;237;655;150440;54890;205330
2022.05_01-07-2022;Республика Калмыкия;105_165_days;SputnikLite;13266;5540;18806;150440;54890;205330
2022.05_01-07-2022;Республика Калмыкия;105_165_days;SputnikV;3193;1151;4344;150440;54890;205330
2022.05_01-07-2022;Республика Калмыкия;165_195_days;AllVaccines;19765;8566;28331;150440;54890;205330
2022.05_01-07-2022;Республика Калмыкия;165_195_days;CoviVac;445;88;533;150440;54890;205330
2022.05_01-07-2022;Республика Калмыкия;165_195_days;EpiVacCorona;54;24;78;150440;54890;205330
2022.05_01-07-2022;Республика Калмыкия;165_195_days;SputnikLite;16612;7149;23761;150440;54890;205330
2022.05_01-07-2022;Республика Калмыкия;165_195_days;SputnikV;2654;1305;3959;150440;54890;205330
2022.05_01-07-2022;Республика Калмыкия;21_45_days;AllVaccines;1265;908;2173;150440;54890;205330
2022.05_01-07-2022;Республика Калмыкия;21_45_days;CoviVac;4;0;4;150440;54890;205330
2022.05_01-07-2022;Республика Калмыкия;21_45_days;EpiVacCorona;22;16;38;150440;54890;205330
2022.05_01-07-2022;Республика Калмыкия;21_45_days;SputnikLite;1027;757;1784;150440;54890;205330
2022.05_01-07-2022;Республика Калмыкия;21_45_days;SputnikV;212;135;347;150440;54890;205330
2022.05_01-07-2022;Республика Калмыкия;45_75_days;AllVaccines;1475;933;2408;150440;54890;205330
2022.05_01-07-2022;Республика Калмыкия;45_75_days;CoviVac;7;1;8;150440;54890;205330
2022.05_01-07-2022;Республика Калмыкия;45_75_days;EpiVacCorona;58;32;90;150440;54890;205330
2022.05_01-07-2022;Республика Калмыкия;45_75_days;SputnikLite;1092;719;1811;150440;54890;205330
2022.05_01-07-2022;Республика Калмыкия;45_75_days;SputnikV;318;181;499;150440;54890;205330
2022.05_01-07-2022;Республика Калмыкия;75_90_days;AllVaccines;1623;703;2326;150440;54890;205330
2022.05_01-07-2022;Республика Калмыкия;75_90_days;CoviVac;11;2;13;150440;54890;205330
2022.05_01-07-2022;Республика Калмыкия;75_90_days;EpiVacCorona;72;15;87;150440;54890;205330
2022.05_01-07-2022;Республика Калмыкия;75_90_days;SputnikLite;1264;549;1813;150440;54890;205330
2022.05_01-07-2022;Республика Калмыкия;75_90_days;SputnikV;276;137;413;150440;54890;205330
2022.05_01-07-2022;Республика Калмыкия;90_105_days;AllVaccines;2465;1085;3550;150440;54890;205330
2022.05_01-07-2022;Республика Калмыкия;90_105_days;CoviVac;16;12;28;150440;54890;205330
2022.05_01-07-2022;Республика Калмыкия;90_105_days;EpiVacCorona;40;8;48;150440;54890;205330
2022.05_01-07-2022;Республика Калмыкия;90_105_days;SputnikLite;1990;849;2839;150440;54890;205330
2022.05_01-07-2022;Республика Калмыкия;90_105_days;SputnikV;419;216;635;150440;54890;205330
2022.05_01-07-2022;Республика Карелия;105_165_days;AllVaccines;37681;22393;60074;334874;149526;484400
2022.05_01-07-2022;Республика Карелия;105_165_days;CoviVac;919;213;1132;334874;149526;484400
2022.05_01-07-2022;Республика Карелия;105_165_days;EpiVacCorona;1472;858;2330;334874;149526;484400
2022.05_01-07-2022;Республика Карелия;105_165_days;SputnikLite;16680;11623;28303;334874;149526;484400
2022.05_01-07-2022;Республика Карелия;105_165_days;SputnikV;18610;9699;28309;334874;149526;484400
2022.05_01-07-2022;Республика Карелия;165_195_days;AllVaccines;24491;20847;45338;334874;149526;484400
2022.05_01-07-2022;Республика Карелия;165_195_days;CoviVac;703;177;880;334874;149526;484400
2022.05_01-07-2022;Республика Карелия;165_195_days;EpiVacCorona;449;323;772;334874;149526;484400
2022.05_01-07-2022;Республика Карелия;165_195_days;SputnikLite;13375;13087;26462;334874;149526;484400
2022.05_01-07-2022;Республика Карелия;165_195_days;SputnikV;9964;7260;17224;334874;149526;484400
2022.05_01-07-2022;Республика Карелия;21_45_days;AllVaccines;2490;2497;4987;334874;149526;484400
2022.05_01-07-2022;Республика Карелия;21_45_days;CoviVac;23;5;28;334874;149526;484400
2022.05_01-07-2022;Республика Карелия;21_45_days;EpiVacCorona;38;62;100;334874;149526;484400
2022.05_01-07-2022;Республика Карелия;21_45_days;SputnikLite;1344;1365;2709;334874;149526;484400
2022.05_01-07-2022;Республика Карелия;21_45_days;SputnikV;1085;1065;2150;334874;149526;484400
2022.05_01-07-2022;Республика Карелия;45_75_days;AllVaccines;6441;4291;10732;334874;149526;484400
2022.05_01-07-2022;Республика Карелия;45_75_days;CoviVac;82;20;102;334874;149526;484400
2022.05_01-07-2022;Республика Карелия;45_75_days;EpiVacCorona;183;120;303;334874;149526;484400
2022.05_01-07-2022;Республика Карелия;45_75_days;SputnikLite;3617;2619;6236;334874;149526;484400
2022.05_01-07-2022;Республика Карелия;45_75_days;SputnikV;2559;1532;4091;334874;149526;484400
2022.05_01-07-2022;Республика Карелия;75_90_days;AllVaccines;6141;3383;9524;334874;149526;484400
2022.05_01-07-2022;Республика Карелия;75_90_days;CoviVac;99;12;111;334874;149526;484400
2022.05_01-07-2022;Республика Карелия;75_90_days;EpiVacCorona;197;125;322;334874;149526;484400
2022.05_01-07-2022;Республика Карелия;75_90_days;SputnikLite;2576;1281;3857;334874;149526;484400
2022.05_01-07-2022;Республика Карелия;75_90_days;SputnikV;3269;1965;5234;334874;149526;484400
2022.05_01-07-2022;Республика Карелия;90_105_days;AllVaccines;6392;3358;9750;334874;149526;484400
2022.05_01-07-2022;Республика Карелия;90_105_days;CoviVac;181;40;221;334874;149526;484400
2022.05_01-07-2022;Республика Карелия;90_105_days;EpiVacCorona;311;222;533;334874;149526;484400
2022.05_01-07-2022;Республика Карелия;90_105_days;SputnikLite;3721;1492;5213;334874;149526;484400
2022.05_01-07-2022;Республика Карелия;90_105_days;SputnikV;2179;1604;3783;334874;149526;484400
2022.05_01-07-2022;Республика Коми;105_165_days;AllVaccines;49271;23635;72906;465210;166370;631580
2022.05_01-07-2022;Республика Коми;105_165_days;CoviVac;641;155;796;465210;166370;631580
2022.05_01-07-2022;Республика Коми;105_165_days;EpiVacCorona;1507;664;2171;465210;166370;631580
2022.05_01-07-2022;Республика Коми;105_165_days;SputnikLite;25028;12727;37755;465210;166370;631580
2022.05_01-07-2022;Республика Коми;105_165_days;SputnikV;22095;10089;32184;465210;166370;631580
2022.05_01-07-2022;Республика Коми;165_195_days;AllVaccines;32978;17420;50398;465210;166370;631580
2022.05_01-07-2022;Республика Коми;165_195_days;CoviVac;451;98;549;465210;166370;631580
2022.05_01-07-2022;Республика Коми;165_195_days;EpiVacCorona;412;150;562;465210;166370;631580
2022.05_01-07-2022;Республика Коми;165_195_days;SputnikLite;21411;11254;32665;465210;166370;631580
2022.05_01-07-2022;Республика Коми;165_195_days;SputnikV;10704;5918;16622;465210;166370;631580
2022.05_01-07-2022;Республика Коми;21_45_days;AllVaccines;3031;1397;4428;465210;166370;631580
2022.05_01-07-2022;Республика Коми;21_45_days;CoviVac;117;49;166;465210;166370;631580
2022.05_01-07-2022;Республика Коми;21_45_days;EpiVacCorona;103;51;154;465210;166370;631580
2022.05_01-07-2022;Республика Коми;21_45_days;SputnikLite;1187;485;1672;465210;166370;631580
2022.05_01-07-2022;Республика Коми;21_45_days;SputnikV;1624;812;2436;465210;166370;631580
2022.05_01-07-2022;Республика Коми;45_75_days;AllVaccines;8727;3313;12040;465210;166370;631580
2022.05_01-07-2022;Республика Коми;45_75_days;CoviVac;127;55;182;465210;166370;631580
2022.05_01-07-2022;Республика Коми;45_75_days;EpiVacCorona;221;63;284;465210;166370;631580
2022.05_01-07-2022;Республика Коми;45_75_days;SputnikLite;4108;1472;5580;465210;166370;631580
2022.05_01-07-2022;Республика Коми;45_75_days;SputnikV;4271;1723;5994;465210;166370;631580
2022.05_01-07-2022;Республика Коми;75_90_days;AllVaccines;5961;2714;8675;465210;166370;631580
2022.05_01-07-2022;Республика Коми;75_90_days;CoviVac;121;25;146;465210;166370;631580
2022.05_01-07-2022;Республика Коми;75_90_days;EpiVacCorona;149;81;230;465210;166370;631580
2022.05_01-07-2022;Республика Коми;75_90_days;SputnikLite;2189;672;2861;465210;166370;631580
2022.05_01-07-2022;Республика Коми;75_90_days;SputnikV;3502;1936;5438;465210;166370;631580
2022.05_01-07-2022;Республика Коми;90_105_days;AllVaccines;7657;3311;10968;465210;166370;631580
2022.05_01-07-2022;Республика Коми;90_105_days;CoviVac;159;36;195;465210;166370;631580
2022.05_01-07-2022;Республика Коми;90_105_days;EpiVacCorona;318;184;502;465210;166370;631580
2022.05_01-07-2022;Республика Коми;90_105_days;SputnikLite;4555;1513;6068;465210;166370;631580
2022.05_01-07-2022;Республика Коми;90_105_days;SputnikV;2625;1578;4203;465210;166370;631580
2022.05_01-07-2022;Республика Крым;105_165_days;AllVaccines;187986;95436;283422;1036087;480146;1516233
2022.05_01-07-2022;Республика Крым;105_165_days;CoviVac;1355;458;1813;1036087;480146;1516233
2022.05_01-07-2022;Республика Крым;105_165_days;EpiVacCorona;4483;2420;6903;1036087;480146;1516233
2022.05_01-07-2022;Республика Крым;105_165_days;SputnikLite;68111;57888;125999;1036087;480146;1516233
2022.05_01-07-2022;Республика Крым;105_165_days;SputnikV;114037;34670;148707;1036087;480146;1516233
2022.05_01-07-2022;Республика Крым;165_195_days;AllVaccines;208866;53301;262167;1036087;480146;1516233
2022.05_01-07-2022;Республика Крым;165_195_days;CoviVac;2021;434;2455;1036087;480146;1516233
2022.05_01-07-2022;Республика Крым;165_195_days;EpiVacCorona;5482;1678;7160;1036087;480146;1516233
2022.05_01-07-2022;Республика Крым;165_195_days;SputnikLite;17913;19633;37546;1036087;480146;1516233
2022.05_01-07-2022;Республика Крым;165_195_days;SputnikV;183450;31556;215006;1036087;480146;1516233
2022.05_01-07-2022;Республика Крым;21_45_days;AllVaccines;7985;4658;12643;1036087;480146;1516233
2022.05_01-07-2022;Республика Крым;21_45_days;CoviVac;430;160;590;1036087;480146;1516233
2022.05_01-07-2022;Республика Крым;21_45_days;EpiVacCorona;597;425;1022;1036087;480146;1516233
2022.05_01-07-2022;Республика Крым;21_45_days;SputnikLite;492;86;578;1036087;480146;1516233
2022.05_01-07-2022;Республика Крым;21_45_days;SputnikV;6466;3987;10453;1036087;480146;1516233
2022.05_01-07-2022;Республика Крым;45_75_days;AllVaccines;11185;5506;16691;1036087;480146;1516233
2022.05_01-07-2022;Республика Крым;45_75_days;CoviVac;368;107;475;1036087;480146;1516233
2022.05_01-07-2022;Республика Крым;45_75_days;EpiVacCorona;1362;787;2149;1036087;480146;1516233
2022.05_01-07-2022;Республика Крым;45_75_days;SputnikLite;549;249;798;1036087;480146;1516233
2022.05_01-07-2022;Республика Крым;45_75_days;SputnikV;8906;4363;13269;1036087;480146;1516233
2022.05_01-07-2022;Республика Крым;75_90_days;AllVaccines;11478;4614;16092;1036087;480146;1516233
2022.05_01-07-2022;Республика Крым;75_90_days;CoviVac;214;65;279;1036087;480146;1516233
2022.05_01-07-2022;Республика Крым;75_90_days;EpiVacCorona;1480;727;2207;1036087;480146;1516233
2022.05_01-07-2022;Республика Крым;75_90_days;SputnikLite;3322;1352;4674;1036087;480146;1516233
2022.05_01-07-2022;Республика Крым;75_90_days;SputnikV;6462;2470;8932;1036087;480146;1516233
2022.05_01-07-2022;Республика Крым;90_105_days;AllVaccines;18237;9529;27766;1036087;480146;1516233
2022.05_01-07-2022;Республика Крым;90_105_days;CoviVac;246;97;343;1036087;480146;1516233
2022.05_01-07-2022;Республика Крым;90_105_days;EpiVacCorona;1161;737;1898;1036087;480146;1516233
2022.05_01-07-2022;Республика Крым;90_105_days;SputnikLite;9864;5382;15246;1036087;480146;1516233
2022.05_01-07-2022;Республика Крым;90_105_days;SputnikV;6966;3313;10279;1036087;480146;1516233
2022.05_01-07-2022;Республика Марий Эл;105_165_days;AllVaccines;57818;24622;82440;370626;156749;527375
2022.05_01-07-2022;Республика Марий Эл;105_165_days;CoviVac;589;193;782;370626;156749;527375
2022.05_01-07-2022;Республика Марий Эл;105_165_days;EpiVacCorona;2275;995;3270;370626;156749;527375
2022.05_01-07-2022;Республика Марий Эл;105_165_days;SputnikLite;25305;12426;37731;370626;156749;527375
2022.05_01-07-2022;Республика Марий Эл;105_165_days;SputnikV;29649;11008;40657;370626;156749;527375
2022.05_01-07-2022;Республика Марий Эл;165_195_days;AllVaccines;41314;17405;58719;370626;156749;527375
2022.05_01-07-2022;Республика Марий Эл;165_195_days;CoviVac;417;122;539;370626;156749;527375
2022.05_01-07-2022;Республика Марий Эл;165_195_days;EpiVacCorona;3207;878;4085;370626;156749;527375
2022.05_01-07-2022;Республика Марий Эл;165_195_days;SputnikLite;14396;7905;22301;370626;156749;527375
2022.05_01-07-2022;Республика Марий Эл;165_195_days;SputnikV;23294;8500;31794;370626;156749;527375
2022.05_01-07-2022;Республика Марий Эл;21_45_days;AllVaccines;2011;1093;3104;370626;156749;527375
2022.05_01-07-2022;Республика Марий Эл;21_45_days;CoviVac;29;3;32;370626;156749;527375
2022.05_01-07-2022;Республика Марий Эл;21_45_days;EpiVacCorona;111;39;150;370626;156749;527375
2022.05_01-07-2022;Республика Марий Эл;21_45_days;SputnikLite;625;66;691;370626;156749;527375
2022.05_01-07-2022;Республика Марий Эл;21_45_days;SputnikV;1246;985;2231;370626;156749;527375
2022.05_01-07-2022;Республика Марий Эл;45_75_days;AllVaccines;2533;2437;4970;370626;156749;527375
2022.05_01-07-2022;Республика Марий Эл;45_75_days;CoviVac;251;142;393;370626;156749;527375
2022.05_01-07-2022;Республика Марий Эл;45_75_days;EpiVacCorona;167;240;407;370626;156749;527375
2022.05_01-07-2022;Республика Марий Эл;45_75_days;SputnikLite;555;308;863;370626;156749;527375
2022.05_01-07-2022;Республика Марий Эл;45_75_days;SputnikV;1560;1747;3307;370626;156749;527375
2022.05_01-07-2022;Республика Марий Эл;75_90_days;AllVaccines;5028;4508;9536;370626;156749;527375
2022.05_01-07-2022;Республика Марий Эл;75_90_days;CoviVac;110;79;189;370626;156749;527375
2022.05_01-07-2022;Республика Марий Эл;75_90_days;EpiVacCorona;147;195;342;370626;156749;527375
2022.05_01-07-2022;Республика Марий Эл;75_90_days;SputnikLite;3364;2770;6134;370626;156749;527375
2022.05_01-07-2022;Республика Марий Эл;75_90_days;SputnikV;1407;1464;2871;370626;156749;527375
2022.05_01-07-2022;Республика Марий Эл;90_105_days;AllVaccines;5520;4013;9533;370626;156749;527375
2022.05_01-07-2022;Республика Марий Эл;90_105_days;CoviVac;84;35;119;370626;156749;527375
2022.05_01-07-2022;Республика Марий Эл;90_105_days;EpiVacCorona;485;467;952;370626;156749;527375
2022.05_01-07-2022;Республика Марий Эл;90_105_days;SputnikLite;3192;2358;5550;370626;156749;527375
2022.05_01-07-2022;Республика Марий Эл;90_105_days;SputnikV;1759;1153;2912;370626;156749;527375
2022.05_01-07-2022;Республика Мордовия;105_165_days;AllVaccines;69941;34735;104676;448319;198808;647127
2022.05_01-07-2022;Республика Мордовия;105_165_days;CoviVac;1025;300;1325;448319;198808;647127
2022.05_01-07-2022;Республика Мордовия;105_165_days;EpiVacCorona;2807;1418;4225;448319;198808;647127
2022.05_01-07-2022;Республика Мордовия;105_165_days;SputnikLite;36357;18060;54417;448319;198808;647127
2022.05_01-07-2022;Республика Мордовия;105_165_days;SputnikV;29752;14957;44709;448319;198808;647127
2022.05_01-07-2022;Республика Мордовия;165_195_days;AllVaccines;51309;28053;79362;448319;198808;647127
2022.05_01-07-2022;Республика Мордовия;165_195_days;CoviVac;880;232;1112;448319;198808;647127
2022.05_01-07-2022;Республика Мордовия;165_195_days;EpiVacCorona;1459;480;1939;448319;198808;647127
2022.05_01-07-2022;Республика Мордовия;165_195_days;SputnikLite;16930;12850;29780;448319;198808;647127
2022.05_01-07-2022;Республика Мордовия;165_195_days;SputnikV;32040;14491;46531;448319;198808;647127
2022.05_01-07-2022;Республика Мордовия;21_45_days;AllVaccines;11882;8491;20373;448319;198808;647127
2022.05_01-07-2022;Республика Мордовия;21_45_days;CoviVac;294;90;384;448319;198808;647127
2022.05_01-07-2022;Республика Мордовия;21_45_days;EpiVacCorona;736;759;1495;448319;198808;647127
2022.05_01-07-2022;Республика Мордовия;21_45_days;SputnikLite;2814;2014;4828;448319;198808;647127
2022.05_01-07-2022;Республика Мордовия;21_45_days;SputnikV;8038;5628;13666;448319;198808;647127
2022.05_01-07-2022;Республика Мордовия;45_75_days;AllVaccines;12499;7408;19907;448319;198808;647127
2022.05_01-07-2022;Республика Мордовия;45_75_days;CoviVac;298;157;455;448319;198808;647127
2022.05_01-07-2022;Республика Мордовия;45_75_days;EpiVacCorona;887;609;1496;448319;198808;647127
2022.05_01-07-2022;Республика Мордовия;45_75_days;SputnikLite;5546;2917;8463;448319;198808;647127
2022.05_01-07-2022;Республика Мордовия;45_75_days;SputnikV;5768;3725;9493;448319;198808;647127
2022.05_01-07-2022;Республика Мордовия;75_90_days;AllVaccines;13258;6880;20138;448319;198808;647127
2022.05_01-07-2022;Республика Мордовия;75_90_days;CoviVac;153;25;178;448319;198808;647127
2022.05_01-07-2022;Республика Мордовия;75_90_days;EpiVacCorona;1405;966;2371;448319;198808;647127
2022.05_01-07-2022;Республика Мордовия;75_90_days;SputnikLite;6846;3236;10082;448319;198808;647127
2022.05_01-07-2022;Республика Мордовия;75_90_days;SputnikV;4854;2653;7507;448319;198808;647127
2022.05_01-07-2022;Республика Мордовия;90_105_days;AllVaccines;15048;6662;21710;448319;198808;647127
2022.05_01-07-2022;Республика Мордовия;90_105_days;CoviVac;195;52;247;448319;198808;647127
2022.05_01-07-2022;Республика Мордовия;90_105_days;EpiVacCorona;1331;649;1980;448319;198808;647127
2022.05_01-07-2022;Республика Мордовия;90_105_days;SputnikLite;8430;3064;11494;448319;198808;647127
2022.05_01-07-2022;Республика Мордовия;90_105_days;SputnikV;5092;2897;7989;448319;198808;647127
2022.05_01-07-2022;Республика Саха (Якутия);105_165_days;AllVaccines;71962;20122;92084;568643;148395;717038
2022.05_01-07-2022;Республика Саха (Якутия);105_165_days;CoviVac;1198;162;1360;568643;148395;717038
2022.05_01-07-2022;Республика Саха (Якутия);105_165_days;EpiVacCorona;766;311;1077;568643;148395;717038
2022.05_01-07-2022;Республика Саха (Якутия);105_165_days;SputnikLite;37814;10760;48574;568643;148395;717038
2022.05_01-07-2022;Республика Саха (Якутия);105_165_days;SputnikV;32184;8889;41073;568643;148395;717038
2022.05_01-07-2022;Республика Саха (Якутия);165_195_days;AllVaccines;47888;14052;61940;568643;148395;717038
2022.05_01-07-2022;Республика Саха (Якутия);165_195_days;CoviVac;888;167;1055;568643;148395;717038
2022.05_01-07-2022;Республика Саха (Якутия);165_195_days;EpiVacCorona;386;180;566;568643;148395;717038
2022.05_01-07-2022;Республика Саха (Якутия);165_195_days;SputnikLite;30682;9334;40016;568643;148395;717038
2022.05_01-07-2022;Республика Саха (Якутия);165_195_days;SputnikV;15932;4371;20303;568643;148395;717038
2022.05_01-07-2022;Республика Саха (Якутия);21_45_days;AllVaccines;4630;1121;5751;568643;148395;717038
2022.05_01-07-2022;Республика Саха (Якутия);21_45_days;CoviVac;103;12;115;568643;148395;717038
2022.05_01-07-2022;Республика Саха (Якутия);21_45_days;EpiVacCorona;451;89;540;568643;148395;717038
2022.05_01-07-2022;Республика Саха (Якутия);21_45_days;SputnikLite;811;253;1064;568643;148395;717038
2022.05_01-07-2022;Республика Саха (Якутия);21_45_days;SputnikV;3265;767;4032;568643;148395;717038
2022.05_01-07-2022;Республика Саха (Якутия);45_75_days;AllVaccines;10129;2076;12205;568643;148395;717038
2022.05_01-07-2022;Республика Саха (Якутия);45_75_days;CoviVac;153;21;174;568643;148395;717038
2022.05_01-07-2022;Республика Саха (Якутия);45_75_days;EpiVacCorona;494;151;645;568643;148395;717038
2022.05_01-07-2022;Республика Саха (Якутия);45_75_days;SputnikLite;2647;565;3212;568643;148395;717038
2022.05_01-07-2022;Республика Саха (Якутия);45_75_days;SputnikV;6835;1339;8174;568643;148395;717038
2022.05_01-07-2022;Республика Саха (Якутия);75_90_days;AllVaccines;10492;2483;12975;568643;148395;717038
2022.05_01-07-2022;Республика Саха (Якутия);75_90_days;CoviVac;109;10;119;568643;148395;717038
2022.05_01-07-2022;Республика Саха (Якутия);75_90_days;EpiVacCorona;414;133;547;568643;148395;717038
2022.05_01-07-2022;Республика Саха (Якутия);75_90_days;SputnikLite;2781;437;3218;568643;148395;717038
2022.05_01-07-2022;Республика Саха (Якутия);75_90_days;SputnikV;7188;1903;9091;568643;148395;717038
2022.05_01-07-2022;Республика Саха (Якутия);90_105_days;AllVaccines;11519;2959;14478;568643;148395;717038
2022.05_01-07-2022;Республика Саха (Якутия);90_105_days;CoviVac;105;16;121;568643;148395;717038
2022.05_01-07-2022;Республика Саха (Якутия);90_105_days;EpiVacCorona;382;186;568;568643;148395;717038
2022.05_01-07-2022;Республика Саха (Якутия);90_105_days;SputnikLite;3954;627;4581;568643;148395;717038
2022.05_01-07-2022;Республика Саха (Якутия);90_105_days;SputnikV;7078;2130;9208;568643;148395;717038
2022.05_01-07-2022;Республика Северная Осетия - Алания;105_165_days;AllVaccines;35474;8324;43798;385443;144230;529673
2022.05_01-07-2022;Республика Северная Осетия - Алания;105_165_days;CoviVac;308;127;435;385443;144230;529673
2022.05_01-07-2022;Республика Северная Осетия - Алания;105_165_days;EpiVacCorona;2598;731;3329;385443;144230;529673
2022.05_01-07-2022;Республика Северная Осетия - Алания;105_165_days;SputnikLite;14481;3848;18329;385443;144230;529673
2022.05_01-07-2022;Республика Северная Осетия - Алания;105_165_days;SputnikV;18087;3618;21705;385443;144230;529673
2022.05_01-07-2022;Республика Северная Осетия - Алания;165_195_days;AllVaccines;32261;6535;38796;385443;144230;529673
2022.05_01-07-2022;Республика Северная Осетия - Алания;165_195_days;CoviVac;478;125;603;385443;144230;529673
2022.05_01-07-2022;Республика Северная Осетия - Алания;165_195_days;EpiVacCorona;545;55;600;385443;144230;529673
2022.05_01-07-2022;Республика Северная Осетия - Алания;165_195_days;SputnikLite;16731;3607;20338;385443;144230;529673
2022.05_01-07-2022;Республика Северная Осетия - Алания;165_195_days;SputnikV;14507;2748;17255;385443;144230;529673
2022.05_01-07-2022;Республика Северная Осетия - Алания;21_45_days;AllVaccines;2158;1157;3315;385443;144230;529673
2022.05_01-07-2022;Республика Северная Осетия - Алания;21_45_days;CoviVac;163;113;276;385443;144230;529673
2022.05_01-07-2022;Республика Северная Осетия - Алания;21_45_days;EpiVacCorona;28;13;41;385443;144230;529673
2022.05_01-07-2022;Республика Северная Осетия - Алания;21_45_days;SputnikLite;286;89;375;385443;144230;529673
2022.05_01-07-2022;Республика Северная Осетия - Алания;21_45_days;SputnikV;1681;942;2623;385443;144230;529673
2022.05_01-07-2022;Республика Северная Осетия - Алания;45_75_days;AllVaccines;4107;1848;5955;385443;144230;529673
2022.05_01-07-2022;Республика Северная Осетия - Алания;45_75_days;CoviVac;85;257;342;385443;144230;529673
2022.05_01-07-2022;Республика Северная Осетия - Алания;45_75_days;EpiVacCorona;296;475;771;385443;144230;529673
2022.05_01-07-2022;Республика Северная Осетия - Алания;45_75_days;SputnikLite;1027;329;1356;385443;144230;529673
2022.05_01-07-2022;Республика Северная Осетия - Алания;45_75_days;SputnikV;2699;787;3486;385443;144230;529673
2022.05_01-07-2022;Республика Северная Осетия - Алания;75_90_days;AllVaccines;3950;1056;5006;385443;144230;529673
2022.05_01-07-2022;Республика Северная Осетия - Алания;75_90_days;CoviVac;47;10;57;385443;144230;529673
2022.05_01-07-2022;Республика Северная Осетия - Алания;75_90_days;EpiVacCorona;126;22;148;385443;144230;529673
2022.05_01-07-2022;Республика Северная Осетия - Алания;75_90_days;SputnikLite;1547;409;1956;385443;144230;529673
2022.05_01-07-2022;Республика Северная Осетия - Алания;75_90_days;SputnikV;2230;615;2845;385443;144230;529673
2022.05_01-07-2022;Республика Северная Осетия - Алания;90_105_days;AllVaccines;3528;1445;4973;385443;144230;529673
2022.05_01-07-2022;Республика Северная Осетия - Алания;90_105_days;CoviVac;23;9;32;385443;144230;529673
2022.05_01-07-2022;Республика Северная Осетия - Алания;90_105_days;EpiVacCorona;123;148;271;385443;144230;529673
2022.05_01-07-2022;Республика Северная Осетия - Алания;90_105_days;SputnikLite;1386;572;1958;385443;144230;529673
2022.05_01-07-2022;Республика Северная Осетия - Алания;90_105_days;SputnikV;1996;716;2712;385443;144230;529673
2022.05_01-07-2022;Республика Татарстан;105_165_days;AllVaccines;297940;142670;440610;2180132;866477;3046609
2022.05_01-07-2022;Республика Татарстан;105_165_days;CoviVac;1158;445;1603;2180132;866477;3046609
2022.05_01-07-2022;Республика Татарстан;105_165_days;EpiVacCorona;5189;4002;9191;2180132;866477;3046609
2022.05_01-07-2022;Республика Татарстан;105_165_days;SputnikLite;71079;50480;121559;2180132;866477;3046609
2022.05_01-07-2022;Республика Татарстан;105_165_days;SputnikV;220514;87743;308257;2180132;866477;3046609
2022.05_01-07-2022;Республика Татарстан;165_195_days;AllVaccines;507801;139857;647658;2180132;866477;3046609
2022.05_01-07-2022;Республика Татарстан;165_195_days;CoviVac;2045;428;2473;2180132;866477;3046609
2022.05_01-07-2022;Республика Татарстан;165_195_days;EpiVacCorona;9732;4234;13966;2180132;866477;3046609
2022.05_01-07-2022;Республика Татарстан;165_195_days;SputnikLite;51652;27525;79177;2180132;866477;3046609
2022.05_01-07-2022;Республика Татарстан;165_195_days;SputnikV;444372;107670;552042;2180132;866477;3046609
2022.05_01-07-2022;Республика Татарстан;21_45_days;AllVaccines;15435;7437;22872;2180132;866477;3046609
2022.05_01-07-2022;Республика Татарстан;21_45_days;CoviVac;145;57;202;2180132;866477;3046609
2022.05_01-07-2022;Республика Татарстан;21_45_days;EpiVacCorona;1160;678;1838;2180132;866477;3046609
2022.05_01-07-2022;Республика Татарстан;21_45_days;SputnikLite;6669;3974;10643;2180132;866477;3046609
2022.05_01-07-2022;Республика Татарстан;21_45_days;SputnikV;7461;2728;10189;2180132;866477;3046609
2022.05_01-07-2022;Республика Татарстан;45_75_days;AllVaccines;34084;13461;47545;2180132;866477;3046609
2022.05_01-07-2022;Республика Татарстан;45_75_days;CoviVac;510;209;719;2180132;866477;3046609
2022.05_01-07-2022;Республика Татарстан;45_75_days;EpiVacCorona;1017;653;1670;2180132;866477;3046609
2022.05_01-07-2022;Республика Татарстан;45_75_days;SputnikLite;11778;5404;17182;2180132;866477;3046609
2022.05_01-07-2022;Республика Татарстан;45_75_days;SputnikV;20779;7195;27974;2180132;866477;3046609
2022.05_01-07-2022;Республика Татарстан;75_90_days;AllVaccines;28704;12151;40855;2180132;866477;3046609
2022.05_01-07-2022;Республика Татарстан;75_90_days;CoviVac;148;65;213;2180132;866477;3046609
2022.05_01-07-2022;Республика Татарстан;75_90_days;EpiVacCorona;356;254;610;2180132;866477;3046609
2022.05_01-07-2022;Республика Татарстан;75_90_days;SputnikLite;11436;4351;15787;2180132;866477;3046609
2022.05_01-07-2022;Республика Татарстан;75_90_days;SputnikV;16764;7481;24245;2180132;866477;3046609
2022.05_01-07-2022;Республика Татарстан;90_105_days;AllVaccines;33469;15313;48782;2180132;866477;3046609
2022.05_01-07-2022;Республика Татарстан;90_105_days;CoviVac;271;130;401;2180132;866477;3046609
2022.05_01-07-2022;Республика Татарстан;90_105_days;EpiVacCorona;503;480;983;2180132;866477;3046609
2022.05_01-07-2022;Республика Татарстан;90_105_days;SputnikLite;15447;6022;21469;2180132;866477;3046609
2022.05_01-07-2022;Республика Татарстан;90_105_days;SputnikV;17248;8681;25929;2180132;866477;3046609
2022.05_01-07-2022;Республика Тыва;105_165_days;AllVaccines;23761;4857;28618;176122;31028;207150
2022.05_01-07-2022;Республика Тыва;105_165_days;CoviVac;6;0;6;176122;31028;207150
2022.05_01-07-2022;Республика Тыва;105_165_days;EpiVacCorona;211;19;230;176122;31028;207150
2022.05_01-07-2022;Республика Тыва;105_165_days;SputnikLite;15827;3721;19548;176122;31028;207150
2022.05_01-07-2022;Республика Тыва;105_165_days;SputnikV;7717;1117;8834;176122;31028;207150
2022.05_01-07-2022;Республика Тыва;165_195_days;AllVaccines;18508;3768;22276;176122;31028;207150
2022.05_01-07-2022;Республика Тыва;165_195_days;CoviVac;22;2;24;176122;31028;207150
2022.05_01-07-2022;Республика Тыва;165_195_days;EpiVacCorona;85;22;107;176122;31028;207150
2022.05_01-07-2022;Республика Тыва;165_195_days;SputnikLite;14082;2935;17017;176122;31028;207150
2022.05_01-07-2022;Республика Тыва;165_195_days;SputnikV;4319;809;5128;176122;31028;207150
2022.05_01-07-2022;Республика Тыва;21_45_days;AllVaccines;4214;818;5032;176122;31028;207150
2022.05_01-07-2022;Республика Тыва;21_45_days;CoviVac;329;44;373;176122;31028;207150
2022.05_01-07-2022;Республика Тыва;21_45_days;EpiVacCorona;404;100;504;176122;31028;207150
2022.05_01-07-2022;Республика Тыва;21_45_days;SputnikLite;1682;269;1951;176122;31028;207150
2022.05_01-07-2022;Республика Тыва;21_45_days;SputnikV;1799;405;2204;176122;31028;207150
2022.05_01-07-2022;Республика Тыва;45_75_days;AllVaccines;7832;1405;9237;176122;31028;207150
2022.05_01-07-2022;Республика Тыва;45_75_days;CoviVac;91;35;126;176122;31028;207150
2022.05_01-07-2022;Республика Тыва;45_75_days;EpiVacCorona;299;44;343;176122;31028;207150
2022.05_01-07-2022;Республика Тыва;45_75_days;SputnikLite;4086;806;4892;176122;31028;207150
2022.05_01-07-2022;Республика Тыва;45_75_days;SputnikV;3356;520;3876;176122;31028;207150
2022.05_01-07-2022;Республика Тыва;75_90_days;AllVaccines;5670;1035;6705;176122;31028;207150
2022.05_01-07-2022;Республика Тыва;75_90_days;CoviVac;21;2;23;176122;31028;207150
2022.05_01-07-2022;Республика Тыва;75_90_days;EpiVacCorona;62;14;76;176122;31028;207150
2022.05_01-07-2022;Республика Тыва;75_90_days;SputnikLite;2996;546;3542;176122;31028;207150
2022.05_01-07-2022;Республика Тыва;75_90_days;SputnikV;2591;473;3064;176122;31028;207150
2022.05_01-07-2022;Республика Тыва;90_105_days;AllVaccines;4771;752;5523;176122;31028;207150
2022.05_01-07-2022;Республика Тыва;90_105_days;CoviVac;13;1;14;176122;31028;207150
2022.05_01-07-2022;Республика Тыва;90_105_days;EpiVacCorona;60;6;66;176122;31028;207150
2022.05_01-07-2022;Республика Тыва;90_105_days;SputnikLite;2331;328;2659;176122;31028;207150
2022.05_01-07-2022;Республика Тыва;90_105_days;SputnikV;2367;417;2784;176122;31028;207150
2022.05_01-07-2022;Республика Хакасия;105_165_days;AllVaccines;32910;14827;47737;291439;112190;403629
2022.05_01-07-2022;Республика Хакасия;105_165_days;CoviVac;512;143;655;291439;112190;403629
2022.05_01-07-2022;Республика Хакасия;105_165_days;EpiVacCorona;939;389;1328;291439;112190;403629
2022.05_01-07-2022;Республика Хакасия;105_165_days;SputnikLite;17056;8230;25286;291439;112190;403629
2022.05_01-07-2022;Республика Хакасия;105_165_days;SputnikV;14403;6065;20468;291439;112190;403629
2022.05_01-07-2022;Республика Хакасия;165_195_days;AllVaccines;20178;12003;32181;291439;112190;403629
2022.05_01-07-2022;Республика Хакасия;165_195_days;CoviVac;489;165;654;291439;112190;403629
2022.05_01-07-2022;Республика Хакасия;165_195_days;EpiVacCorona;384;198;582;291439;112190;403629
2022.05_01-07-2022;Республика Хакасия;165_195_days;SputnikLite;10121;7166;17287;291439;112190;403629
2022.05_01-07-2022;Республика Хакасия;165_195_days;SputnikV;9184;4474;13658;291439;112190;403629
2022.05_01-07-2022;Республика Хакасия;21_45_days;AllVaccines;1421;672;2093;291439;112190;403629
2022.05_01-07-2022;Республика Хакасия;21_45_days;CoviVac;128;42;170;291439;112190;403629
2022.05_01-07-2022;Республика Хакасия;21_45_days;EpiVacCorona;77;35;112;291439;112190;403629
2022.05_01-07-2022;Республика Хакасия;21_45_days;SputnikLite;138;98;236;291439;112190;403629
2022.05_01-07-2022;Республика Хакасия;21_45_days;SputnikV;1078;497;1575;291439;112190;403629
2022.05_01-07-2022;Республика Хакасия;45_75_days;AllVaccines;3501;1531;5032;291439;112190;403629
2022.05_01-07-2022;Республика Хакасия;45_75_days;CoviVac;89;15;104;291439;112190;403629
2022.05_01-07-2022;Республика Хакасия;45_75_days;EpiVacCorona;166;51;217;291439;112190;403629
2022.05_01-07-2022;Республика Хакасия;45_75_days;SputnikLite;685;296;981;291439;112190;403629
2022.05_01-07-2022;Республика Хакасия;45_75_days;SputnikV;2561;1169;3730;291439;112190;403629
2022.05_01-07-2022;Республика Хакасия;75_90_days;AllVaccines;5630;2150;7780;291439;112190;403629
2022.05_01-07-2022;Республика Хакасия;75_90_days;CoviVac;114;24;138;291439;112190;403629
2022.05_01-07-2022;Республика Хакасия;75_90_days;EpiVacCorona;220;71;291;291439;112190;403629
2022.05_01-07-2022;Республика Хакасия;75_90_days;SputnikLite;2745;845;3590;291439;112190;403629
2022.05_01-07-2022;Республика Хакасия;75_90_days;SputnikV;2551;1210;3761;291439;112190;403629
2022.05_01-07-2022;Республика Хакасия;90_105_days;AllVaccines;7270;2579;9849;291439;112190;403629
2022.05_01-07-2022;Республика Хакасия;90_105_days;CoviVac;133;47;180;291439;112190;403629
2022.05_01-07-2022;Республика Хакасия;90_105_days;EpiVacCorona;374;136;510;291439;112190;403629
2022.05_01-07-2022;Республика Хакасия;90_105_days;SputnikLite;4886;1466;6352;291439;112190;403629
2022.05_01-07-2022;Республика Хакасия;90_105_days;SputnikV;1877;930;2807;291439;112190;403629
2022.05_01-07-2022;Ростовская область;105_165_days;AllVaccines;243097;133630;376727;2367942;1020468;3388410
2022.05_01-07-2022;Ростовская область;105_165_days;CoviVac;1631;676;2307;2367942;1020468;3388410
2022.05_01-07-2022;Ростовская область;105_165_days;EpiVacCorona;2135;1425;3560;2367942;1020468;3388410
2022.05_01-07-2022;Ростовская область;105_165_days;SputnikLite;82819;45613;128432;2367942;1020468;3388410
2022.05_01-07-2022;Ростовская область;105_165_days;SputnikV;156512;85916;242428;2367942;1020468;3388410
2022.05_01-07-2022;Ростовская область;165_195_days;AllVaccines;132405;70620;203025;2367942;1020468;3388410
2022.05_01-07-2022;Ростовская область;165_195_days;CoviVac;1906;780;2686;2367942;1020468;3388410
2022.05_01-07-2022;Ростовская область;165_195_days;EpiVacCorona;1724;794;2518;2367942;1020468;3388410
2022.05_01-07-2022;Ростовская область;165_195_days;SputnikLite;31891;23731;55622;2367942;1020468;3388410
2022.05_01-07-2022;Ростовская область;165_195_days;SputnikV;96884;45315;142199;2367942;1020468;3388410
2022.05_01-07-2022;Ростовская область;21_45_days;AllVaccines;25579;17171;42750;2367942;1020468;3388410
2022.05_01-07-2022;Ростовская область;21_45_days;CoviVac;792;287;1079;2367942;1020468;3388410
2022.05_01-07-2022;Ростовская область;21_45_days;EpiVacCorona;2689;2137;4826;2367942;1020468;3388410
2022.05_01-07-2022;Ростовская область;21_45_days;SputnikLite;1666;610;2276;2367942;1020468;3388410
2022.05_01-07-2022;Ростовская область;21_45_days;SputnikV;20432;14137;34569;2367942;1020468;3388410
2022.05_01-07-2022;Ростовская область;45_75_days;AllVaccines;45866;25456;71322;2367942;1020468;3388410
2022.05_01-07-2022;Ростовская область;45_75_days;CoviVac;833;212;1045;2367942;1020468;3388410
2022.05_01-07-2022;Ростовская область;45_75_days;EpiVacCorona;3367;1869;5236;2367942;1020468;3388410
2022.05_01-07-2022;Ростовская область;45_75_days;SputnikLite;8365;2997;11362;2367942;1020468;3388410
2022.05_01-07-2022;Ростовская область;45_75_days;SputnikV;33301;20378;53679;2367942;1020468;3388410
2022.05_01-07-2022;Ростовская область;75_90_days;AllVaccines;61677;27991;89668;2367942;1020468;3388410
2022.05_01-07-2022;Ростовская область;75_90_days;CoviVac;538;146;684;2367942;1020468;3388410
2022.05_01-07-2022;Ростовская область;75_90_days;EpiVacCorona;2843;2084;4927;2367942;1020468;3388410
2022.05_01-07-2022;Ростовская область;75_90_days;SputnikLite;24212;7519;31731;2367942;1020468;3388410
2022.05_01-07-2022;Ростовская область;75_90_days;SputnikV;34084;18242;52326;2367942;1020468;3388410
2022.05_01-07-2022;Ростовская область;90_105_days;AllVaccines;56377;26341;82718;2367942;1020468;3388410
2022.05_01-07-2022;Ростовская область;90_105_days;CoviVac;739;212;951;2367942;1020468;3388410
2022.05_01-07-2022;Ростовская область;90_105_days;EpiVacCorona;1790;945;2735;2367942;1020468;3388410
2022.05_01-07-2022;Ростовская область;90_105_days;SputnikLite;24491;6881;31372;2367942;1020468;3388410
2022.05_01-07-2022;Ростовская область;90_105_days;SputnikV;29357;18303;47660;2367942;1020468;3388410
2022.05_01-07-2022;Рязанская область;105_165_days;AllVaccines;91766;50039;141805;600731;301318;902049
2022.05_01-07-2022;Рязанская область;105_165_days;CoviVac;1466;438;1904;600731;301318;902049
2022.05_01-07-2022;Рязанская область;105_165_days;EpiVacCorona;2234;947;3181;600731;301318;902049
2022.05_01-07-2022;Рязанская область;105_165_days;SputnikLite;29994;24886;54880;600731;301318;902049
2022.05_01-07-2022;Рязанская область;105_165_days;SputnikV;58072;23768;81840;600731;301318;902049
2022.05_01-07-2022;Рязанская область;165_195_days;AllVaccines;87794;27082;114876;600731;301318;902049
2022.05_01-07-2022;Рязанская область;165_195_days;CoviVac;1304;266;1570;600731;301318;902049
2022.05_01-07-2022;Рязанская область;165_195_days;EpiVacCorona;4486;1110;5596;600731;301318;902049
2022.05_01-07-2022;Рязанская область;165_195_days;SputnikLite;6800;6740;13540;600731;301318;902049
2022.05_01-07-2022;Рязанская область;165_195_days;SputnikV;75204;18966;94170;600731;301318;902049
2022.05_01-07-2022;Рязанская область;21_45_days;AllVaccines;3042;2641;5683;600731;301318;902049
2022.05_01-07-2022;Рязанская область;21_45_days;CoviVac;145;41;186;600731;301318;902049
2022.05_01-07-2022;Рязанская область;21_45_days;EpiVacCorona;62;24;86;600731;301318;902049
2022.05_01-07-2022;Рязанская область;21_45_days;SputnikLite;1152;1233;2385;600731;301318;902049
2022.05_01-07-2022;Рязанская область;21_45_days;SputnikV;1683;1343;3026;600731;301318;902049
2022.05_01-07-2022;Рязанская область;45_75_days;AllVaccines;5104;2595;7699;600731;301318;902049
2022.05_01-07-2022;Рязанская область;45_75_days;CoviVac;198;55;253;600731;301318;902049
2022.05_01-07-2022;Рязанская область;45_75_days;EpiVacCorona;124;62;186;600731;301318;902049
2022.05_01-07-2022;Рязанская область;45_75_days;SputnikLite;1308;863;2171;600731;301318;902049
2022.05_01-07-2022;Рязанская область;45_75_days;SputnikV;3474;1615;5089;600731;301318;902049
2022.05_01-07-2022;Рязанская область;75_90_days;AllVaccines;7213;3163;10376;600731;301318;902049
2022.05_01-07-2022;Рязанская область;75_90_days;CoviVac;90;18;108;600731;301318;902049
2022.05_01-07-2022;Рязанская область;75_90_days;EpiVacCorona;128;50;178;600731;301318;902049
2022.05_01-07-2022;Рязанская область;75_90_days;SputnikLite;3179;1768;4947;600731;301318;902049
2022.05_01-07-2022;Рязанская область;75_90_days;SputnikV;3816;1327;5143;600731;301318;902049
2022.05_01-07-2022;Рязанская область;90_105_days;AllVaccines;9800;4591;14391;600731;301318;902049
2022.05_01-07-2022;Рязанская область;90_105_days;CoviVac;161;57;218;600731;301318;902049
2022.05_01-07-2022;Рязанская область;90_105_days;EpiVacCorona;214;79;293;600731;301318;902049
2022.05_01-07-2022;Рязанская область;90_105_days;SputnikLite;4958;2545;7503;600731;301318;902049
2022.05_01-07-2022;Рязанская область;90_105_days;SputnikV;4467;1910;6377;600731;301318;902049
2022.05_01-07-2022;Самарская область;105_165_days;AllVaccines;226469;128386;354855;1769846;769791;2539637
2022.05_01-07-2022;Самарская область;105_165_days;CoviVac;1796;663;2459;1769846;769791;2539637
2022.05_01-07-2022;Самарская область;105_165_days;EpiVacCorona;3740;3250;6990;1769846;769791;2539637
2022.05_01-07-2022;Самарская область;105_165_days;SputnikLite;77024;55027;132051;1769846;769791;2539637
2022.05_01-07-2022;Самарская область;105_165_days;SputnikV;143909;69446;213355;1769846;769791;2539637
2022.05_01-07-2022;Самарская область;165_195_days;AllVaccines;194116;96688;290804;1769846;769791;2539637
2022.05_01-07-2022;Самарская область;165_195_days;CoviVac;975;336;1311;1769846;769791;2539637
2022.05_01-07-2022;Самарская область;165_195_days;EpiVacCorona;2528;1543;4071;1769846;769791;2539637
2022.05_01-07-2022;Самарская область;165_195_days;SputnikLite;29322;23937;53259;1769846;769791;2539637
2022.05_01-07-2022;Самарская область;165_195_days;SputnikV;161291;70872;232163;1769846;769791;2539637
2022.05_01-07-2022;Самарская область;21_45_days;AllVaccines;15164;16682;31846;1769846;769791;2539637
2022.05_01-07-2022;Самарская область;21_45_days;CoviVac;392;222;614;1769846;769791;2539637
2022.05_01-07-2022;Самарская область;21_45_days;EpiVacCorona;1342;2195;3537;1769846;769791;2539637
2022.05_01-07-2022;Самарская область;21_45_days;SputnikLite;4237;2476;6713;1769846;769791;2539637
2022.05_01-07-2022;Самарская область;21_45_days;SputnikV;9193;11789;20982;1769846;769791;2539637
2022.05_01-07-2022;Самарская область;45_75_days;AllVaccines;27137;18436;45573;1769846;769791;2539637
2022.05_01-07-2022;Самарская область;45_75_days;CoviVac;371;230;601;1769846;769791;2539637
2022.05_01-07-2022;Самарская область;45_75_days;EpiVacCorona;1578;1929;3507;1769846;769791;2539637
2022.05_01-07-2022;Самарская область;45_75_days;SputnikLite;9755;4499;14254;1769846;769791;2539637
2022.05_01-07-2022;Самарская область;45_75_days;SputnikV;15433;11778;27211;1769846;769791;2539637
2022.05_01-07-2022;Самарская область;75_90_days;AllVaccines;23921;12477;36398;1769846;769791;2539637
2022.05_01-07-2022;Самарская область;75_90_days;CoviVac;274;86;360;1769846;769791;2539637
2022.05_01-07-2022;Самарская область;75_90_days;EpiVacCorona;614;695;1309;1769846;769791;2539637
2022.05_01-07-2022;Самарская область;75_90_days;SputnikLite;8314;3222;11536;1769846;769791;2539637
2022.05_01-07-2022;Самарская область;75_90_days;SputnikV;14719;8474;23193;1769846;769791;2539637
2022.05_01-07-2022;Самарская область;90_105_days;AllVaccines;27581;14264;41845;1769846;769791;2539637
2022.05_01-07-2022;Самарская область;90_105_days;CoviVac;404;129;533;1769846;769791;2539637
2022.05_01-07-2022;Самарская область;90_105_days;EpiVacCorona;805;806;1611;1769846;769791;2539637
2022.05_01-07-2022;Самарская область;90_105_days;SputnikLite;12405;4782;17187;1769846;769791;2539637
2022.05_01-07-2022;Самарская область;90_105_days;SputnikV;13967;8547;22514;1769846;769791;2539637
2022.05_01-07-2022;Саратовская область;105_165_days;AllVaccines;185997;86373;272370;1348454;599954;1948408
2022.05_01-07-2022;Саратовская область;105_165_days;CoviVac;1780;452;2232;1348454;599954;1948408
2022.05_01-07-2022;Саратовская область;105_165_days;EpiVacCorona;8705;3994;12699;1348454;599954;1948408
2022.05_01-07-2022;Саратовская область;105_165_days;SputnikLite;60621;37015;97636;1348454;599954;1948408
2022.05_01-07-2022;Саратовская область;105_165_days;SputnikV;114891;44912;159803;1348454;599954;1948408
2022.05_01-07-2022;Саратовская область;165_195_days;AllVaccines;136885;57518;194403;1348454;599954;1948408
2022.05_01-07-2022;Саратовская область;165_195_days;CoviVac;1017;150;1167;1348454;599954;1948408
2022.05_01-07-2022;Саратовская область;165_195_days;EpiVacCorona;5445;1842;7287;1348454;599954;1948408
2022.05_01-07-2022;Саратовская область;165_195_days;SputnikLite;27545;16485;44030;1348454;599954;1948408
2022.05_01-07-2022;Саратовская область;165_195_days;SputnikV;102878;39041;141919;1348454;599954;1948408
2022.05_01-07-2022;Саратовская область;21_45_days;AllVaccines;11072;7988;19060;1348454;599954;1948408
2022.05_01-07-2022;Саратовская область;21_45_days;CoviVac;635;200;835;1348454;599954;1948408
2022.05_01-07-2022;Саратовская область;21_45_days;EpiVacCorona;1482;767;2249;1348454;599954;1948408
2022.05_01-07-2022;Саратовская область;21_45_days;SputnikLite;2357;1557;3914;1348454;599954;1948408
2022.05_01-07-2022;Саратовская область;21_45_days;SputnikV;6598;5464;12062;1348454;599954;1948408
2022.05_01-07-2022;Саратовская область;45_75_days;AllVaccines;15660;10087;25747;1348454;599954;1948408
2022.05_01-07-2022;Саратовская область;45_75_days;CoviVac;468;229;697;1348454;599954;1948408
2022.05_01-07-2022;Саратовская область;45_75_days;EpiVacCorona;1864;1644;3508;1348454;599954;1948408
2022.05_01-07-2022;Саратовская область;45_75_days;SputnikLite;5052;2714;7766;1348454;599954;1948408
2022.05_01-07-2022;Саратовская область;45_75_days;SputnikV;8276;5500;13776;1348454;599954;1948408
2022.05_01-07-2022;Саратовская область;75_90_days;AllVaccines;16507;9066;25573;1348454;599954;1948408
2022.05_01-07-2022;Саратовская область;75_90_days;CoviVac;208;76;284;1348454;599954;1948408
2022.05_01-07-2022;Саратовская область;75_90_days;EpiVacCorona;1236;771;2007;1348454;599954;1948408
2022.05_01-07-2022;Саратовская область;75_90_days;SputnikLite;7054;3650;10704;1348454;599954;1948408
2022.05_01-07-2022;Саратовская область;75_90_days;SputnikV;8009;4569;12578;1348454;599954;1948408
2022.05_01-07-2022;Саратовская область;90_105_days;AllVaccines;25834;13703;39537;1348454;599954;1948408
2022.05_01-07-2022;Саратовская область;90_105_days;CoviVac;512;142;654;1348454;599954;1948408
2022.05_01-07-2022;Саратовская область;90_105_days;EpiVacCorona;1674;1295;2969;1348454;599954;1948408
2022.05_01-07-2022;Саратовская область;90_105_days;SputnikLite;13966;5995;19961;1348454;599954;1948408
2022.05_01-07-2022;Саратовская область;90_105_days;SputnikV;9682;6271;15953;1348454;599954;1948408
2022.05_01-07-2022;Сахалинская область;105_165_days;AllVaccines;38755;14278;53033;276677;101794;378471
2022.05_01-07-2022;Сахалинская область;105_165_days;CoviVac;664;128;792;276677;101794;378471
2022.05_01-07-2022;Сахалинская область;105_165_days;EpiVacCorona;2437;570;3007;276677;101794;378471
2022.05_01-07-2022;Сахалинская область;105_165_days;SputnikLite;20944;10046;30990;276677;101794;378471
2022.05_01-07-2022;Сахалинская область;105_165_days;SputnikV;14710;3534;18244;276677;101794;378471
2022.05_01-07-2022;Сахалинская область;165_195_days;AllVaccines;20208;11685;31893;276677;101794;378471
2022.05_01-07-2022;Сахалинская область;165_195_days;CoviVac;60;8;68;276677;101794;378471
2022.05_01-07-2022;Сахалинская область;165_195_days;EpiVacCorona;1909;647;2556;276677;101794;378471
2022.05_01-07-2022;Сахалинская область;165_195_days;SputnikLite;10387;8699;19086;276677;101794;378471
2022.05_01-07-2022;Сахалинская область;165_195_days;SputnikV;7852;2331;10183;276677;101794;378471
2022.05_01-07-2022;Сахалинская область;21_45_days;AllVaccines;3351;1162;4513;276677;101794;378471
2022.05_01-07-2022;Сахалинская область;21_45_days;CoviVac;149;11;160;276677;101794;378471
2022.05_01-07-2022;Сахалинская область;21_45_days;EpiVacCorona;149;13;162;276677;101794;378471
2022.05_01-07-2022;Сахалинская область;21_45_days;SputnikLite;1908;895;2803;276677;101794;378471
2022.05_01-07-2022;Сахалинская область;21_45_days;SputnikV;1145;243;1388;276677;101794;378471
2022.05_01-07-2022;Сахалинская область;45_75_days;AllVaccines;6679;1958;8637;276677;101794;378471
2022.05_01-07-2022;Сахалинская область;45_75_days;CoviVac;246;26;272;276677;101794;378471
2022.05_01-07-2022;Сахалинская область;45_75_days;EpiVacCorona;326;71;397;276677;101794;378471
2022.05_01-07-2022;Сахалинская область;45_75_days;SputnikLite;3304;1125;4429;276677;101794;378471
2022.05_01-07-2022;Сахалинская область;45_75_days;SputnikV;2803;736;3539;276677;101794;378471
2022.05_01-07-2022;Сахалинская область;75_90_days;AllVaccines;3972;1349;5321;276677;101794;378471
2022.05_01-07-2022;Сахалинская область;75_90_days;CoviVac;82;18;100;276677;101794;378471
2022.05_01-07-2022;Сахалинская область;75_90_days;EpiVacCorona;267;45;312;276677;101794;378471
2022.05_01-07-2022;Сахалинская область;75_90_days;SputnikLite;2097;741;2838;276677;101794;378471
2022.05_01-07-2022;Сахалинская область;75_90_days;SputnikV;1526;545;2071;276677;101794;378471
2022.05_01-07-2022;Сахалинская область;90_105_days;AllVaccines;6096;1891;7987;276677;101794;378471
2022.05_01-07-2022;Сахалинская область;90_105_days;CoviVac;101;24;125;276677;101794;378471
2022.05_01-07-2022;Сахалинская область;90_105_days;EpiVacCorona;276;38;314;276677;101794;378471
2022.05_01-07-2022;Сахалинская область;90_105_days;SputnikLite;4574;1511;6085;276677;101794;378471
2022.05_01-07-2022;Сахалинская область;90_105_days;SputnikV;1145;318;1463;276677;101794;378471
2022.05_01-07-2022;Свердловская область;105_165_days;AllVaccines;383815;180992;564807;2364046;987486;3351532
2022.05_01-07-2022;Свердловская область;105_165_days;CoviVac;1230;328;1558;2364046;987486;3351532
2022.05_01-07-2022;Свердловская область;105_165_days;EpiVacCorona;8892;5185;14077;2364046;987486;3351532
2022.05_01-07-2022;Свердловская область;105_165_days;SputnikLite;123349;75421;198770;2364046;987486;3351532
2022.05_01-07-2022;Свердловская область;105_165_days;SputnikV;250344;100058;350402;2364046;987486;3351532
2022.05_01-07-2022;Свердловская область;165_195_days;AllVaccines;314907;107471;422378;2364046;987486;3351532
2022.05_01-07-2022;Свердловская область;165_195_days;CoviVac;3597;669;4266;2364046;987486;3351532
2022.05_01-07-2022;Свердловская область;165_195_days;EpiVacCorona;7963;2898;10861;2364046;987486;3351532
2022.05_01-07-2022;Свердловская область;165_195_days;SputnikLite;56925;32083;89008;2364046;987486;3351532
2022.05_01-07-2022;Свердловская область;165_195_days;SputnikV;246422;71821;318243;2364046;987486;3351532
2022.05_01-07-2022;Свердловская область;21_45_days;AllVaccines;22485;14928;37413;2364046;987486;3351532
2022.05_01-07-2022;Свердловская область;21_45_days;CoviVac;250;65;315;2364046;987486;3351532
2022.05_01-07-2022;Свердловская область;21_45_days;EpiVacCorona;1280;700;1980;2364046;987486;3351532
2022.05_01-07-2022;Свердловская область;21_45_days;SputnikLite;3574;1999;5573;2364046;987486;3351532
2022.05_01-07-2022;Свердловская область;21_45_days;SputnikV;17381;12164;29545;2364046;987486;3351532
2022.05_01-07-2022;Свердловская область;45_75_days;AllVaccines;37190;17888;55078;2364046;987486;3351532
2022.05_01-07-2022;Свердловская область;45_75_days;CoviVac;211;49;260;2364046;987486;3351532
2022.05_01-07-2022;Свердловская область;45_75_days;EpiVacCorona;1933;993;2926;2364046;987486;3351532
2022.05_01-07-2022;Свердловская область;45_75_days;SputnikLite;8452;3819;12271;2364046;987486;3351532
2022.05_01-07-2022;Свердловская область;45_75_days;SputnikV;26594;13027;39621;2364046;987486;3351532
2022.05_01-07-2022;Свердловская область;75_90_days;AllVaccines;33896;15416;49312;2364046;987486;3351532
2022.05_01-07-2022;Свердловская область;75_90_days;CoviVac;192;55;247;2364046;987486;3351532
2022.05_01-07-2022;Свердловская область;75_90_days;EpiVacCorona;2486;1136;3622;2364046;987486;3351532
2022.05_01-07-2022;Свердловская область;75_90_days;SputnikLite;11789;4899;16688;2364046;987486;3351532
2022.05_01-07-2022;Свердловская область;75_90_days;SputnikV;19429;9326;28755;2364046;987486;3351532
2022.05_01-07-2022;Свердловская область;90_105_days;AllVaccines;47374;22919;70293;2364046;987486;3351532
2022.05_01-07-2022;Свердловская область;90_105_days;CoviVac;514;132;646;2364046;987486;3351532
2022.05_01-07-2022;Свердловская область;90_105_days;EpiVacCorona;3764;1889;5653;2364046;987486;3351532
2022.05_01-07-2022;Свердловская область;90_105_days;SputnikLite;24552;10659;35211;2364046;987486;3351532
2022.05_01-07-2022;Свердловская область;90_105_days;SputnikV;18544;10239;28783;2364046;987486;3351532
2022.05_01-07-2022;Смоленская область;105_165_days;AllVaccines;50376;32358;82734;521379;238479;759858
2022.05_01-07-2022;Смоленская область;105_165_days;CoviVac;501;124;625;521379;238479;759858
2022.05_01-07-2022;Смоленская область;105_165_days;EpiVacCorona;2512;1459;3971;521379;238479;759858
2022.05_01-07-2022;Смоленская область;105_165_days;SputnikLite;20699;16507;37206;521379;238479;759858
2022.05_01-07-2022;Смоленская область;105_165_days;SputnikV;26664;14268;40932;521379;238479;759858
2022.05_01-07-2022;Смоленская область;165_195_days;AllVaccines;35296;19891;55187;521379;238479;759858
2022.05_01-07-2022;Смоленская область;165_195_days;CoviVac;147;33;180;521379;238479;759858
2022.05_01-07-2022;Смоленская область;165_195_days;EpiVacCorona;332;149;481;521379;238479;759858
2022.05_01-07-2022;Смоленская область;165_195_days;SputnikLite;12595;11207;23802;521379;238479;759858
2022.05_01-07-2022;Смоленская область;165_195_days;SputnikV;22222;8502;30724;521379;238479;759858
2022.05_01-07-2022;Смоленская область;21_45_days;AllVaccines;4184;2567;6751;521379;238479;759858
2022.05_01-07-2022;Смоленская область;21_45_days;CoviVac;230;70;300;521379;238479;759858
2022.05_01-07-2022;Смоленская область;21_45_days;EpiVacCorona;192;132;324;521379;238479;759858
2022.05_01-07-2022;Смоленская область;21_45_days;SputnikLite;1719;1107;2826;521379;238479;759858
2022.05_01-07-2022;Смоленская область;21_45_days;SputnikV;2043;1258;3301;521379;238479;759858
2022.05_01-07-2022;Смоленская область;45_75_days;AllVaccines;6823;3479;10302;521379;238479;759858
2022.05_01-07-2022;Смоленская область;45_75_days;CoviVac;306;100;406;521379;238479;759858
2022.05_01-07-2022;Смоленская область;45_75_days;EpiVacCorona;560;280;840;521379;238479;759858
2022.05_01-07-2022;Смоленская область;45_75_days;SputnikLite;1131;633;1764;521379;238479;759858
2022.05_01-07-2022;Смоленская область;45_75_days;SputnikV;4826;2466;7292;521379;238479;759858
2022.05_01-07-2022;Смоленская область;75_90_days;AllVaccines;6488;3544;10032;521379;238479;759858
2022.05_01-07-2022;Смоленская область;75_90_days;CoviVac;119;44;163;521379;238479;759858
2022.05_01-07-2022;Смоленская область;75_90_days;EpiVacCorona;434;217;651;521379;238479;759858
2022.05_01-07-2022;Смоленская область;75_90_days;SputnikLite;2054;1048;3102;521379;238479;759858
2022.05_01-07-2022;Смоленская область;75_90_days;SputnikV;3881;2235;6116;521379;238479;759858
2022.05_01-07-2022;Смоленская область;90_105_days;AllVaccines;7610;4023;11633;521379;238479;759858
2022.05_01-07-2022;Смоленская область;90_105_days;CoviVac;154;49;203;521379;238479;759858
2022.05_01-07-2022;Смоленская область;90_105_days;EpiVacCorona;674;467;1141;521379;238479;759858
2022.05_01-07-2022;Смоленская область;90_105_days;SputnikLite;3542;1565;5107;521379;238479;759858
2022.05_01-07-2022;Смоленская область;90_105_days;SputnikV;3240;1942;5182;521379;238479;759858
2022.05_01-07-2022;Ставропольский край;105_165_days;AllVaccines;203621;78178;281799;1590669;616030;2206699
2022.05_01-07-2022;Ставропольский край;105_165_days;CoviVac;1309;447;1756;1590669;616030;2206699
2022.05_01-07-2022;Ставропольский край;105_165_days;EpiVacCorona;7324;3205;10529;1590669;616030;2206699
2022.05_01-07-2022;Ставропольский край;105_165_days;SputnikLite;67590;36405;103995;1590669;616030;2206699
2022.05_01-07-2022;Ставропольский край;105_165_days;SputnikV;127398;38121;165519;1590669;616030;2206699
2022.05_01-07-2022;Ставропольский край;165_195_days;AllVaccines;134238;50948;185186;1590669;616030;2206699
2022.05_01-07-2022;Ставропольский край;165_195_days;CoviVac;1533;427;1960;1590669;616030;2206699
2022.05_01-07-2022;Ставропольский край;165_195_days;EpiVacCorona;3360;1279;4639;1590669;616030;2206699
2022.05_01-07-2022;Ставропольский край;165_195_days;SputnikLite;32724;18708;51432;1590669;616030;2206699
2022.05_01-07-2022;Ставропольский край;165_195_days;SputnikV;96621;30534;127155;1590669;616030;2206699
2022.05_01-07-2022;Ставропольский край;21_45_days;AllVaccines;10166;5621;15787;1590669;616030;2206699
2022.05_01-07-2022;Ставропольский край;21_45_days;CoviVac;365;127;492;1590669;616030;2206699
2022.05_01-07-2022;Ставропольский край;21_45_days;EpiVacCorona;1031;590;1621;1590669;616030;2206699
2022.05_01-07-2022;Ставропольский край;21_45_days;SputnikLite;979;641;1620;1590669;616030;2206699
2022.05_01-07-2022;Ставропольский край;21_45_days;SputnikV;7791;4263;12054;1590669;616030;2206699
2022.05_01-07-2022;Ставропольский край;45_75_days;AllVaccines;16145;12458;28603;1590669;616030;2206699
2022.05_01-07-2022;Ставропольский край;45_75_days;CoviVac;691;494;1185;1590669;616030;2206699
2022.05_01-07-2022;Ставропольский край;45_75_days;EpiVacCorona;1342;695;2037;1590669;616030;2206699
2022.05_01-07-2022;Ставропольский край;45_75_days;SputnikLite;2312;1425;3737;1590669;616030;2206699
2022.05_01-07-2022;Ставропольский край;45_75_days;SputnikV;11800;9844;21644;1590669;616030;2206699
2022.05_01-07-2022;Ставропольский край;75_90_days;AllVaccines;15210;8631;23841;1590669;616030;2206699
2022.05_01-07-2022;Ставропольский край;75_90_days;CoviVac;216;170;386;1590669;616030;2206699
2022.05_01-07-2022;Ставропольский край;75_90_days;EpiVacCorona;2290;1385;3675;1590669;616030;2206699
2022.05_01-07-2022;Ставропольский край;75_90_days;SputnikLite;6048;2374;8422;1590669;616030;2206699
2022.05_01-07-2022;Ставропольский край;75_90_days;SputnikV;6656;4702;11358;1590669;616030;2206699
2022.05_01-07-2022;Ставропольский край;90_105_days;AllVaccines;21442;10575;32017;1590669;616030;2206699
2022.05_01-07-2022;Ставропольский край;90_105_days;CoviVac;330;307;637;1590669;616030;2206699
2022.05_01-07-2022;Ставропольский край;90_105_days;EpiVacCorona;2857;2277;5134;1590669;616030;2206699
2022.05_01-07-2022;Ставропольский край;90_105_days;SputnikLite;10910;4440;15350;1590669;616030;2206699
2022.05_01-07-2022;Ставропольский край;90_105_days;SputnikV;7345;3551;10896;1590669;616030;2206699
2022.05_01-07-2022;Тамбовская область;105_165_days;AllVaccines;60142;37480;97622;545785;279936;825721
2022.05_01-07-2022;Тамбовская область;105_165_days;CoviVac;1310;241;1551;545785;279936;825721
2022.05_01-07-2022;Тамбовская область;105_165_days;EpiVacCorona;2687;1878;4565;545785;279936;825721
2022.05_01-07-2022;Тамбовская область;105_165_days;SputnikLite;34862;16684;51546;545785;279936;825721
2022.05_01-07-2022;Тамбовская область;105_165_days;SputnikV;21283;18677;39960;545785;279936;825721
2022.05_01-07-2022;Тамбовская область;165_195_days;AllVaccines;41125;29706;70831;545785;279936;825721
2022.05_01-07-2022;Тамбовская область;165_195_days;CoviVac;1048;230;1278;545785;279936;825721
2022.05_01-07-2022;Тамбовская область;165_195_days;EpiVacCorona;633;353;986;545785;279936;825721
2022.05_01-07-2022;Тамбовская область;165_195_days;SputnikLite;22823;13942;36765;545785;279936;825721
2022.05_01-07-2022;Тамбовская область;165_195_days;SputnikV;16621;15181;31802;545785;279936;825721
2022.05_01-07-2022;Тамбовская область;21_45_days;AllVaccines;6797;6070;12867;545785;279936;825721
2022.05_01-07-2022;Тамбовская область;21_45_days;CoviVac;1105;251;1356;545785;279936;825721
2022.05_01-07-2022;Тамбовская область;21_45_days;EpiVacCorona;1091;941;2032;545785;279936;825721
2022.05_01-07-2022;Тамбовская область;21_45_days;SputnikLite;128;74;202;545785;279936;825721
2022.05_01-07-2022;Тамбовская область;21_45_days;SputnikV;4473;4804;9277;545785;279936;825721
2022.05_01-07-2022;Тамбовская область;45_75_days;AllVaccines;12906;8112;21018;545785;279936;825721
2022.05_01-07-2022;Тамбовская область;45_75_days;CoviVac;528;57;585;545785;279936;825721
2022.05_01-07-2022;Тамбовская область;45_75_days;EpiVacCorona;1003;763;1766;545785;279936;825721
2022.05_01-07-2022;Тамбовская область;45_75_days;SputnikLite;1186;814;2000;545785;279936;825721
2022.05_01-07-2022;Тамбовская область;45_75_days;SputnikV;10189;6478;16667;545785;279936;825721
2022.05_01-07-2022;Тамбовская область;75_90_days;AllVaccines;9549;5254;14803;545785;279936;825721
2022.05_01-07-2022;Тамбовская область;75_90_days;CoviVac;223;30;253;545785;279936;825721
2022.05_01-07-2022;Тамбовская область;75_90_days;EpiVacCorona;1037;677;1714;545785;279936;825721
2022.05_01-07-2022;Тамбовская область;75_90_days;SputnikLite;4117;1422;5539;545785;279936;825721
2022.05_01-07-2022;Тамбовская область;75_90_days;SputnikV;4172;3125;7297;545785;279936;825721
2022.05_01-07-2022;Тамбовская область;90_105_days;AllVaccines;15593;10131;25724;545785;279936;825721
2022.05_01-07-2022;Тамбовская область;90_105_days;CoviVac;286;48;334;545785;279936;825721
2022.05_01-07-2022;Тамбовская область;90_105_days;EpiVacCorona;2608;2147;4755;545785;279936;825721
2022.05_01-07-2022;Тамбовская область;90_105_days;SputnikLite;6853;1927;8780;545785;279936;825721
2022.05_01-07-2022;Тамбовская область;90_105_days;SputnikV;5846;6009;11855;545785;279936;825721
2022.05_01-07-2022;Тверская область;105_165_days;AllVaccines;62617;39663;102280;681519;330234;1011753
2022.05_01-07-2022;Тверская область;105_165_days;CoviVac;1592;411;2003;681519;330234;1011753
2022.05_01-07-2022;Тверская область;105_165_days;EpiVacCorona;3894;2605;6499;681519;330234;1011753
2022.05_01-07-2022;Тверская область;105_165_days;SputnikLite;27984;20420;48404;681519;330234;1011753
2022.05_01-07-2022;Тверская область;105_165_days;SputnikV;29147;16227;45374;681519;330234;1011753
2022.05_01-07-2022;Тверская область;165_195_days;AllVaccines;51972;32101;84073;681519;330234;1011753
2022.05_01-07-2022;Тверская область;165_195_days;CoviVac;845;220;1065;681519;330234;1011753
2022.05_01-07-2022;Тверская область;165_195_days;EpiVacCorona;2611;1140;3751;681519;330234;1011753
2022.05_01-07-2022;Тверская область;165_195_days;SputnikLite;17275;16507;33782;681519;330234;1011753
2022.05_01-07-2022;Тверская область;165_195_days;SputnikV;31241;14234;45475;681519;330234;1011753
2022.05_01-07-2022;Тверская область;21_45_days;AllVaccines;3378;3617;6995;681519;330234;1011753
2022.05_01-07-2022;Тверская область;21_45_days;CoviVac;230;44;274;681519;330234;1011753
2022.05_01-07-2022;Тверская область;21_45_days;EpiVacCorona;152;144;296;681519;330234;1011753
2022.05_01-07-2022;Тверская область;21_45_days;SputnikLite;1082;1512;2594;681519;330234;1011753
2022.05_01-07-2022;Тверская область;21_45_days;SputnikV;1914;1917;3831;681519;330234;1011753
2022.05_01-07-2022;Тверская область;45_75_days;AllVaccines;7499;5690;13189;681519;330234;1011753
2022.05_01-07-2022;Тверская область;45_75_days;CoviVac;245;70;315;681519;330234;1011753
2022.05_01-07-2022;Тверская область;45_75_days;EpiVacCorona;296;195;491;681519;330234;1011753
2022.05_01-07-2022;Тверская область;45_75_days;SputnikLite;3616;3198;6814;681519;330234;1011753
2022.05_01-07-2022;Тверская область;45_75_days;SputnikV;3342;2227;5569;681519;330234;1011753
2022.05_01-07-2022;Тверская область;75_90_days;AllVaccines;8875;5048;13923;681519;330234;1011753
2022.05_01-07-2022;Тверская область;75_90_days;CoviVac;225;48;273;681519;330234;1011753
2022.05_01-07-2022;Тверская область;75_90_days;EpiVacCorona;414;259;673;681519;330234;1011753
2022.05_01-07-2022;Тверская область;75_90_days;SputnikLite;4342;2470;6812;681519;330234;1011753
2022.05_01-07-2022;Тверская область;75_90_days;SputnikV;3894;2271;6165;681519;330234;1011753
2022.05_01-07-2022;Тверская область;90_105_days;AllVaccines;12284;7018;19302;681519;330234;1011753
2022.05_01-07-2022;Тверская область;90_105_days;CoviVac;313;92;405;681519;330234;1011753
2022.05_01-07-2022;Тверская область;90_105_days;EpiVacCorona;522;493;1015;681519;330234;1011753
2022.05_01-07-2022;Тверская область;90_105_days;SputnikLite;7799;4055;11854;681519;330234;1011753
2022.05_01-07-2022;Тверская область;90_105_days;SputnikV;3650;2378;6028;681519;330234;1011753
2022.05_01-07-2022;Томская область;105_165_days;AllVaccines;97484;36571;134055;621613;222482;844095
2022.05_01-07-2022;Томская область;105_165_days;CoviVac;1836;265;2101;621613;222482;844095
2022.05_01-07-2022;Томская область;105_165_days;EpiVacCorona;2259;900;3159;621613;222482;844095
2022.05_01-07-2022;Томская область;105_165_days;SputnikLite;32958;20303;53261;621613;222482;844095
2022.05_01-07-2022;Томская область;105_165_days;SputnikV;60431;15103;75534;621613;222482;844095
2022.05_01-07-2022;Томская область;165_195_days;AllVaccines;66731;22685;89416;621613;222482;844095
2022.05_01-07-2022;Томская область;165_195_days;CoviVac;1783;229;2012;621613;222482;844095
2022.05_01-07-2022;Томская область;165_195_days;EpiVacCorona;948;259;1207;621613;222482;844095
2022.05_01-07-2022;Томская область;165_195_days;SputnikLite;23088;13251;36339;621613;222482;844095
2022.05_01-07-2022;Томская область;165_195_days;SputnikV;40912;8946;49858;621613;222482;844095
2022.05_01-07-2022;Томская область;21_45_days;AllVaccines;3491;2373;5864;621613;222482;844095
2022.05_01-07-2022;Томская область;21_45_days;CoviVac;147;20;167;621613;222482;844095
2022.05_01-07-2022;Томская область;21_45_days;EpiVacCorona;250;103;353;621613;222482;844095
2022.05_01-07-2022;Томская область;21_45_days;SputnikLite;818;616;1434;621613;222482;844095
2022.05_01-07-2022;Томская область;21_45_days;SputnikV;2276;1634;3910;621613;222482;844095
2022.05_01-07-2022;Томская область;45_75_days;AllVaccines;8042;3917;11959;621613;222482;844095
2022.05_01-07-2022;Томская область;45_75_days;CoviVac;206;11;217;621613;222482;844095
2022.05_01-07-2022;Томская область;45_75_days;EpiVacCorona;428;160;588;621613;222482;844095
2022.05_01-07-2022;Томская область;45_75_days;SputnikLite;3105;1671;4776;621613;222482;844095
2022.05_01-07-2022;Томская область;45_75_days;SputnikV;4303;2075;6378;621613;222482;844095
2022.05_01-07-2022;Томская область;75_90_days;AllVaccines;9419;4430;13849;621613;222482;844095
2022.05_01-07-2022;Томская область;75_90_days;CoviVac;123;5;128;621613;222482;844095
2022.05_01-07-2022;Томская область;75_90_days;EpiVacCorona;663;216;879;621613;222482;844095
2022.05_01-07-2022;Томская область;75_90_days;SputnikLite;4021;1720;5741;621613;222482;844095
2022.05_01-07-2022;Томская область;75_90_days;SputnikV;4612;2489;7101;621613;222482;844095
2022.05_01-07-2022;Томская область;90_105_days;AllVaccines;14011;6487;20498;621613;222482;844095
2022.05_01-07-2022;Томская область;90_105_days;CoviVac;178;31;209;621613;222482;844095
2022.05_01-07-2022;Томская область;90_105_days;EpiVacCorona;744;361;1105;621613;222482;844095
2022.05_01-07-2022;Томская область;90_105_days;SputnikLite;8843;3944;12787;621613;222482;844095
2022.05_01-07-2022;Томская область;90_105_days;SputnikV;4246;2151;6397;621613;222482;844095
2022.05_01-07-2022;Тульская область;105_165_days;AllVaccines;94151;51933;146084;804510;401385;1205895
2022.05_01-07-2022;Тульская область;105_165_days;CoviVac;833;331;1164;804510;401385;1205895
2022.05_01-07-2022;Тульская область;105_165_days;EpiVacCorona;3319;2530;5849;804510;401385;1205895
2022.05_01-07-2022;Тульская область;105_165_days;SputnikLite;42558;24882;67440;804510;401385;1205895
2022.05_01-07-2022;Тульская область;105_165_days;SputnikV;47441;24190;71631;804510;401385;1205895
2022.05_01-07-2022;Тульская область;165_195_days;AllVaccines;57944;37915;95859;804510;401385;1205895
2022.05_01-07-2022;Тульская область;165_195_days;CoviVac;1224;440;1664;804510;401385;1205895
2022.05_01-07-2022;Тульская область;165_195_days;EpiVacCorona;2784;2719;5503;804510;401385;1205895
2022.05_01-07-2022;Тульская область;165_195_days;SputnikLite;28918;17993;46911;804510;401385;1205895
2022.05_01-07-2022;Тульская область;165_195_days;SputnikV;25018;16763;41781;804510;401385;1205895
2022.05_01-07-2022;Тульская область;21_45_days;AllVaccines;6078;3481;9559;804510;401385;1205895
2022.05_01-07-2022;Тульская область;21_45_days;CoviVac;98;40;138;804510;401385;1205895
2022.05_01-07-2022;Тульская область;21_45_days;EpiVacCorona;664;344;1008;804510;401385;1205895
2022.05_01-07-2022;Тульская область;21_45_days;SputnikLite;180;99;279;804510;401385;1205895
2022.05_01-07-2022;Тульская область;21_45_days;SputnikV;5136;2998;8134;804510;401385;1205895
2022.05_01-07-2022;Тульская область;45_75_days;AllVaccines;14680;6302;20982;804510;401385;1205895
2022.05_01-07-2022;Тульская область;45_75_days;CoviVac;213;27;240;804510;401385;1205895
2022.05_01-07-2022;Тульская область;45_75_days;EpiVacCorona;1171;558;1729;804510;401385;1205895
2022.05_01-07-2022;Тульская область;45_75_days;SputnikLite;1362;610;1972;804510;401385;1205895
2022.05_01-07-2022;Тульская область;45_75_days;SputnikV;11934;5107;17041;804510;401385;1205895
2022.05_01-07-2022;Тульская область;75_90_days;AllVaccines;13302;5667;18969;804510;401385;1205895
2022.05_01-07-2022;Тульская область;75_90_days;CoviVac;165;30;195;804510;401385;1205895
2022.05_01-07-2022;Тульская область;75_90_days;EpiVacCorona;967;471;1438;804510;401385;1205895
2022.05_01-07-2022;Тульская область;75_90_days;SputnikLite;4454;1497;5951;804510;401385;1205895
2022.05_01-07-2022;Тульская область;75_90_days;SputnikV;7716;3669;11385;804510;401385;1205895
2022.05_01-07-2022;Тульская область;90_105_days;AllVaccines;17399;7871;25270;804510;401385;1205895
2022.05_01-07-2022;Тульская область;90_105_days;CoviVac;292;112;404;804510;401385;1205895
2022.05_01-07-2022;Тульская область;90_105_days;EpiVacCorona;879;639;1518;804510;401385;1205895
2022.05_01-07-2022;Тульская область;90_105_days;SputnikLite;10610;3824;14434;804510;401385;1205895
2022.05_01-07-2022;Тульская область;90_105_days;SputnikV;5618;3296;8914;804510;401385;1205895
2022.05_01-07-2022;Тюменская область;105_165_days;AllVaccines;166049;67510;233559;870789;301209;1171998
2022.05_01-07-2022;Тюменская область;105_165_days;CoviVac;602;143;745;870789;301209;1171998
2022.05_01-07-2022;Тюменская область;105_165_days;EpiVacCorona;619;268;887;870789;301209;1171998
2022.05_01-07-2022;Тюменская область;105_165_days;SputnikLite;73340;40731;114071;870789;301209;1171998
2022.05_01-07-2022;Тюменская область;105_165_days;SputnikV;91488;26368;117856;870789;301209;1171998
2022.05_01-07-2022;Тюменская область;165_195_days;AllVaccines;87461;31987;119448;870789;301209;1171998
2022.05_01-07-2022;Тюменская область;165_195_days;CoviVac;1168;200;1368;870789;301209;1171998
2022.05_01-07-2022;Тюменская область;165_195_days;EpiVacCorona;1056;266;1322;870789;301209;1171998
2022.05_01-07-2022;Тюменская область;165_195_days;SputnikLite;28223;17267;45490;870789;301209;1171998
2022.05_01-07-2022;Тюменская область;165_195_days;SputnikV;57014;14254;71268;870789;301209;1171998
2022.05_01-07-2022;Тюменская область;21_45_days;AllVaccines;5957;2813;8770;870789;301209;1171998
2022.05_01-07-2022;Тюменская область;21_45_days;CoviVac;290;83;373;870789;301209;1171998
2022.05_01-07-2022;Тюменская область;21_45_days;EpiVacCorona;521;163;684;870789;301209;1171998
2022.05_01-07-2022;Тюменская область;21_45_days;SputnikLite;1141;364;1505;870789;301209;1171998
2022.05_01-07-2022;Тюменская область;21_45_days;SputnikV;4005;2203;6208;870789;301209;1171998
2022.05_01-07-2022;Тюменская область;45_75_days;AllVaccines;12030;4935;16965;870789;301209;1171998
2022.05_01-07-2022;Тюменская область;45_75_days;CoviVac;130;44;174;870789;301209;1171998
2022.05_01-07-2022;Тюменская область;45_75_days;EpiVacCorona;483;210;693;870789;301209;1171998
2022.05_01-07-2022;Тюменская область;45_75_days;SputnikLite;3918;1202;5120;870789;301209;1171998
2022.05_01-07-2022;Тюменская область;45_75_days;SputnikV;7499;3479;10978;870789;301209;1171998
2022.05_01-07-2022;Тюменская область;75_90_days;AllVaccines;15173;5790;20963;870789;301209;1171998
2022.05_01-07-2022;Тюменская область;75_90_days;CoviVac;78;21;99;870789;301209;1171998
2022.05_01-07-2022;Тюменская область;75_90_days;EpiVacCorona;527;286;813;870789;301209;1171998
2022.05_01-07-2022;Тюменская область;75_90_days;SputnikLite;7032;2385;9417;870789;301209;1171998
2022.05_01-07-2022;Тюменская область;75_90_days;SputnikV;7536;3098;10634;870789;301209;1171998
2022.05_01-07-2022;Тюменская область;90_105_days;AllVaccines;22097;8952;31049;870789;301209;1171998
2022.05_01-07-2022;Тюменская область;90_105_days;CoviVac;183;46;229;870789;301209;1171998
2022.05_01-07-2022;Тюменская область;90_105_days;EpiVacCorona;235;100;335;870789;301209;1171998
2022.05_01-07-2022;Тюменская область;90_105_days;SputnikLite;16006;6486;22492;870789;301209;1171998
2022.05_01-07-2022;Тюменская область;90_105_days;SputnikV;5673;2320;7993;870789;301209;1171998
2022.05_01-07-2022;Удмуртская Республика;105_165_days;AllVaccines;95959;50463;146422;818861;336450;1155311
2022.05_01-07-2022;Удмуртская Республика;105_165_days;CoviVac;2401;387;2788;818861;336450;1155311
2022.05_01-07-2022;Удмуртская Республика;105_165_days;EpiVacCorona;3898;2475;6373;818861;336450;1155311
2022.05_01-07-2022;Удмуртская Республика;105_165_days;SputnikLite;28548;24755;53303;818861;336450;1155311
2022.05_01-07-2022;Удмуртская Республика;105_165_days;SputnikV;61112;22846;83958;818861;336450;1155311
2022.05_01-07-2022;Удмуртская Республика;165_195_days;AllVaccines;100622;37178;137800;818861;336450;1155311
2022.05_01-07-2022;Удмуртская Республика;165_195_days;CoviVac;1469;210;1679;818861;336450;1155311
2022.05_01-07-2022;Удмуртская Республика;165_195_days;EpiVacCorona;5595;2616;8211;818861;336450;1155311
2022.05_01-07-2022;Удмуртская Республика;165_195_days;SputnikLite;13296;11469;24765;818861;336450;1155311
2022.05_01-07-2022;Удмуртская Республика;165_195_days;SputnikV;80262;22883;103145;818861;336450;1155311
2022.05_01-07-2022;Удмуртская Республика;21_45_days;AllVaccines;5243;3593;8836;818861;336450;1155311
2022.05_01-07-2022;Удмуртская Республика;21_45_days;CoviVac;597;166;763;818861;336450;1155311
2022.05_01-07-2022;Удмуртская Республика;21_45_days;EpiVacCorona;542;491;1033;818861;336450;1155311
2022.05_01-07-2022;Удмуртская Республика;21_45_days;SputnikLite;539;334;873;818861;336450;1155311
2022.05_01-07-2022;Удмуртская Республика;21_45_days;SputnikV;3565;2602;6167;818861;336450;1155311
2022.05_01-07-2022;Удмуртская Республика;45_75_days;AllVaccines;10671;6051;16722;818861;336450;1155311
2022.05_01-07-2022;Удмуртская Республика;45_75_days;CoviVac;368;71;439;818861;336450;1155311
2022.05_01-07-2022;Удмуртская Республика;45_75_days;EpiVacCorona;759;520;1279;818861;336450;1155311
2022.05_01-07-2022;Удмуртская Республика;45_75_days;SputnikLite;2314;1471;3785;818861;336450;1155311
2022.05_01-07-2022;Удмуртская Республика;45_75_days;SputnikV;7230;3989;11219;818861;336450;1155311
2022.05_01-07-2022;Удмуртская Республика;75_90_days;AllVaccines;11389;6240;17629;818861;336450;1155311
2022.05_01-07-2022;Удмуртская Республика;75_90_days;CoviVac;130;28;158;818861;336450;1155311
2022.05_01-07-2022;Удмуртская Республика;75_90_days;EpiVacCorona;686;457;1143;818861;336450;1155311
2022.05_01-07-2022;Удмуртская Республика;75_90_days;SputnikLite;4299;2233;6532;818861;336450;1155311
2022.05_01-07-2022;Удмуртская Республика;75_90_days;SputnikV;6274;3522;9796;818861;336450;1155311
2022.05_01-07-2022;Удмуртская Республика;90_105_days;AllVaccines;13492;8539;22031;818861;336450;1155311
2022.05_01-07-2022;Удмуртская Республика;90_105_days;CoviVac;202;41;243;818861;336450;1155311
2022.05_01-07-2022;Удмуртская Республика;90_105_days;EpiVacCorona;640;663;1303;818861;336450;1155311
2022.05_01-07-2022;Удмуртская Республика;90_105_days;SputnikLite;7244;4225;11469;818861;336450;1155311
2022.05_01-07-2022;Удмуртская Республика;90_105_days;SputnikV;5406;3610;9016;818861;336450;1155311
2022.05_01-07-2022;Ульяновская область;105_165_days;AllVaccines;86225;46682;132907;672149;320065;992214
2022.05_01-07-2022;Ульяновская область;105_165_days;CoviVac;1058;241;1299;672149;320065;992214
2022.05_01-07-2022;Ульяновская область;105_165_days;EpiVacCorona;2764;1459;4223;672149;320065;992214
2022.05_01-07-2022;Ульяновская область;105_165_days;SputnikLite;29629;22567;52196;672149;320065;992214
2022.05_01-07-2022;Ульяновская область;105_165_days;SputnikV;52774;22415;75189;672149;320065;992214
2022.05_01-07-2022;Ульяновская область;165_195_days;AllVaccines;64994;32309;97303;672149;320065;992214
2022.05_01-07-2022;Ульяновская область;165_195_days;CoviVac;1511;358;1869;672149;320065;992214
2022.05_01-07-2022;Ульяновская область;165_195_days;EpiVacCorona;1602;568;2170;672149;320065;992214
2022.05_01-07-2022;Ульяновская область;165_195_days;SputnikLite;14640;14144;28784;672149;320065;992214
2022.05_01-07-2022;Ульяновская область;165_195_days;SputnikV;47241;17239;64480;672149;320065;992214
2022.05_01-07-2022;Ульяновская область;21_45_days;AllVaccines;3764;2375;6139;672149;320065;992214
2022.05_01-07-2022;Ульяновская область;21_45_days;CoviVac;109;34;143;672149;320065;992214
2022.05_01-07-2022;Ульяновская область;21_45_days;EpiVacCorona;189;104;293;672149;320065;992214
2022.05_01-07-2022;Ульяновская область;21_45_days;SputnikLite;360;248;608;672149;320065;992214
2022.05_01-07-2022;Ульяновская область;21_45_days;SputnikV;3106;1989;5095;672149;320065;992214
2022.05_01-07-2022;Ульяновская область;45_75_days;AllVaccines;6306;3265;9571;672149;320065;992214
2022.05_01-07-2022;Ульяновская область;45_75_days;CoviVac;94;34;128;672149;320065;992214
2022.05_01-07-2022;Ульяновская область;45_75_days;EpiVacCorona;460;235;695;672149;320065;992214
2022.05_01-07-2022;Ульяновская область;45_75_days;SputnikLite;1245;623;1868;672149;320065;992214
2022.05_01-07-2022;Ульяновская область;45_75_days;SputnikV;4507;2373;6880;672149;320065;992214
2022.05_01-07-2022;Ульяновская область;75_90_days;AllVaccines;7014;3732;10746;672149;320065;992214
2022.05_01-07-2022;Ульяновская область;75_90_days;CoviVac;80;21;101;672149;320065;992214
2022.05_01-07-2022;Ульяновская область;75_90_days;EpiVacCorona;609;352;961;672149;320065;992214
2022.05_01-07-2022;Ульяновская область;75_90_days;SputnikLite;2450;1125;3575;672149;320065;992214
2022.05_01-07-2022;Ульяновская область;75_90_days;SputnikV;3875;2234;6109;672149;320065;992214
2022.05_01-07-2022;Ульяновская область;90_105_days;AllVaccines;10249;5239;15488;672149;320065;992214
2022.05_01-07-2022;Ульяновская область;90_105_days;CoviVac;136;41;177;672149;320065;992214
2022.05_01-07-2022;Ульяновская область;90_105_days;EpiVacCorona;434;298;732;672149;320065;992214
2022.05_01-07-2022;Ульяновская область;90_105_days;SputnikLite;6166;2883;9049;672149;320065;992214
2022.05_01-07-2022;Ульяновская область;90_105_days;SputnikV;3513;2017;5530;672149;320065;992214
2022.05_01-07-2022;Хабаровский край;105_165_days;AllVaccines;101936;39337;141273;757169;265178;1022347
2022.05_01-07-2022;Хабаровский край;105_165_days;CoviVac;1788;352;2140;757169;265178;1022347
2022.05_01-07-2022;Хабаровский край;105_165_days;EpiVacCorona;6383;2212;8595;757169;265178;1022347
2022.05_01-07-2022;Хабаровский край;105_165_days;SputnikLite;35639;17866;53505;757169;265178;1022347
2022.05_01-07-2022;Хабаровский край;105_165_days;SputnikV;58126;18907;77033;757169;265178;1022347
2022.05_01-07-2022;Хабаровский край;165_195_days;AllVaccines;51243;19397;70640;757169;265178;1022347
2022.05_01-07-2022;Хабаровский край;165_195_days;CoviVac;1180;252;1432;757169;265178;1022347
2022.05_01-07-2022;Хабаровский край;165_195_days;EpiVacCorona;1237;336;1573;757169;265178;1022347
2022.05_01-07-2022;Хабаровский край;165_195_days;SputnikLite;28316;10894;39210;757169;265178;1022347
2022.05_01-07-2022;Хабаровский край;165_195_days;SputnikV;20510;7915;28425;757169;265178;1022347
2022.05_01-07-2022;Хабаровский край;21_45_days;AllVaccines;4014;2555;6569;757169;265178;1022347
2022.05_01-07-2022;Хабаровский край;21_45_days;CoviVac;97;34;131;757169;265178;1022347
2022.05_01-07-2022;Хабаровский край;21_45_days;EpiVacCorona;343;233;576;757169;265178;1022347
2022.05_01-07-2022;Хабаровский край;21_45_days;SputnikLite;826;307;1133;757169;265178;1022347
2022.05_01-07-2022;Хабаровский край;21_45_days;SputnikV;2748;1981;4729;757169;265178;1022347
2022.05_01-07-2022;Хабаровский край;45_75_days;AllVaccines;7558;3479;11037;757169;265178;1022347
2022.05_01-07-2022;Хабаровский край;45_75_days;CoviVac;188;83;271;757169;265178;1022347
2022.05_01-07-2022;Хабаровский край;45_75_days;EpiVacCorona;531;260;791;757169;265178;1022347
2022.05_01-07-2022;Хабаровский край;45_75_days;SputnikLite;1732;718;2450;757169;265178;1022347
2022.05_01-07-2022;Хабаровский край;45_75_days;SputnikV;5107;2418;7525;757169;265178;1022347
2022.05_01-07-2022;Хабаровский край;75_90_days;AllVaccines;11952;5392;17344;757169;265178;1022347
2022.05_01-07-2022;Хабаровский край;75_90_days;CoviVac;127;29;156;757169;265178;1022347
2022.05_01-07-2022;Хабаровский край;75_90_days;EpiVacCorona;738;312;1050;757169;265178;1022347
2022.05_01-07-2022;Хабаровский край;75_90_days;SputnikLite;4831;1719;6550;757169;265178;1022347
2022.05_01-07-2022;Хабаровский край;75_90_days;SputnikV;6256;3332;9588;757169;265178;1022347
2022.05_01-07-2022;Хабаровский край;90_105_days;AllVaccines;14872;6973;21845;757169;265178;1022347
2022.05_01-07-2022;Хабаровский край;90_105_days;CoviVac;276;54;330;757169;265178;1022347
2022.05_01-07-2022;Хабаровский край;90_105_days;EpiVacCorona;1118;496;1614;757169;265178;1022347
2022.05_01-07-2022;Хабаровский край;90_105_days;SputnikLite;7515;3237;10752;757169;265178;1022347
2022.05_01-07-2022;Хабаровский край;90_105_days;SputnikV;5963;3186;9149;757169;265178;1022347
2022.05_01-07-2022;Ханты-Мансийский автономный округ - Югра;105_165_days;AllVaccines;148047;37561;185608;1019471;240107;1259578
2022.05_01-07-2022;Ханты-Мансийский автономный округ - Югра;105_165_days;CoviVac;659;134;793;1019471;240107;1259578
2022.05_01-07-2022;Ханты-Мансийский автономный округ - Югра;105_165_days;EpiVacCorona;2001;744;2745;1019471;240107;1259578
2022.05_01-07-2022;Ханты-Мансийский автономный округ - Югра;105_165_days;SputnikLite;73588;20589;94177;1019471;240107;1259578
2022.05_01-07-2022;Ханты-Мансийский автономный округ - Югра;105_165_days;SputnikV;71799;16094;87893;1019471;240107;1259578
2022.05_01-07-2022;Ханты-Мансийский автономный округ - Югра;165_195_days;AllVaccines;131274;27588;158862;1019471;240107;1259578
2022.05_01-07-2022;Ханты-Мансийский автономный округ - Югра;165_195_days;CoviVac;1189;208;1397;1019471;240107;1259578
2022.05_01-07-2022;Ханты-Мансийский автономный округ - Югра;165_195_days;EpiVacCorona;1439;399;1838;1019471;240107;1259578
2022.05_01-07-2022;Ханты-Мансийский автономный округ - Югра;165_195_days;SputnikLite;29452;11119;40571;1019471;240107;1259578
2022.05_01-07-2022;Ханты-Мансийский автономный округ - Югра;165_195_days;SputnikV;99194;15862;115056;1019471;240107;1259578
2022.05_01-07-2022;Ханты-Мансийский автономный округ - Югра;21_45_days;AllVaccines;8692;1817;10509;1019471;240107;1259578
2022.05_01-07-2022;Ханты-Мансийский автономный округ - Югра;21_45_days;CoviVac;289;34;323;1019471;240107;1259578
2022.05_01-07-2022;Ханты-Мансийский автономный округ - Югра;21_45_days;EpiVacCorona;423;95;518;1019471;240107;1259578
2022.05_01-07-2022;Ханты-Мансийский автономный округ - Югра;21_45_days;SputnikLite;1274;257;1531;1019471;240107;1259578
2022.05_01-07-2022;Ханты-Мансийский автономный округ - Югра;21_45_days;SputnikV;6706;1431;8137;1019471;240107;1259578
2022.05_01-07-2022;Ханты-Мансийский автономный округ - Югра;45_75_days;AllVaccines;18070;3514;21584;1019471;240107;1259578
2022.05_01-07-2022;Ханты-Мансийский автономный округ - Югра;45_75_days;CoviVac;227;36;263;1019471;240107;1259578
2022.05_01-07-2022;Ханты-Мансийский автономный округ - Югра;45_75_days;EpiVacCorona;322;70;392;1019471;240107;1259578
2022.05_01-07-2022;Ханты-Мансийский автономный округ - Югра;45_75_days;SputnikLite;6320;1324;7644;1019471;240107;1259578
2022.05_01-07-2022;Ханты-Мансийский автономный округ - Югра;45_75_days;SputnikV;11201;2084;13285;1019471;240107;1259578
2022.05_01-07-2022;Ханты-Мансийский автономный округ - Югра;75_90_days;AllVaccines;21005;3669;24674;1019471;240107;1259578
2022.05_01-07-2022;Ханты-Мансийский автономный округ - Югра;75_90_days;CoviVac;95;19;114;1019471;240107;1259578
2022.05_01-07-2022;Ханты-Мансийский автономный округ - Югра;75_90_days;EpiVacCorona;229;48;277;1019471;240107;1259578
2022.05_01-07-2022;Ханты-Мансийский автономный округ - Югра;75_90_days;SputnikLite;11986;1758;13744;1019471;240107;1259578
2022.05_01-07-2022;Ханты-Мансийский автономный округ - Югра;75_90_days;SputnikV;8695;1844;10539;1019471;240107;1259578
2022.05_01-07-2022;Ханты-Мансийский автономный округ - Югра;90_105_days;AllVaccines;24634;5226;29860;1019471;240107;1259578
2022.05_01-07-2022;Ханты-Мансийский автономный округ - Югра;90_105_days;CoviVac;163;30;193;1019471;240107;1259578
2022.05_01-07-2022;Ханты-Мансийский автономный округ - Югра;90_105_days;EpiVacCorona;273;99;372;1019471;240107;1259578
2022.05_01-07-2022;Ханты-Мансийский автономный округ - Югра;90_105_days;SputnikLite;16453;3132;19585;1019471;240107;1259578
2022.05_01-07-2022;Ханты-Мансийский автономный округ - Югра;90_105_days;SputnikV;7745;1965;9710;1019471;240107;1259578
2022.05_01-07-2022;Челябинская область;105_165_days;AllVaccines;267331;129477;396808;1901705;795956;2697661
2022.05_01-07-2022;Челябинская область;105_165_days;CoviVac;1652;509;2161;1901705;795956;2697661
2022.05_01-07-2022;Челябинская область;105_165_days;EpiVacCorona;7729;4540;12269;1901705;795956;2697661
2022.05_01-07-2022;Челябинская область;105_165_days;SputnikLite;101237;57933;159170;1901705;795956;2697661
2022.05_01-07-2022;Челябинская область;105_165_days;SputnikV;156713;66495;223208;1901705;795956;2697661
2022.05_01-07-2022;Челябинская область;165_195_days;AllVaccines;284861;98362;383223;1901705;795956;2697661
2022.05_01-07-2022;Челябинская область;165_195_days;CoviVac;3217;577;3794;1901705;795956;2697661
2022.05_01-07-2022;Челябинская область;165_195_days;EpiVacCorona;10013;3513;13526;1901705;795956;2697661
2022.05_01-07-2022;Челябинская область;165_195_days;SputnikLite;44086;23245;67331;1901705;795956;2697661
2022.05_01-07-2022;Челябинская область;165_195_days;SputnikV;227545;71027;298572;1901705;795956;2697661
2022.05_01-07-2022;Челябинская область;21_45_days;AllVaccines;16103;10239;26342;1901705;795956;2697661
2022.05_01-07-2022;Челябинская область;21_45_days;CoviVac;780;165;945;1901705;795956;2697661
2022.05_01-07-2022;Челябинская область;21_45_days;EpiVacCorona;1111;836;1947;1901705;795956;2697661
2022.05_01-07-2022;Челябинская область;21_45_days;SputnikLite;6676;3889;10565;1901705;795956;2697661
2022.05_01-07-2022;Челябинская область;21_45_days;SputnikV;7536;5349;12885;1901705;795956;2697661
2022.05_01-07-2022;Челябинская область;45_75_days;AllVaccines;27379;14682;42061;1901705;795956;2697661
2022.05_01-07-2022;Челябинская область;45_75_days;CoviVac;266;55;321;1901705;795956;2697661
2022.05_01-07-2022;Челябинская область;45_75_days;EpiVacCorona;1215;1440;2655;1901705;795956;2697661
2022.05_01-07-2022;Челябинская область;45_75_days;SputnikLite;12012;6333;18345;1901705;795956;2697661
2022.05_01-07-2022;Челябинская область;45_75_days;SputnikV;13886;6854;20740;1901705;795956;2697661
2022.05_01-07-2022;Челябинская область;75_90_days;AllVaccines;27735;12895;40630;1901705;795956;2697661
2022.05_01-07-2022;Челябинская область;75_90_days;CoviVac;155;22;177;1901705;795956;2697661
2022.05_01-07-2022;Челябинская область;75_90_days;EpiVacCorona;1990;1309;3299;1901705;795956;2697661
2022.05_01-07-2022;Челябинская область;75_90_days;SputnikLite;13755;5222;18977;1901705;795956;2697661
2022.05_01-07-2022;Челябинская область;75_90_days;SputnikV;11835;6342;18177;1901705;795956;2697661
2022.05_01-07-2022;Челябинская область;90_105_days;AllVaccines;31528;16922;48450;1901705;795956;2697661
2022.05_01-07-2022;Челябинская область;90_105_days;CoviVac;286;81;367;1901705;795956;2697661
2022.05_01-07-2022;Челябинская область;90_105_days;EpiVacCorona;1719;1572;3291;1901705;795956;2697661
2022.05_01-07-2022;Челябинская область;90_105_days;SputnikLite;18457;7532;25989;1901705;795956;2697661
2022.05_01-07-2022;Челябинская область;90_105_days;SputnikV;11066;7737;18803;1901705;795956;2697661
2022.05_01-07-2022;Чеченская Республика;105_165_days;AllVaccines;42684;5424;48108;809759;137234;946993
2022.05_01-07-2022;Чеченская Республика;105_165_days;CoviVac;185;38;223;809759;137234;946993
2022.05_01-07-2022;Чеченская Республика;105_165_days;EpiVacCorona;2671;444;3115;809759;137234;946993
2022.05_01-07-2022;Чеченская Республика;105_165_days;SputnikLite;30465;3495;33960;809759;137234;946993
2022.05_01-07-2022;Чеченская Республика;105_165_days;SputnikV;9363;1447;10810;809759;137234;946993
2022.05_01-07-2022;Чеченская Республика;165_195_days;AllVaccines;18787;3082;21869;809759;137234;946993
2022.05_01-07-2022;Чеченская Республика;165_195_days;CoviVac;364;67;431;809759;137234;946993
2022.05_01-07-2022;Чеченская Республика;165_195_days;EpiVacCorona;1943;313;2256;809759;137234;946993
2022.05_01-07-2022;Чеченская Республика;165_195_days;SputnikLite;2953;192;3145;809759;137234;946993
2022.05_01-07-2022;Чеченская Республика;165_195_days;SputnikV;13527;2510;16037;809759;137234;946993
2022.05_01-07-2022;Чеченская Республика;21_45_days;AllVaccines;10512;1723;12235;809759;137234;946993
2022.05_01-07-2022;Чеченская Республика;21_45_days;CoviVac;693;126;819;809759;137234;946993
2022.05_01-07-2022;Чеченская Республика;21_45_days;EpiVacCorona;33;2;35;809759;137234;946993
2022.05_01-07-2022;Чеченская Республика;21_45_days;SputnikLite;7012;1114;8126;809759;137234;946993
2022.05_01-07-2022;Чеченская Республика;21_45_days;SputnikV;2774;481;3255;809759;137234;946993
2022.05_01-07-2022;Чеченская Республика;45_75_days;AllVaccines;14344;2878;17222;809759;137234;946993
2022.05_01-07-2022;Чеченская Республика;45_75_days;CoviVac;3418;649;4067;809759;137234;946993
2022.05_01-07-2022;Чеченская Республика;45_75_days;EpiVacCorona;261;28;289;809759;137234;946993
2022.05_01-07-2022;Чеченская Республика;45_75_days;SputnikLite;2841;717;3558;809759;137234;946993
2022.05_01-07-2022;Чеченская Республика;45_75_days;SputnikV;7824;1484;9308;809759;137234;946993
2022.05_01-07-2022;Чеченская Республика;75_90_days;AllVaccines;7874;1228;9102;809759;137234;946993
2022.05_01-07-2022;Чеченская Республика;75_90_days;CoviVac;215;22;237;809759;137234;946993
2022.05_01-07-2022;Чеченская Республика;75_90_days;EpiVacCorona;346;45;391;809759;137234;946993
2022.05_01-07-2022;Чеченская Республика;75_90_days;SputnikLite;4619;754;5373;809759;137234;946993
2022.05_01-07-2022;Чеченская Республика;75_90_days;SputnikV;2694;407;3101;809759;137234;946993
2022.05_01-07-2022;Чеченская Республика;90_105_days;AllVaccines;15860;1778;17638;809759;137234;946993
2022.05_01-07-2022;Чеченская Республика;90_105_days;CoviVac;3;0;3;809759;137234;946993
2022.05_01-07-2022;Чеченская Республика;90_105_days;EpiVacCorona;327;54;381;809759;137234;946993
2022.05_01-07-2022;Чеченская Республика;90_105_days;SputnikLite;13168;1426;14594;809759;137234;946993
2022.05_01-07-2022;Чеченская Республика;90_105_days;SputnikV;2362;298;2660;809759;137234;946993
2022.05_01-07-2022;Чувашская Республика;105_165_days;AllVaccines;93529;45813;139342;674689;275580;950269
2022.05_01-07-2022;Чувашская Республика;105_165_days;CoviVac;1281;190;1471;674689;275580;950269
2022.05_01-07-2022;Чувашская Республика;105_165_days;EpiVacCorona;2510;1087;3597;674689;275580;950269
2022.05_01-07-2022;Чувашская Республика;105_165_days;SputnikLite;29155;21307;50462;674689;275580;950269
2022.05_01-07-2022;Чувашская Республика;105_165_days;SputnikV;60583;23229;83812;674689;275580;950269
2022.05_01-07-2022;Чувашская Республика;165_195_days;AllVaccines;70404;27806;98210;674689;275580;950269
2022.05_01-07-2022;Чувашская Республика;165_195_days;CoviVac;1172;175;1347;674689;275580;950269
2022.05_01-07-2022;Чувашская Республика;165_195_days;EpiVacCorona;2041;499;2540;674689;275580;950269
2022.05_01-07-2022;Чувашская Республика;165_195_days;SputnikLite;9885;9384;19269;674689;275580;950269
2022.05_01-07-2022;Чувашская Республика;165_195_days;SputnikV;57306;17748;75054;674689;275580;950269
2022.05_01-07-2022;Чувашская Республика;21_45_days;AllVaccines;5810;3648;9458;674689;275580;950269
2022.05_01-07-2022;Чувашская Республика;21_45_days;CoviVac;446;127;573;674689;275580;950269
2022.05_01-07-2022;Чувашская Республика;21_45_days;EpiVacCorona;275;187;462;674689;275580;950269
2022.05_01-07-2022;Чувашская Республика;21_45_days;SputnikLite;1082;891;1973;674689;275580;950269
2022.05_01-07-2022;Чувашская Республика;21_45_days;SputnikV;4007;2443;6450;674689;275580;950269
2022.05_01-07-2022;Чувашская Республика;45_75_days;AllVaccines;9375;5307;14682;674689;275580;950269
2022.05_01-07-2022;Чувашская Республика;45_75_days;CoviVac;162;22;184;674689;275580;950269
2022.05_01-07-2022;Чувашская Республика;45_75_days;EpiVacCorona;730;525;1255;674689;275580;950269
2022.05_01-07-2022;Чувашская Республика;45_75_days;SputnikLite;2678;1297;3975;674689;275580;950269
2022.05_01-07-2022;Чувашская Республика;45_75_days;SputnikV;5805;3463;9268;674689;275580;950269
2022.05_01-07-2022;Чувашская Республика;75_90_days;AllVaccines;12133;5630;17763;674689;275580;950269
2022.05_01-07-2022;Чувашская Республика;75_90_days;CoviVac;248;35;283;674689;275580;950269
2022.05_01-07-2022;Чувашская Республика;75_90_days;EpiVacCorona;731;295;1026;674689;275580;950269
2022.05_01-07-2022;Чувашская Республика;75_90_days;SputnikLite;6210;2681;8891;674689;275580;950269
2022.05_01-07-2022;Чувашская Республика;75_90_days;SputnikV;4944;2619;7563;674689;275580;950269
2022.05_01-07-2022;Чувашская Республика;90_105_days;AllVaccines;14564;7273;21837;674689;275580;950269
2022.05_01-07-2022;Чувашская Республика;90_105_days;CoviVac;199;45;244;674689;275580;950269
2022.05_01-07-2022;Чувашская Республика;90_105_days;EpiVacCorona;841;427;1268;674689;275580;950269
2022.05_01-07-2022;Чувашская Республика;90_105_days;SputnikLite;7144;3447;10591;674689;275580;950269
2022.05_01-07-2022;Чувашская Республика;90_105_days;SputnikV;6380;3354;9734;674689;275580;950269
2022.05_01-07-2022;Чукотский автономный округ;105_165_days;AllVaccines;4210;695;4905;30806;6299;37105
2022.05_01-07-2022;Чукотский автономный округ;105_165_days;CoviVac;130;19;149;30806;6299;37105
2022.05_01-07-2022;Чукотский автономный округ;105_165_days;EpiVacCorona;395;56;451;30806;6299;37105
2022.05_01-07-2022;Чукотский автономный округ;105_165_days;SputnikLite;3002;523;3525;30806;6299;37105
2022.05_01-07-2022;Чукотский автономный округ;105_165_days;SputnikV;683;97;780;30806;6299;37105
2022.05_01-07-2022;Чукотский автономный округ;165_195_days;AllVaccines;4419;741;5160;30806;6299;37105
2022.05_01-07-2022;Чукотский автономный округ;165_195_days;CoviVac;525;33;558;30806;6299;37105
2022.05_01-07-2022;Чукотский автономный округ;165_195_days;EpiVacCorona;255;34;289;30806;6299;37105
2022.05_01-07-2022;Чукотский автономный округ;165_195_days;SputnikLite;3197;610;3807;30806;6299;37105
2022.05_01-07-2022;Чукотский автономный округ;165_195_days;SputnikV;442;64;506;30806;6299;37105
2022.05_01-07-2022;Чукотский автономный округ;21_45_days;AllVaccines;504;106;610;30806;6299;37105
2022.05_01-07-2022;Чукотский автономный округ;21_45_days;CoviVac;21;1;22;30806;6299;37105
2022.05_01-07-2022;Чукотский автономный округ;21_45_days;EpiVacCorona;18;4;22;30806;6299;37105
2022.05_01-07-2022;Чукотский автономный округ;21_45_days;SputnikLite;298;66;364;30806;6299;37105
2022.05_01-07-2022;Чукотский автономный округ;21_45_days;SputnikV;167;35;202;30806;6299;37105
2022.05_01-07-2022;Чукотский автономный округ;45_75_days;AllVaccines;914;148;1062;30806;6299;37105
2022.05_01-07-2022;Чукотский автономный округ;45_75_days;CoviVac;16;1;17;30806;6299;37105
2022.05_01-07-2022;Чукотский автономный округ;45_75_days;EpiVacCorona;33;3;36;30806;6299;37105
2022.05_01-07-2022;Чукотский автономный округ;45_75_days;SputnikLite;596;96;692;30806;6299;37105
2022.05_01-07-2022;Чукотский автономный округ;45_75_days;SputnikV;269;48;317;30806;6299;37105
2022.05_01-07-2022;Чукотский автономный округ;75_90_days;AllVaccines;651;92;743;30806;6299;37105
2022.05_01-07-2022;Чукотский автономный округ;75_90_days;CoviVac;29;2;31;30806;6299;37105
2022.05_01-07-2022;Чукотский автономный округ;75_90_days;EpiVacCorona;40;5;45;30806;6299;37105
2022.05_01-07-2022;Чукотский автономный округ;75_90_days;SputnikLite;406;55;461;30806;6299;37105
2022.05_01-07-2022;Чукотский автономный округ;75_90_days;SputnikV;176;30;206;30806;6299;37105
2022.05_01-07-2022;Чукотский автономный округ;90_105_days;AllVaccines;870;124;994;30806;6299;37105
2022.05_01-07-2022;Чукотский автономный округ;90_105_days;CoviVac;32;4;36;30806;6299;37105
2022.05_01-07-2022;Чукотский автономный округ;90_105_days;EpiVacCorona;53;14;67;30806;6299;37105
2022.05_01-07-2022;Чукотский автономный округ;90_105_days;SputnikLite;624;71;695;30806;6299;37105
2022.05_01-07-2022;Чукотский автономный округ;90_105_days;SputnikV;161;35;196;30806;6299;37105
2022.05_01-07-2022;Ямало-Ненецкий автономный округ;105_165_days;AllVaccines;44328;5752;50080;346064;56429;402493
2022.05_01-07-2022;Ямало-Ненецкий автономный округ;105_165_days;CoviVac;459;81;540;346064;56429;402493
2022.05_01-07-2022;Ямало-Ненецкий автономный округ;105_165_days;EpiVacCorona;246;34;280;346064;56429;402493
2022.05_01-07-2022;Ямало-Ненецкий автономный округ;105_165_days;SputnikLite;25253;3731;28984;346064;56429;402493
2022.05_01-07-2022;Ямало-Ненецкий автономный округ;105_165_days;SputnikV;18370;1906;20276;346064;56429;402493
2022.05_01-07-2022;Ямало-Ненецкий автономный округ;165_195_days;AllVaccines;43090;5147;48237;346064;56429;402493
2022.05_01-07-2022;Ямало-Ненецкий автономный округ;165_195_days;CoviVac;536;50;586;346064;56429;402493
2022.05_01-07-2022;Ямало-Ненецкий автономный округ;165_195_days;EpiVacCorona;222;19;241;346064;56429;402493
2022.05_01-07-2022;Ямало-Ненецкий автономный округ;165_195_days;SputnikLite;18912;3323;22235;346064;56429;402493
2022.05_01-07-2022;Ямало-Ненецкий автономный округ;165_195_days;SputnikV;23420;1755;25175;346064;56429;402493
2022.05_01-07-2022;Ямало-Ненецкий автономный округ;21_45_days;AllVaccines;4137;533;4670;346064;56429;402493
2022.05_01-07-2022;Ямало-Ненецкий автономный округ;21_45_days;CoviVac;50;7;57;346064;56429;402493
2022.05_01-07-2022;Ямало-Ненецкий автономный округ;21_45_days;EpiVacCorona;63;9;72;346064;56429;402493
2022.05_01-07-2022;Ямало-Ненецкий автономный округ;21_45_days;SputnikLite;2871;369;3240;346064;56429;402493
2022.05_01-07-2022;Ямало-Ненецкий автономный округ;21_45_days;SputnikV;1153;148;1301;346064;56429;402493
2022.05_01-07-2022;Ямало-Ненецкий автономный округ;45_75_days;AllVaccines;6531;801;7332;346064;56429;402493
2022.05_01-07-2022;Ямало-Ненецкий автономный округ;45_75_days;CoviVac;51;7;58;346064;56429;402493
2022.05_01-07-2022;Ямало-Ненецкий автономный округ;45_75_days;EpiVacCorona;162;25;187;346064;56429;402493
2022.05_01-07-2022;Ямало-Ненецкий автономный округ;45_75_days;SputnikLite;4072;509;4581;346064;56429;402493
2022.05_01-07-2022;Ямало-Ненецкий автономный округ;45_75_days;SputnikV;2246;260;2506;346064;56429;402493
2022.05_01-07-2022;Ямало-Ненецкий автономный округ;75_90_days;AllVaccines;5746;764;6510;346064;56429;402493
2022.05_01-07-2022;Ямало-Ненецкий автономный округ;75_90_days;CoviVac;47;3;50;346064;56429;402493
2022.05_01-07-2022;Ямало-Ненецкий автономный округ;75_90_days;EpiVacCorona;163;21;184;346064;56429;402493
2022.05_01-07-2022;Ямало-Ненецкий автономный округ;75_90_days;SputnikLite;3279;405;3684;346064;56429;402493
2022.05_01-07-2022;Ямало-Ненецкий автономный округ;75_90_days;SputnikV;2257;335;2592;346064;56429;402493
2022.05_01-07-2022;Ямало-Ненецкий автономный округ;90_105_days;AllVaccines;8341;1046;9387;346064;56429;402493
2022.05_01-07-2022;Ямало-Ненецкий автономный округ;90_105_days;CoviVac;64;6;70;346064;56429;402493
2022.05_01-07-2022;Ямало-Ненецкий автономный округ;90_105_days;EpiVacCorona;91;14;105;346064;56429;402493
2022.05_01-07-2022;Ямало-Ненецкий автономный округ;90_105_days;SputnikLite;5977;688;6665;346064;56429;402493
2022.05_01-07-2022;Ямало-Ненецкий автономный округ;90_105_days;SputnikV;2209;338;2547;346064;56429;402493
2022.05_01-07-2022;Ярославская область;105_165_days;AllVaccines;72230;40027;112257;682586;317712;1000298
2022.05_01-07-2022;Ярославская область;105_165_days;CoviVac;1375;317;1692;682586;317712;1000298
2022.05_01-07-2022;Ярославская область;105_165_days;EpiVacCorona;1708;842;2550;682586;317712;1000298
2022.05_01-07-2022;Ярославская область;105_165_days;SputnikLite;33954;21602;55556;682586;317712;1000298
2022.05_01-07-2022;Ярославская область;105_165_days;SputnikV;35193;17266;52459;682586;317712;1000298
2022.05_01-07-2022;Ярославская область;165_195_days;AllVaccines;53104;29543;82647;682586;317712;1000298
2022.05_01-07-2022;Ярославская область;165_195_days;CoviVac;484;37;521;682586;317712;1000298
2022.05_01-07-2022;Ярославская область;165_195_days;EpiVacCorona;565;236;801;682586;317712;1000298
2022.05_01-07-2022;Ярославская область;165_195_days;SputnikLite;30474;16816;47290;682586;317712;1000298
2022.05_01-07-2022;Ярославская область;165_195_days;SputnikV;21581;12454;34035;682586;317712;1000298
2022.05_01-07-2022;Ярославская область;21_45_days;AllVaccines;3148;2348;5496;682586;317712;1000298
2022.05_01-07-2022;Ярославская область;21_45_days;CoviVac;176;64;240;682586;317712;1000298
2022.05_01-07-2022;Ярославская область;21_45_days;EpiVacCorona;134;80;214;682586;317712;1000298
2022.05_01-07-2022;Ярославская область;21_45_days;SputnikLite;810;409;1219;682586;317712;1000298
2022.05_01-07-2022;Ярославская область;21_45_days;SputnikV;2028;1795;3823;682586;317712;1000298
2022.05_01-07-2022;Ярославская область;45_75_days;AllVaccines;7139;3499;10638;682586;317712;1000298
2022.05_01-07-2022;Ярославская область;45_75_days;CoviVac;260;73;333;682586;317712;1000298
2022.05_01-07-2022;Ярославская область;45_75_days;EpiVacCorona;297;115;412;682586;317712;1000298
2022.05_01-07-2022;Ярославская область;45_75_days;SputnikLite;2042;988;3030;682586;317712;1000298
2022.05_01-07-2022;Ярославская область;45_75_days;SputnikV;4540;2323;6863;682586;317712;1000298
2022.05_01-07-2022;Ярославская область;75_90_days;AllVaccines;7474;3552;11026;682586;317712;1000298
2022.05_01-07-2022;Ярославская область;75_90_days;CoviVac;204;38;242;682586;317712;1000298
2022.05_01-07-2022;Ярославская область;75_90_days;EpiVacCorona;213;89;302;682586;317712;1000298
2022.05_01-07-2022;Ярославская область;75_90_days;SputnikLite;3192;1363;4555;682586;317712;1000298
2022.05_01-07-2022;Ярославская область;75_90_days;SputnikV;3865;2062;5927;682586;317712;1000298
2022.05_01-07-2022;Ярославская область;90_105_days;AllVaccines;9568;4829;14397;682586;317712;1000298
2022.05_01-07-2022;Ярославская область;90_105_days;CoviVac;258;49;307;682586;317712;1000298
2022.05_01-07-2022;Ярославская область;90_105_days;EpiVacCorona;557;244;801;682586;317712;1000298
2022.05_01-07-2022;Ярославская область;90_105_days;SputnikLite;5054;2332;7386;682586;317712;1000298
2022.05_01-07-2022;Ярославская область;90_105_days;SputnikV;3699;2204;5903;682586;317712;1000298
2022.05_01-07-2022;г. Москва;105_165_days;AllVaccines;622953;318680;941633;7299088;3167729;10466817
2022.05_01-07-2022;г. Москва;105_165_days;CoviVac;21559;2354;23913;7299088;3167729;10466817
2022.05_01-07-2022;г. Москва;105_165_days;EpiVacCorona;1339;816;2155;7299088;3167729;10466817
2022.05_01-07-2022;г. Москва;105_165_days;SputnikLite;293279;164149;457428;7299088;3167729;10466817
2022.05_01-07-2022;г. Москва;105_165_days;SputnikV;306776;151361;458137;7299088;3167729;10466817
2022.05_01-07-2022;г. Москва;165_195_days;AllVaccines;402179;289752;691931;7299088;3167729;10466817
2022.05_01-07-2022;г. Москва;165_195_days;CoviVac;14319;2880;17199;7299088;3167729;10466817
2022.05_01-07-2022;г. Москва;165_195_days;EpiVacCorona;1353;991;2344;7299088;3167729;10466817
2022.05_01-07-2022;г. Москва;165_195_days;SputnikLite;152106;120044;272150;7299088;3167729;10466817
2022.05_01-07-2022;г. Москва;165_195_days;SputnikV;234401;165837;400238;7299088;3167729;10466817
2022.05_01-07-2022;г. Москва;21_45_days;AllVaccines;20353;12343;32696;7299088;3167729;10466817
2022.05_01-07-2022;г. Москва;21_45_days;CoviVac;630;72;702;7299088;3167729;10466817
2022.05_01-07-2022;г. Москва;21_45_days;EpiVacCorona;14;9;23;7299088;3167729;10466817
2022.05_01-07-2022;г. Москва;21_45_days;SputnikLite;4752;1276;6028;7299088;3167729;10466817
2022.05_01-07-2022;г. Москва;21_45_days;SputnikV;14957;10986;25943;7299088;3167729;10466817
2022.05_01-07-2022;г. Москва;45_75_days;AllVaccines;56779;25814;82593;7299088;3167729;10466817
2022.05_01-07-2022;г. Москва;45_75_days;CoviVac;1325;130;1455;7299088;3167729;10466817
2022.05_01-07-2022;г. Москва;45_75_days;EpiVacCorona;39;30;69;7299088;3167729;10466817
2022.05_01-07-2022;г. Москва;45_75_days;SputnikLite;13346;4842;18188;7299088;3167729;10466817
2022.05_01-07-2022;г. Москва;45_75_days;SputnikV;42069;20812;62881;7299088;3167729;10466817
2022.05_01-07-2022;г. Москва;75_90_days;AllVaccines;85048;31491;116539;7299088;3167729;10466817
2022.05_01-07-2022;г. Москва;75_90_days;CoviVac;1442;86;1528;7299088;3167729;10466817
2022.05_01-07-2022;г. Москва;75_90_days;EpiVacCorona;100;35;135;7299088;3167729;10466817
2022.05_01-07-2022;г. Москва;75_90_days;SputnikLite;37974;15440;53414;7299088;3167729;10466817
2022.05_01-07-2022;г. Москва;75_90_days;SputnikV;45532;15930;61462;7299088;3167729;10466817
2022.05_01-07-2022;г. Москва;90_105_days;AllVaccines;139944;52471;192415;7299088;3167729;10466817
2022.05_01-07-2022;г. Москва;90_105_days;CoviVac;2354;224;2578;7299088;3167729;10466817
2022.05_01-07-2022;г. Москва;90_105_days;EpiVacCorona;170;71;241;7299088;3167729;10466817
2022.05_01-07-2022;г. Москва;90_105_days;SputnikLite;81294;30762;112056;7299088;3167729;10466817
2022.05_01-07-2022;г. Москва;90_105_days;SputnikV;56126;21414;77540;7299088;3167729;10466817
2022.05_01-07-2022;г. Санкт-Петербург;105_165_days;AllVaccines;549154;203810;752964;3114778;1306302;4421080
2022.05_01-07-2022;г. Санкт-Петербург;105_165_days;CoviVac;3489;284;3773;3114778;1306302;4421080
2022.05_01-07-2022;г. Санкт-Петербург;105_165_days;EpiVacCorona;6161;2714;8875;3114778;1306302;4421080
2022.05_01-07-2022;г. Санкт-Петербург;105_165_days;SputnikLite;204277;101649;305926;3114778;1306302;4421080
2022.05_01-07-2022;г. Санкт-Петербург;105_165_days;SputnikV;335227;99163;434390;3114778;1306302;4421080
2022.05_01-07-2022;г. Санкт-Петербург;165_195_days;AllVaccines;332835;125734;458569;3114778;1306302;4421080
2022.05_01-07-2022;г. Санкт-Петербург;165_195_days;CoviVac;3633;279;3912;3114778;1306302;4421080
2022.05_01-07-2022;г. Санкт-Петербург;165_195_days;EpiVacCorona;2754;1279;4033;3114778;1306302;4421080
2022.05_01-07-2022;г. Санкт-Петербург;165_195_days;SputnikLite;134121;57876;191997;3114778;1306302;4421080
2022.05_01-07-2022;г. Санкт-Петербург;165_195_days;SputnikV;192327;66300;258627;3114778;1306302;4421080
2022.05_01-07-2022;г. Санкт-Петербург;21_45_days;AllVaccines;13992;7651;21643;3114778;1306302;4421080
2022.05_01-07-2022;г. Санкт-Петербург;21_45_days;CoviVac;659;50;709;3114778;1306302;4421080
2022.05_01-07-2022;г. Санкт-Петербург;21_45_days;EpiVacCorona;348;188;536;3114778;1306302;4421080
2022.05_01-07-2022;г. Санкт-Петербург;21_45_days;SputnikLite;4116;1655;5771;3114778;1306302;4421080
2022.05_01-07-2022;г. Санкт-Петербург;21_45_days;SputnikV;8869;5758;14627;3114778;1306302;4421080
2022.05_01-07-2022;г. Санкт-Петербург;45_75_days;AllVaccines;35939;16533;52472;3114778;1306302;4421080
2022.05_01-07-2022;г. Санкт-Петербург;45_75_days;CoviVac;608;45;653;3114778;1306302;4421080
2022.05_01-07-2022;г. Санкт-Петербург;45_75_days;EpiVacCorona;406;275;681;3114778;1306302;4421080
2022.05_01-07-2022;г. Санкт-Петербург;45_75_days;SputnikLite;12035;7273;19308;3114778;1306302;4421080
2022.05_01-07-2022;г. Санкт-Петербург;45_75_days;SputnikV;22890;8940;31830;3114778;1306302;4421080
2022.05_01-07-2022;г. Санкт-Петербург;75_90_days;AllVaccines;45415;15004;60419;3114778;1306302;4421080
2022.05_01-07-2022;г. Санкт-Петербург;75_90_days;CoviVac;644;29;673;3114778;1306302;4421080
2022.05_01-07-2022;г. Санкт-Петербург;75_90_days;EpiVacCorona;652;239;891;3114778;1306302;4421080
2022.05_01-07-2022;г. Санкт-Петербург;75_90_days;SputnikLite;16490;6519;23009;3114778;1306302;4421080
2022.05_01-07-2022;г. Санкт-Петербург;75_90_days;SputnikV;27629;8217;35846;3114778;1306302;4421080
2022.05_01-07-2022;г. Санкт-Петербург;90_105_days;AllVaccines;67073;22408;89481;3114778;1306302;4421080
2022.05_01-07-2022;г. Санкт-Петербург;90_105_days;CoviVac;1294;56;1350;3114778;1306302;4421080
2022.05_01-07-2022;г. Санкт-Петербург;90_105_days;EpiVacCorona;1506;651;2157;3114778;1306302;4421080
2022.05_01-07-2022;г. Санкт-Петербург;90_105_days;SputnikLite;25858;10674;36532;3114778;1306302;4421080
2022.05_01-07-2022;г. Санкт-Петербург;90_105_days;SputnikV;38415;11027;49442;3114778;1306302;4421080
2022.05_01-07-2022;г. Севастополь;105_165_days;AllVaccines;37416;17345;54761;293051;116400;409451
2022.05_01-07-2022;г. Севастополь;105_165_days;CoviVac;229;107;336;293051;116400;409451
2022.05_01-07-2022;г. Севастополь;105_165_days;EpiVacCorona;488;266;754;293051;116400;409451
2022.05_01-07-2022;г. Севастополь;105_165_days;SputnikLite;14999;11278;26277;293051;116400;409451
2022.05_01-07-2022;г. Севастополь;105_165_days;SputnikV;21700;5694;27394;293051;116400;409451
2022.05_01-07-2022;г. Севастополь;165_195_days;AllVaccines;44365;15497;59862;293051;116400;409451
2022.05_01-07-2022;г. Севастополь;165_195_days;CoviVac;501;132;633;293051;116400;409451
2022.05_01-07-2022;г. Севастополь;165_195_days;EpiVacCorona;937;305;1242;293051;116400;409451
2022.05_01-07-2022;г. Севастополь;165_195_days;SputnikLite;9864;8606;18470;293051;116400;409451
2022.05_01-07-2022;г. Севастополь;165_195_days;SputnikV;33063;6454;39517;293051;116400;409451
2022.05_01-07-2022;г. Севастополь;21_45_days;AllVaccines;2531;1660;4191;293051;116400;409451
2022.05_01-07-2022;г. Севастополь;21_45_days;CoviVac;13;9;22;293051;116400;409451
2022.05_01-07-2022;г. Севастополь;21_45_days;EpiVacCorona;16;28;44;293051;116400;409451
2022.05_01-07-2022;г. Севастополь;21_45_days;SputnikLite;1627;1131;2758;293051;116400;409451
2022.05_01-07-2022;г. Севастополь;21_45_days;SputnikV;875;492;1367;293051;116400;409451
2022.05_01-07-2022;г. Севастополь;45_75_days;AllVaccines;2720;1718;4438;293051;116400;409451
2022.05_01-07-2022;г. Севастополь;45_75_days;CoviVac;30;11;41;293051;116400;409451
2022.05_01-07-2022;г. Севастополь;45_75_days;EpiVacCorona;24;42;66;293051;116400;409451
2022.05_01-07-2022;г. Севастополь;45_75_days;SputnikLite;1433;925;2358;293051;116400;409451
2022.05_01-07-2022;г. Севастополь;45_75_days;SputnikV;1233;740;1973;293051;116400;409451
2022.05_01-07-2022;г. Севастополь;75_90_days;AllVaccines;3095;1515;4610;293051;116400;409451
2022.05_01-07-2022;г. Севастополь;75_90_days;CoviVac;39;19;58;293051;116400;409451
2022.05_01-07-2022;г. Севастополь;75_90_days;EpiVacCorona;26;55;81;293051;116400;409451
2022.05_01-07-2022;г. Севастополь;75_90_days;SputnikLite;1224;634;1858;293051;116400;409451
2022.05_01-07-2022;г. Севастополь;75_90_days;SputnikV;1806;807;2613;293051;116400;409451
2022.05_01-07-2022;г. Севастополь;90_105_days;AllVaccines;4095;2185;6280;293051;116400;409451
2022.05_01-07-2022;г. Севастополь;90_105_days;CoviVac;60;23;83;293051;116400;409451
2022.05_01-07-2022;г. Севастополь;90_105_days;EpiVacCorona;68;72;140;293051;116400;409451
2022.05_01-07-2022;г. Севастополь;90_105_days;SputnikLite;2406;1358;3764;293051;116400;409451
2022.05_01-07-2022;г. Севастополь;90_105_days;SputnikV;1561;732;2293;293051;116400;409451
2022.06_18-07-2022;Алтайский край;105_165_days;AllVaccines;108224;59983;168207;1240936;570412;1811348
2022.06_18-07-2022;Алтайский край;105_165_days;CoviVac;856;317;1173;1240936;570412;1811348
2022.06_18-07-2022;Алтайский край;105_165_days;EpiVacCorona;3966;2432;6398;1240936;570412;1811348
2022.06_18-07-2022;Алтайский край;105_165_days;SputnikLite;67202;33217;100419;1240936;570412;1811348
2022.06_18-07-2022;Алтайский край;105_165_days;SputnikV;36200;24017;60217;1240936;570412;1811348
2022.06_18-07-2022;Алтайский край;165_195_days;AllVaccines;101041;62656;163697;1240936;570412;1811348
2022.06_18-07-2022;Алтайский край;165_195_days;CoviVac;1325;240;1565;1240936;570412;1811348
2022.06_18-07-2022;Алтайский край;165_195_days;EpiVacCorona;4945;2055;7000;1240936;570412;1811348
2022.06_18-07-2022;Алтайский край;165_195_days;SputnikLite;26885;22684;49569;1240936;570412;1811348
2022.06_18-07-2022;Алтайский край;165_195_days;SputnikV;67886;37677;105563;1240936;570412;1811348
2022.06_18-07-2022;Алтайский край;21_45_days;AllVaccines;4506;4478;8984;1240936;570412;1811348
2022.06_18-07-2022;Алтайский край;21_45_days;CoviVac;150;116;266;1240936;570412;1811348
2022.06_18-07-2022;Алтайский край;21_45_days;EpiVacCorona;443;405;848;1240936;570412;1811348
2022.06_18-07-2022;Алтайский край;21_45_days;SputnikLite;480;227;707;1240936;570412;1811348
2022.06_18-07-2022;Алтайский край;21_45_days;SputnikV;3433;3730;7163;1240936;570412;1811348
2022.06_18-07-2022;Алтайский край;45_75_days;AllVaccines;8321;6801;15122;1240936;570412;1811348
2022.06_18-07-2022;Алтайский край;45_75_days;CoviVac;587;230;817;1240936;570412;1811348
2022.06_18-07-2022;Алтайский край;45_75_days;EpiVacCorona;993;772;1765;1240936;570412;1811348
2022.06_18-07-2022;Алтайский край;45_75_days;SputnikLite;950;558;1508;1240936;570412;1811348
2022.06_18-07-2022;Алтайский край;45_75_days;SputnikV;5791;5241;11032;1240936;570412;1811348
2022.06_18-07-2022;Алтайский край;75_90_days;AllVaccines;6930;3917;10847;1240936;570412;1811348
2022.06_18-07-2022;Алтайский край;75_90_days;CoviVac;680;261;941;1240936;570412;1811348
2022.06_18-07-2022;Алтайский край;75_90_days;EpiVacCorona;916;520;1436;1240936;570412;1811348
2022.06_18-07-2022;Алтайский край;75_90_days;SputnikLite;631;269;900;1240936;570412;1811348
2022.06_18-07-2022;Алтайский край;75_90_days;SputnikV;4703;2867;7570;1240936;570412;1811348
2022.06_18-07-2022;Алтайский край;90_105_days;AllVaccines;6548;3629;10177;1240936;570412;1811348
2022.06_18-07-2022;Алтайский край;90_105_days;CoviVac;154;59;213;1240936;570412;1811348
2022.06_18-07-2022;Алтайский край;90_105_days;EpiVacCorona;515;292;807;1240936;570412;1811348
2022.06_18-07-2022;Алтайский край;90_105_days;SputnikLite;1586;737;2323;1240936;570412;1811348
2022.06_18-07-2022;Алтайский край;90_105_days;SputnikV;4293;2541;6834;1240936;570412;1811348
2022.06_18-07-2022;Амурская область;105_165_days;AllVaccines;46011;14366;60377;444961;159780;604741
2022.06_18-07-2022;Амурская область;105_165_days;CoviVac;529;105;634;444961;159780;604741
2022.06_18-07-2022;Амурская область;105_165_days;EpiVacCorona;2701;923;3624;444961;159780;604741
2022.06_18-07-2022;Амурская область;105_165_days;SputnikLite;26016;8678;34694;444961;159780;604741
2022.06_18-07-2022;Амурская область;105_165_days;SputnikV;16765;4660;21425;444961;159780;604741
2022.06_18-07-2022;Амурская область;165_195_days;AllVaccines;43991;14657;58648;444961;159780;604741
2022.06_18-07-2022;Амурская область;165_195_days;CoviVac;384;117;501;444961;159780;604741
2022.06_18-07-2022;Амурская область;165_195_days;EpiVacCorona;3429;1243;4672;444961;159780;604741
2022.06_18-07-2022;Амурская область;165_195_days;SputnikLite;9637;5208;14845;444961;159780;604741
2022.06_18-07-2022;Амурская область;165_195_days;SputnikV;30541;8089;38630;444961;159780;604741
2022.06_18-07-2022;Амурская область;21_45_days;AllVaccines;2654;1420;4074;444961;159780;604741
2022.06_18-07-2022;Амурская область;21_45_days;CoviVac;68;5;73;444961;159780;604741
2022.06_18-07-2022;Амурская область;21_45_days;EpiVacCorona;285;151;436;444961;159780;604741
2022.06_18-07-2022;Амурская область;21_45_days;SputnikLite;1093;393;1486;444961;159780;604741
2022.06_18-07-2022;Амурская область;21_45_days;SputnikV;1208;871;2079;444961;159780;604741
2022.06_18-07-2022;Амурская область;45_75_days;AllVaccines;4454;1785;6239;444961;159780;604741
2022.06_18-07-2022;Амурская область;45_75_days;CoviVac;80;9;89;444961;159780;604741
2022.06_18-07-2022;Амурская область;45_75_days;EpiVacCorona;453;194;647;444961;159780;604741
2022.06_18-07-2022;Амурская область;45_75_days;SputnikLite;1918;634;2552;444961;159780;604741
2022.06_18-07-2022;Амурская область;45_75_days;SputnikV;2003;948;2951;444961;159780;604741
2022.06_18-07-2022;Амурская область;75_90_days;AllVaccines;4528;1202;5730;444961;159780;604741
2022.06_18-07-2022;Амурская область;75_90_days;CoviVac;47;10;57;444961;159780;604741
2022.06_18-07-2022;Амурская область;75_90_days;EpiVacCorona;267;137;404;444961;159780;604741
2022.06_18-07-2022;Амурская область;75_90_days;SputnikLite;2627;554;3181;444961;159780;604741
2022.06_18-07-2022;Амурская область;75_90_days;SputnikV;1587;501;2088;444961;159780;604741
2022.06_18-07-2022;Амурская область;90_105_days;AllVaccines;4926;1400;6326;444961;159780;604741
2022.06_18-07-2022;Амурская область;90_105_days;CoviVac;56;6;62;444961;159780;604741
2022.06_18-07-2022;Амурская область;90_105_days;EpiVacCorona;292;137;429;444961;159780;604741
2022.06_18-07-2022;Амурская область;90_105_days;SputnikLite;2538;718;3256;444961;159780;604741
2022.06_18-07-2022;Амурская область;90_105_days;SputnikV;2040;539;2579;444961;159780;604741
2022.06_18-07-2022;Архангельская область;105_165_days;AllVaccines;32569;20073;52642;595439;264499;859938
2022.06_18-07-2022;Архангельская область;105_165_days;CoviVac;422;64;486;595439;264499;859938
2022.06_18-07-2022;Архангельская область;105_165_days;EpiVacCorona;1102;707;1809;595439;264499;859938
2022.06_18-07-2022;Архангельская область;105_165_days;SputnikLite;16666;11395;28061;595439;264499;859938
2022.06_18-07-2022;Архангельская область;105_165_days;SputnikV;14379;7907;22286;595439;264499;859938
2022.06_18-07-2022;Архангельская область;165_195_days;AllVaccines;46124;32013;78137;595439;264499;859938
2022.06_18-07-2022;Архангельская область;165_195_days;CoviVac;767;94;861;595439;264499;859938
2022.06_18-07-2022;Архангельская область;165_195_days;EpiVacCorona;2587;1374;3961;595439;264499;859938
2022.06_18-07-2022;Архангельская область;165_195_days;SputnikLite;13968;12782;26750;595439;264499;859938
2022.06_18-07-2022;Архангельская область;165_195_days;SputnikV;28802;17763;46565;595439;264499;859938
2022.06_18-07-2022;Архангельская область;21_45_days;AllVaccines;3104;2491;5595;595439;264499;859938
2022.06_18-07-2022;Архангельская область;21_45_days;CoviVac;185;117;302;595439;264499;859938
2022.06_18-07-2022;Архангельская область;21_45_days;EpiVacCorona;122;128;250;595439;264499;859938
2022.06_18-07-2022;Архангельская область;21_45_days;SputnikLite;645;216;861;595439;264499;859938
2022.06_18-07-2022;Архангельская область;21_45_days;SputnikV;2152;2030;4182;595439;264499;859938
2022.06_18-07-2022;Архангельская область;45_75_days;AllVaccines;5454;4551;10005;595439;264499;859938
2022.06_18-07-2022;Архангельская область;45_75_days;CoviVac;223;138;361;595439;264499;859938
2022.06_18-07-2022;Архангельская область;45_75_days;EpiVacCorona;340;316;656;595439;264499;859938
2022.06_18-07-2022;Архангельская область;45_75_days;SputnikLite;997;788;1785;595439;264499;859938
2022.06_18-07-2022;Архангельская область;45_75_days;SputnikV;3894;3309;7203;595439;264499;859938
2022.06_18-07-2022;Архангельская область;75_90_days;AllVaccines;3740;2742;6482;595439;264499;859938
2022.06_18-07-2022;Архангельская область;75_90_days;CoviVac;82;24;106;595439;264499;859938
2022.06_18-07-2022;Архангельская область;75_90_days;EpiVacCorona;270;279;549;595439;264499;859938
2022.06_18-07-2022;Архангельская область;75_90_days;SputnikLite;467;360;827;595439;264499;859938
2022.06_18-07-2022;Архангельская область;75_90_days;SputnikV;2921;2079;5000;595439;264499;859938
2022.06_18-07-2022;Архангельская область;90_105_days;AllVaccines;4321;2592;6913;595439;264499;859938
2022.06_18-07-2022;Архангельская область;90_105_days;CoviVac;89;14;103;595439;264499;859938
2022.06_18-07-2022;Архангельская область;90_105_days;EpiVacCorona;281;317;598;595439;264499;859938
2022.06_18-07-2022;Архангельская область;90_105_days;SputnikLite;607;398;1005;595439;264499;859938
2022.06_18-07-2022;Архангельская область;90_105_days;SputnikV;3344;1863;5207;595439;264499;859938
2022.06_18-07-2022;Астраханская область;105_165_days;AllVaccines;42141;15892;58033;550968;219749;770717
2022.06_18-07-2022;Астраханская область;105_165_days;CoviVac;481;221;702;550968;219749;770717
2022.06_18-07-2022;Астраханская область;105_165_days;EpiVacCorona;841;302;1143;550968;219749;770717
2022.06_18-07-2022;Астраханская область;105_165_days;SputnikLite;24343;8889;33232;550968;219749;770717
2022.06_18-07-2022;Астраханская область;105_165_days;SputnikV;16476;6480;22956;550968;219749;770717
2022.06_18-07-2022;Астраханская область;165_195_days;AllVaccines;43481;15439;58920;550968;219749;770717
2022.06_18-07-2022;Астраханская область;165_195_days;CoviVac;697;228;925;550968;219749;770717
2022.06_18-07-2022;Астраханская область;165_195_days;EpiVacCorona;2646;939;3585;550968;219749;770717
2022.06_18-07-2022;Астраханская область;165_195_days;SputnikLite;12641;5873;18514;550968;219749;770717
2022.06_18-07-2022;Астраханская область;165_195_days;SputnikV;27497;8399;35896;550968;219749;770717
2022.06_18-07-2022;Астраханская область;21_45_days;AllVaccines;2662;1706;4368;550968;219749;770717
2022.06_18-07-2022;Астраханская область;21_45_days;CoviVac;42;3;45;550968;219749;770717
2022.06_18-07-2022;Астраханская область;21_45_days;EpiVacCorona;162;86;248;550968;219749;770717
2022.06_18-07-2022;Астраханская область;21_45_days;SputnikLite;576;390;966;550968;219749;770717
2022.06_18-07-2022;Астраханская область;21_45_days;SputnikV;1882;1227;3109;550968;219749;770717
2022.06_18-07-2022;Астраханская область;45_75_days;AllVaccines;5452;2907;8359;550968;219749;770717
2022.06_18-07-2022;Астраханская область;45_75_days;CoviVac;69;16;85;550968;219749;770717
2022.06_18-07-2022;Астраханская область;45_75_days;EpiVacCorona;158;248;406;550968;219749;770717
2022.06_18-07-2022;Астраханская область;45_75_days;SputnikLite;3318;1435;4753;550968;219749;770717
2022.06_18-07-2022;Астраханская область;45_75_days;SputnikV;1907;1208;3115;550968;219749;770717
2022.06_18-07-2022;Астраханская область;75_90_days;AllVaccines;4175;1643;5818;550968;219749;770717
2022.06_18-07-2022;Астраханская область;75_90_days;CoviVac;67;10;77;550968;219749;770717
2022.06_18-07-2022;Астраханская область;75_90_days;EpiVacCorona;72;25;97;550968;219749;770717
2022.06_18-07-2022;Астраханская область;75_90_days;SputnikLite;2155;894;3049;550968;219749;770717
2022.06_18-07-2022;Астраханская область;75_90_days;SputnikV;1881;714;2595;550968;219749;770717
2022.06_18-07-2022;Астраханская область;90_105_days;AllVaccines;6001;2171;8172;550968;219749;770717
2022.06_18-07-2022;Астраханская область;90_105_days;CoviVac;50;18;68;550968;219749;770717
2022.06_18-07-2022;Астраханская область;90_105_days;EpiVacCorona;145;33;178;550968;219749;770717
2022.06_18-07-2022;Астраханская область;90_105_days;SputnikLite;2648;1029;3677;550968;219749;770717
2022.06_18-07-2022;Астраханская область;90_105_days;SputnikV;3158;1091;4249;550968;219749;770717
2022.06_18-07-2022;Белгородская область;105_165_days;AllVaccines;90864;35485;126349;867731;383871;1251602
2022.06_18-07-2022;Белгородская область;105_165_days;CoviVac;581;202;783;867731;383871;1251602
2022.06_18-07-2022;Белгородская область;105_165_days;EpiVacCorona;853;409;1262;867731;383871;1251602
2022.06_18-07-2022;Белгородская область;105_165_days;SputnikLite;67694;27151;94845;867731;383871;1251602
2022.06_18-07-2022;Белгородская область;105_165_days;SputnikV;21736;7723;29459;867731;383871;1251602
2022.06_18-07-2022;Белгородская область;165_195_days;AllVaccines;95890;40434;136324;867731;383871;1251602
2022.06_18-07-2022;Белгородская область;165_195_days;CoviVac;592;209;801;867731;383871;1251602
2022.06_18-07-2022;Белгородская область;165_195_days;EpiVacCorona;862;388;1250;867731;383871;1251602
2022.06_18-07-2022;Белгородская область;165_195_days;SputnikLite;36534;20470;57004;867731;383871;1251602
2022.06_18-07-2022;Белгородская область;165_195_days;SputnikV;57902;19367;77269;867731;383871;1251602
2022.06_18-07-2022;Белгородская область;21_45_days;AllVaccines;3203;2665;5868;867731;383871;1251602
2022.06_18-07-2022;Белгородская область;21_45_days;CoviVac;16;4;20;867731;383871;1251602
2022.06_18-07-2022;Белгородская область;21_45_days;EpiVacCorona;134;121;255;867731;383871;1251602
2022.06_18-07-2022;Белгородская область;21_45_days;SputnikLite;172;87;259;867731;383871;1251602
2022.06_18-07-2022;Белгородская область;21_45_days;SputnikV;2881;2453;5334;867731;383871;1251602
2022.06_18-07-2022;Белгородская область;45_75_days;AllVaccines;5197;3738;8935;867731;383871;1251602
2022.06_18-07-2022;Белгородская область;45_75_days;CoviVac;120;104;224;867731;383871;1251602
2022.06_18-07-2022;Белгородская область;45_75_days;EpiVacCorona;359;286;645;867731;383871;1251602
2022.06_18-07-2022;Белгородская область;45_75_days;SputnikLite;837;423;1260;867731;383871;1251602
2022.06_18-07-2022;Белгородская область;45_75_days;SputnikV;3881;2925;6806;867731;383871;1251602
2022.06_18-07-2022;Белгородская область;75_90_days;AllVaccines;3715;1749;5464;867731;383871;1251602
2022.06_18-07-2022;Белгородская область;75_90_days;CoviVac;107;24;131;867731;383871;1251602
2022.06_18-07-2022;Белгородская область;75_90_days;EpiVacCorona;250;110;360;867731;383871;1251602
2022.06_18-07-2022;Белгородская область;75_90_days;SputnikLite;1348;619;1967;867731;383871;1251602
2022.06_18-07-2022;Белгородская область;75_90_days;SputnikV;2010;996;3006;867731;383871;1251602
2022.06_18-07-2022;Белгородская область;90_105_days;AllVaccines;5097;2366;7463;867731;383871;1251602
2022.06_18-07-2022;Белгородская область;90_105_days;CoviVac;106;44;150;867731;383871;1251602
2022.06_18-07-2022;Белгородская область;90_105_days;EpiVacCorona;132;93;225;867731;383871;1251602
2022.06_18-07-2022;Белгородская область;90_105_days;SputnikLite;2999;1511;4510;867731;383871;1251602
2022.06_18-07-2022;Белгородская область;90_105_days;SputnikV;1860;718;2578;867731;383871;1251602
2022.06_18-07-2022;Брянская область;105_165_days;AllVaccines;44299;25351;69650;659625;298625;958250
2022.06_18-07-2022;Брянская область;105_165_days;CoviVac;665;200;865;659625;298625;958250
2022.06_18-07-2022;Брянская область;105_165_days;EpiVacCorona;1243;633;1876;659625;298625;958250
2022.06_18-07-2022;Брянская область;105_165_days;SputnikLite;28373;16519;44892;659625;298625;958250
2022.06_18-07-2022;Брянская область;105_165_days;SputnikV;14018;7999;22017;659625;298625;958250
2022.06_18-07-2022;Брянская область;165_195_days;AllVaccines;48388;29136;77524;659625;298625;958250
2022.06_18-07-2022;Брянская область;165_195_days;CoviVac;1071;285;1356;659625;298625;958250
2022.06_18-07-2022;Брянская область;165_195_days;EpiVacCorona;3894;1970;5864;659625;298625;958250
2022.06_18-07-2022;Брянская область;165_195_days;SputnikLite;12006;10450;22456;659625;298625;958250
2022.06_18-07-2022;Брянская область;165_195_days;SputnikV;31417;16431;47848;659625;298625;958250
2022.06_18-07-2022;Брянская область;21_45_days;AllVaccines;1991;2184;4175;659625;298625;958250
2022.06_18-07-2022;Брянская область;21_45_days;CoviVac;74;18;92;659625;298625;958250
2022.06_18-07-2022;Брянская область;21_45_days;EpiVacCorona;109;77;186;659625;298625;958250
2022.06_18-07-2022;Брянская область;21_45_days;SputnikLite;926;1054;1980;659625;298625;958250
2022.06_18-07-2022;Брянская область;21_45_days;SputnikV;882;1035;1917;659625;298625;958250
2022.06_18-07-2022;Брянская область;45_75_days;AllVaccines;2990;2409;5399;659625;298625;958250
2022.06_18-07-2022;Брянская область;45_75_days;CoviVac;191;122;313;659625;298625;958250
2022.06_18-07-2022;Брянская область;45_75_days;EpiVacCorona;131;52;183;659625;298625;958250
2022.06_18-07-2022;Брянская область;45_75_days;SputnikLite;1054;972;2026;659625;298625;958250
2022.06_18-07-2022;Брянская область;45_75_days;SputnikV;1614;1263;2877;659625;298625;958250
2022.06_18-07-2022;Брянская область;75_90_days;AllVaccines;2269;1420;3689;659625;298625;958250
2022.06_18-07-2022;Брянская область;75_90_days;CoviVac;55;19;74;659625;298625;958250
2022.06_18-07-2022;Брянская область;75_90_days;EpiVacCorona;75;46;121;659625;298625;958250
2022.06_18-07-2022;Брянская область;75_90_days;SputnikLite;777;536;1313;659625;298625;958250
2022.06_18-07-2022;Брянская область;75_90_days;SputnikV;1362;819;2181;659625;298625;958250
2022.06_18-07-2022;Брянская область;90_105_days;AllVaccines;3305;1825;5130;659625;298625;958250
2022.06_18-07-2022;Брянская область;90_105_days;CoviVac;73;19;92;659625;298625;958250
2022.06_18-07-2022;Брянская область;90_105_days;EpiVacCorona;97;51;148;659625;298625;958250
2022.06_18-07-2022;Брянская область;90_105_days;SputnikLite;1100;734;1834;659625;298625;958250
2022.06_18-07-2022;Брянская область;90_105_days;SputnikV;2035;1021;3056;659625;298625;958250
2022.06_18-07-2022;Владимирская область;105_165_days;AllVaccines;33625;20929;54554;739166;354521;1093687
2022.06_18-07-2022;Владимирская область;105_165_days;CoviVac;361;139;500;739166;354521;1093687
2022.06_18-07-2022;Владимирская область;105_165_days;EpiVacCorona;1333;941;2274;739166;354521;1093687
2022.06_18-07-2022;Владимирская область;105_165_days;SputnikLite;19298;12967;32265;739166;354521;1093687
2022.06_18-07-2022;Владимирская область;105_165_days;SputnikV;12633;6882;19515;739166;354521;1093687
2022.06_18-07-2022;Владимирская область;165_195_days;AllVaccines;59214;29746;88960;739166;354521;1093687
2022.06_18-07-2022;Владимирская область;165_195_days;CoviVac;737;202;939;739166;354521;1093687
2022.06_18-07-2022;Владимирская область;165_195_days;EpiVacCorona;3988;2355;6343;739166;354521;1093687
2022.06_18-07-2022;Владимирская область;165_195_days;SputnikLite;15150;11084;26234;739166;354521;1093687
2022.06_18-07-2022;Владимирская область;165_195_days;SputnikV;39339;16105;55444;739166;354521;1093687
2022.06_18-07-2022;Владимирская область;21_45_days;AllVaccines;1395;1613;3008;739166;354521;1093687
2022.06_18-07-2022;Владимирская область;21_45_days;CoviVac;87;54;141;739166;354521;1093687
2022.06_18-07-2022;Владимирская область;21_45_days;EpiVacCorona;79;122;201;739166;354521;1093687
2022.06_18-07-2022;Владимирская область;21_45_days;SputnikLite;197;155;352;739166;354521;1093687
2022.06_18-07-2022;Владимирская область;21_45_days;SputnikV;1032;1282;2314;739166;354521;1093687
2022.06_18-07-2022;Владимирская область;45_75_days;AllVaccines;2536;2412;4948;739166;354521;1093687
2022.06_18-07-2022;Владимирская область;45_75_days;CoviVac;173;55;228;739166;354521;1093687
2022.06_18-07-2022;Владимирская область;45_75_days;EpiVacCorona;148;137;285;739166;354521;1093687
2022.06_18-07-2022;Владимирская область;45_75_days;SputnikLite;380;428;808;739166;354521;1093687
2022.06_18-07-2022;Владимирская область;45_75_days;SputnikV;1835;1792;3627;739166;354521;1093687
2022.06_18-07-2022;Владимирская область;75_90_days;AllVaccines;2119;1413;3532;739166;354521;1093687
2022.06_18-07-2022;Владимирская область;75_90_days;CoviVac;89;44;133;739166;354521;1093687
2022.06_18-07-2022;Владимирская область;75_90_days;EpiVacCorona;106;81;187;739166;354521;1093687
2022.06_18-07-2022;Владимирская область;75_90_days;SputnikLite;518;375;893;739166;354521;1093687
2022.06_18-07-2022;Владимирская область;75_90_days;SputnikV;1406;913;2319;739166;354521;1093687
2022.06_18-07-2022;Владимирская область;90_105_days;AllVaccines;2526;1420;3946;739166;354521;1093687
2022.06_18-07-2022;Владимирская область;90_105_days;CoviVac;46;29;75;739166;354521;1093687
2022.06_18-07-2022;Владимирская область;90_105_days;EpiVacCorona;143;106;249;739166;354521;1093687
2022.06_18-07-2022;Владимирская область;90_105_days;SputnikLite;599;471;1070;739166;354521;1093687
2022.06_18-07-2022;Владимирская область;90_105_days;SputnikV;1738;814;2552;739166;354521;1093687
2022.06_18-07-2022;Волгоградская область;105_165_days;AllVaccines;111160;56811;167971;1387837;615020;2002857
2022.06_18-07-2022;Волгоградская область;105_165_days;CoviVac;1266;380;1646;1387837;615020;2002857
2022.06_18-07-2022;Волгоградская область;105_165_days;EpiVacCorona;3576;3260;6836;1387837;615020;2002857
2022.06_18-07-2022;Волгоградская область;105_165_days;SputnikLite;70011;31907;101918;1387837;615020;2002857
2022.06_18-07-2022;Волгоградская область;105_165_days;SputnikV;36307;21264;57571;1387837;615020;2002857
2022.06_18-07-2022;Волгоградская область;165_195_days;AllVaccines;121479;69901;191380;1387837;615020;2002857
2022.06_18-07-2022;Волгоградская область;165_195_days;CoviVac;833;261;1094;1387837;615020;2002857
2022.06_18-07-2022;Волгоградская область;165_195_days;EpiVacCorona;2833;1503;4336;1387837;615020;2002857
2022.06_18-07-2022;Волгоградская область;165_195_days;SputnikLite;39345;26800;66145;1387837;615020;2002857
2022.06_18-07-2022;Волгоградская область;165_195_days;SputnikV;78468;41337;119805;1387837;615020;2002857
2022.06_18-07-2022;Волгоградская область;21_45_days;AllVaccines;6240;5215;11455;1387837;615020;2002857
2022.06_18-07-2022;Волгоградская область;21_45_days;CoviVac;322;95;417;1387837;615020;2002857
2022.06_18-07-2022;Волгоградская область;21_45_days;EpiVacCorona;941;490;1431;1387837;615020;2002857
2022.06_18-07-2022;Волгоградская область;21_45_days;SputnikLite;1134;824;1958;1387837;615020;2002857
2022.06_18-07-2022;Волгоградская область;21_45_days;SputnikV;3843;3806;7649;1387837;615020;2002857
2022.06_18-07-2022;Волгоградская область;45_75_days;AllVaccines;11701;8592;20293;1387837;615020;2002857
2022.06_18-07-2022;Волгоградская область;45_75_days;CoviVac;1238;606;1844;1387837;615020;2002857
2022.06_18-07-2022;Волгоградская область;45_75_days;EpiVacCorona;1203;705;1908;1387837;615020;2002857
2022.06_18-07-2022;Волгоградская область;45_75_days;SputnikLite;2048;1533;3581;1387837;615020;2002857
2022.06_18-07-2022;Волгоградская область;45_75_days;SputnikV;7212;5748;12960;1387837;615020;2002857
2022.06_18-07-2022;Волгоградская область;75_90_days;AllVaccines;7778;4749;12527;1387837;615020;2002857
2022.06_18-07-2022;Волгоградская область;75_90_days;CoviVac;392;111;503;1387837;615020;2002857
2022.06_18-07-2022;Волгоградская область;75_90_days;EpiVacCorona;615;318;933;1387837;615020;2002857
2022.06_18-07-2022;Волгоградская область;75_90_days;SputnikLite;1859;1038;2897;1387837;615020;2002857
2022.06_18-07-2022;Волгоградская область;75_90_days;SputnikV;4912;3282;8194;1387837;615020;2002857
2022.06_18-07-2022;Волгоградская область;90_105_days;AllVaccines;9818;4727;14545;1387837;615020;2002857
2022.06_18-07-2022;Волгоградская область;90_105_days;CoviVac;168;53;221;1387837;615020;2002857
2022.06_18-07-2022;Волгоградская область;90_105_days;EpiVacCorona;778;342;1120;1387837;615020;2002857
2022.06_18-07-2022;Волгоградская область;90_105_days;SputnikLite;3916;1762;5678;1387837;615020;2002857
2022.06_18-07-2022;Волгоградская область;90_105_days;SputnikV;4956;2570;7526;1387837;615020;2002857
2022.06_18-07-2022;Вологодская область;105_165_days;AllVaccines;38986;19881;58867;628100;275171;903271
2022.06_18-07-2022;Вологодская область;105_165_days;CoviVac;977;255;1232;628100;275171;903271
2022.06_18-07-2022;Вологодская область;105_165_days;EpiVacCorona;1583;820;2403;628100;275171;903271
2022.06_18-07-2022;Вологодская область;105_165_days;SputnikLite;16180;9575;25755;628100;275171;903271
2022.06_18-07-2022;Вологодская область;105_165_days;SputnikV;20246;9231;29477;628100;275171;903271
2022.06_18-07-2022;Вологодская область;165_195_days;AllVaccines;68886;32031;100917;628100;275171;903271
2022.06_18-07-2022;Вологодская область;165_195_days;CoviVac;1752;284;2036;628100;275171;903271
2022.06_18-07-2022;Вологодская область;165_195_days;EpiVacCorona;3006;1061;4067;628100;275171;903271
2022.06_18-07-2022;Вологодская область;165_195_days;SputnikLite;13777;11348;25125;628100;275171;903271
2022.06_18-07-2022;Вологодская область;165_195_days;SputnikV;50351;19338;69689;628100;275171;903271
2022.06_18-07-2022;Вологодская область;21_45_days;AllVaccines;1961;1771;3732;628100;275171;903271
2022.06_18-07-2022;Вологодская область;21_45_days;CoviVac;63;16;79;628100;275171;903271
2022.06_18-07-2022;Вологодская область;21_45_days;EpiVacCorona;84;20;104;628100;275171;903271
2022.06_18-07-2022;Вологодская область;21_45_days;SputnikLite;58;30;88;628100;275171;903271
2022.06_18-07-2022;Вологодская область;21_45_days;SputnikV;1756;1705;3461;628100;275171;903271
2022.06_18-07-2022;Вологодская область;45_75_days;AllVaccines;3746;2970;6716;628100;275171;903271
2022.06_18-07-2022;Вологодская область;45_75_days;CoviVac;138;25;163;628100;275171;903271
2022.06_18-07-2022;Вологодская область;45_75_days;EpiVacCorona;151;105;256;628100;275171;903271
2022.06_18-07-2022;Вологодская область;45_75_days;SputnikLite;462;346;808;628100;275171;903271
2022.06_18-07-2022;Вологодская область;45_75_days;SputnikV;2995;2494;5489;628100;275171;903271
2022.06_18-07-2022;Вологодская область;75_90_days;AllVaccines;2610;1648;4258;628100;275171;903271
2022.06_18-07-2022;Вологодская область;75_90_days;CoviVac;27;8;35;628100;275171;903271
2022.06_18-07-2022;Вологодская область;75_90_days;EpiVacCorona;106;56;162;628100;275171;903271
2022.06_18-07-2022;Вологодская область;75_90_days;SputnikLite;600;232;832;628100;275171;903271
2022.06_18-07-2022;Вологодская область;75_90_days;SputnikV;1877;1352;3229;628100;275171;903271
2022.06_18-07-2022;Вологодская область;90_105_days;AllVaccines;3981;2160;6141;628100;275171;903271
2022.06_18-07-2022;Вологодская область;90_105_days;CoviVac;84;10;94;628100;275171;903271
2022.06_18-07-2022;Вологодская область;90_105_days;EpiVacCorona;119;74;193;628100;275171;903271
2022.06_18-07-2022;Вологодская область;90_105_days;SputnikLite;844;298;1142;628100;275171;903271
2022.06_18-07-2022;Вологодская область;90_105_days;SputnikV;2934;1778;4712;628100;275171;903271
2022.06_18-07-2022;Воронежская область;105_165_days;AllVaccines;81964;44362;126326;1293123;602333;1895456
2022.06_18-07-2022;Воронежская область;105_165_days;CoviVac;972;333;1305;1293123;602333;1895456
2022.06_18-07-2022;Воронежская область;105_165_days;EpiVacCorona;2404;1424;3828;1293123;602333;1895456
2022.06_18-07-2022;Воронежская область;105_165_days;SputnikLite;51521;26787;78308;1293123;602333;1895456
2022.06_18-07-2022;Воронежская область;105_165_days;SputnikV;27067;15818;42885;1293123;602333;1895456
2022.06_18-07-2022;Воронежская область;165_195_days;AllVaccines;107037;52387;159424;1293123;602333;1895456
2022.06_18-07-2022;Воронежская область;165_195_days;CoviVac;650;198;848;1293123;602333;1895456
2022.06_18-07-2022;Воронежская область;165_195_days;EpiVacCorona;4976;2873;7849;1293123;602333;1895456
2022.06_18-07-2022;Воронежская область;165_195_days;SputnikLite;25652;20768;46420;1293123;602333;1895456
2022.06_18-07-2022;Воронежская область;165_195_days;SputnikV;75759;28548;104307;1293123;602333;1895456
2022.06_18-07-2022;Воронежская область;21_45_days;AllVaccines;6908;5169;12077;1293123;602333;1895456
2022.06_18-07-2022;Воронежская область;21_45_days;CoviVac;105;36;141;1293123;602333;1895456
2022.06_18-07-2022;Воронежская область;21_45_days;EpiVacCorona;400;348;748;1293123;602333;1895456
2022.06_18-07-2022;Воронежская область;21_45_days;SputnikLite;1573;1320;2893;1293123;602333;1895456
2022.06_18-07-2022;Воронежская область;21_45_days;SputnikV;4830;3465;8295;1293123;602333;1895456
2022.06_18-07-2022;Воронежская область;45_75_days;AllVaccines;11352;8872;20224;1293123;602333;1895456
2022.06_18-07-2022;Воронежская область;45_75_days;CoviVac;629;214;843;1293123;602333;1895456
2022.06_18-07-2022;Воронежская область;45_75_days;EpiVacCorona;1460;1681;3141;1293123;602333;1895456
2022.06_18-07-2022;Воронежская область;45_75_days;SputnikLite;1776;1315;3091;1293123;602333;1895456
2022.06_18-07-2022;Воронежская область;45_75_days;SputnikV;7487;5662;13149;1293123;602333;1895456
2022.06_18-07-2022;Воронежская область;75_90_days;AllVaccines;6264;6387;12651;1293123;602333;1895456
2022.06_18-07-2022;Воронежская область;75_90_days;CoviVac;210;134;344;1293123;602333;1895456
2022.06_18-07-2022;Воронежская область;75_90_days;EpiVacCorona;616;594;1210;1293123;602333;1895456
2022.06_18-07-2022;Воронежская область;75_90_days;SputnikLite;1416;1031;2447;1293123;602333;1895456
2022.06_18-07-2022;Воронежская область;75_90_days;SputnikV;4022;4628;8650;1293123;602333;1895456
2022.06_18-07-2022;Воронежская область;90_105_days;AllVaccines;7646;3673;11319;1293123;602333;1895456
2022.06_18-07-2022;Воронежская область;90_105_days;CoviVac;172;93;265;1293123;602333;1895456
2022.06_18-07-2022;Воронежская область;90_105_days;EpiVacCorona;556;307;863;1293123;602333;1895456
2022.06_18-07-2022;Воронежская область;90_105_days;SputnikLite;2259;1554;3813;1293123;602333;1895456
2022.06_18-07-2022;Воронежская область;90_105_days;SputnikV;4659;1719;6378;1293123;602333;1895456
2022.06_18-07-2022;Еврейская автономная область;105_165_days;AllVaccines;9499;3404;12903;88207;31969;120176
2022.06_18-07-2022;Еврейская автономная область;105_165_days;CoviVac;648;115;763;88207;31969;120176
2022.06_18-07-2022;Еврейская автономная область;105_165_days;EpiVacCorona;1408;506;1914;88207;31969;120176
2022.06_18-07-2022;Еврейская автономная область;105_165_days;SputnikLite;4926;2080;7006;88207;31969;120176
2022.06_18-07-2022;Еврейская автономная область;105_165_days;SputnikV;2517;703;3220;88207;31969;120176
2022.06_18-07-2022;Еврейская автономная область;165_195_days;AllVaccines;12376;3517;15893;88207;31969;120176
2022.06_18-07-2022;Еврейская автономная область;165_195_days;CoviVac;298;54;352;88207;31969;120176
2022.06_18-07-2022;Еврейская автономная область;165_195_days;EpiVacCorona;707;159;866;88207;31969;120176
2022.06_18-07-2022;Еврейская автономная область;165_195_days;SputnikLite;2324;1219;3543;88207;31969;120176
2022.06_18-07-2022;Еврейская автономная область;165_195_days;SputnikV;9047;2085;11132;88207;31969;120176
2022.06_18-07-2022;Еврейская автономная область;21_45_days;AllVaccines;426;213;639;88207;31969;120176
2022.06_18-07-2022;Еврейская автономная область;21_45_days;CoviVac;20;2;22;88207;31969;120176
2022.06_18-07-2022;Еврейская автономная область;21_45_days;EpiVacCorona;91;31;122;88207;31969;120176
2022.06_18-07-2022;Еврейская автономная область;21_45_days;SputnikV;315;180;495;88207;31969;120176
2022.06_18-07-2022;Еврейская автономная область;45_75_days;AllVaccines;738;337;1075;88207;31969;120176
2022.06_18-07-2022;Еврейская автономная область;45_75_days;CoviVac;179;86;265;88207;31969;120176
2022.06_18-07-2022;Еврейская автономная область;45_75_days;EpiVacCorona;139;51;190;88207;31969;120176
2022.06_18-07-2022;Еврейская автономная область;45_75_days;SputnikLite;1;0;1;88207;31969;120176
2022.06_18-07-2022;Еврейская автономная область;45_75_days;SputnikV;419;200;619;88207;31969;120176
2022.06_18-07-2022;Еврейская автономная область;75_90_days;AllVaccines;436;143;579;88207;31969;120176
2022.06_18-07-2022;Еврейская автономная область;75_90_days;CoviVac;19;2;21;88207;31969;120176
2022.06_18-07-2022;Еврейская автономная область;75_90_days;EpiVacCorona;201;69;270;88207;31969;120176
2022.06_18-07-2022;Еврейская автономная область;75_90_days;SputnikLite;23;8;31;88207;31969;120176
2022.06_18-07-2022;Еврейская автономная область;75_90_days;SputnikV;193;64;257;88207;31969;120176
2022.06_18-07-2022;Еврейская автономная область;90_105_days;AllVaccines;399;125;524;88207;31969;120176
2022.06_18-07-2022;Еврейская автономная область;90_105_days;CoviVac;15;1;16;88207;31969;120176
2022.06_18-07-2022;Еврейская автономная область;90_105_days;EpiVacCorona;100;26;126;88207;31969;120176
2022.06_18-07-2022;Еврейская автономная область;90_105_days;SputnikLite;110;53;163;88207;31969;120176
2022.06_18-07-2022;Еврейская автономная область;90_105_days;SputnikV;174;45;219;88207;31969;120176
2022.06_18-07-2022;Забайкальский край;105_165_days;AllVaccines;57939;17528;75467;596322;191826;788148
2022.06_18-07-2022;Забайкальский край;105_165_days;CoviVac;1176;177;1353;596322;191826;788148
2022.06_18-07-2022;Забайкальский край;105_165_days;EpiVacCorona;5709;1859;7568;596322;191826;788148
2022.06_18-07-2022;Забайкальский край;105_165_days;SputnikLite;24377;6507;30884;596322;191826;788148
2022.06_18-07-2022;Забайкальский край;105_165_days;SputnikV;26677;8985;35662;596322;191826;788148
2022.06_18-07-2022;Забайкальский край;165_195_days;AllVaccines;61183;23243;84426;596322;191826;788148
2022.06_18-07-2022;Забайкальский край;165_195_days;CoviVac;536;41;577;596322;191826;788148
2022.06_18-07-2022;Забайкальский край;165_195_days;EpiVacCorona;4381;1452;5833;596322;191826;788148
2022.06_18-07-2022;Забайкальский край;165_195_days;SputnikLite;18181;8130;26311;596322;191826;788148
2022.06_18-07-2022;Забайкальский край;165_195_days;SputnikV;38085;13620;51705;596322;191826;788148
2022.06_18-07-2022;Забайкальский край;21_45_days;AllVaccines;5824;3168;8992;596322;191826;788148
2022.06_18-07-2022;Забайкальский край;21_45_days;CoviVac;1246;432;1678;596322;191826;788148
2022.06_18-07-2022;Забайкальский край;21_45_days;EpiVacCorona;837;478;1315;596322;191826;788148
2022.06_18-07-2022;Забайкальский край;21_45_days;SputnikLite;360;108;468;596322;191826;788148
2022.06_18-07-2022;Забайкальский край;21_45_days;SputnikV;3381;2150;5531;596322;191826;788148
2022.06_18-07-2022;Забайкальский край;45_75_days;AllVaccines;9164;4022;13186;596322;191826;788148
2022.06_18-07-2022;Забайкальский край;45_75_days;CoviVac;1050;203;1253;596322;191826;788148
2022.06_18-07-2022;Забайкальский край;45_75_days;EpiVacCorona;1185;488;1673;596322;191826;788148
2022.06_18-07-2022;Забайкальский край;45_75_days;SputnikLite;796;291;1087;596322;191826;788148
2022.06_18-07-2022;Забайкальский край;45_75_days;SputnikV;6133;3040;9173;596322;191826;788148
2022.06_18-07-2022;Забайкальский край;75_90_days;AllVaccines;6676;2178;8854;596322;191826;788148
2022.06_18-07-2022;Забайкальский край;75_90_days;CoviVac;322;38;360;596322;191826;788148
2022.06_18-07-2022;Забайкальский край;75_90_days;EpiVacCorona;1045;277;1322;596322;191826;788148
2022.06_18-07-2022;Забайкальский край;75_90_days;SputnikLite;676;142;818;596322;191826;788148
2022.06_18-07-2022;Забайкальский край;75_90_days;SputnikV;4633;1721;6354;596322;191826;788148
2022.06_18-07-2022;Забайкальский край;90_105_days;AllVaccines;9137;2767;11904;596322;191826;788148
2022.06_18-07-2022;Забайкальский край;90_105_days;CoviVac;360;52;412;596322;191826;788148
2022.06_18-07-2022;Забайкальский край;90_105_days;EpiVacCorona;1280;322;1602;596322;191826;788148
2022.06_18-07-2022;Забайкальский край;90_105_days;SputnikLite;877;169;1046;596322;191826;788148
2022.06_18-07-2022;Забайкальский край;90_105_days;SputnikV;6620;2224;8844;596322;191826;788148
2022.06_18-07-2022;Ивановская область;105_165_days;AllVaccines;27791;14524;42315;549803;255947;805750
2022.06_18-07-2022;Ивановская область;105_165_days;CoviVac;388;60;448;549803;255947;805750
2022.06_18-07-2022;Ивановская область;105_165_days;EpiVacCorona;1009;489;1498;549803;255947;805750
2022.06_18-07-2022;Ивановская область;105_165_days;SputnikLite;17773;8779;26552;549803;255947;805750
2022.06_18-07-2022;Ивановская область;105_165_days;SputnikV;8621;5196;13817;549803;255947;805750
2022.06_18-07-2022;Ивановская область;165_195_days;AllVaccines;20964;16557;37521;549803;255947;805750
2022.06_18-07-2022;Ивановская область;165_195_days;CoviVac;387;65;452;549803;255947;805750
2022.06_18-07-2022;Ивановская область;165_195_days;EpiVacCorona;1173;1053;2226;549803;255947;805750
2022.06_18-07-2022;Ивановская область;165_195_days;SputnikLite;7400;6754;14154;549803;255947;805750
2022.06_18-07-2022;Ивановская область;165_195_days;SputnikV;12004;8685;20689;549803;255947;805750
2022.06_18-07-2022;Ивановская область;21_45_days;AllVaccines;1485;1706;3191;549803;255947;805750
2022.06_18-07-2022;Ивановская область;21_45_days;CoviVac;41;11;52;549803;255947;805750
2022.06_18-07-2022;Ивановская область;21_45_days;EpiVacCorona;102;182;284;549803;255947;805750
2022.06_18-07-2022;Ивановская область;21_45_days;SputnikLite;430;597;1027;549803;255947;805750
2022.06_18-07-2022;Ивановская область;21_45_days;SputnikV;912;916;1828;549803;255947;805750
2022.06_18-07-2022;Ивановская область;45_75_days;AllVaccines;2001;2201;4202;549803;255947;805750
2022.06_18-07-2022;Ивановская область;45_75_days;CoviVac;90;45;135;549803;255947;805750
2022.06_18-07-2022;Ивановская область;45_75_days;EpiVacCorona;100;170;270;549803;255947;805750
2022.06_18-07-2022;Ивановская область;45_75_days;SputnikLite;644;794;1438;549803;255947;805750
2022.06_18-07-2022;Ивановская область;45_75_days;SputnikV;1167;1192;2359;549803;255947;805750
2022.06_18-07-2022;Ивановская область;75_90_days;AllVaccines;1704;1261;2965;549803;255947;805750
2022.06_18-07-2022;Ивановская область;75_90_days;CoviVac;60;9;69;549803;255947;805750
2022.06_18-07-2022;Ивановская область;75_90_days;EpiVacCorona;72;41;113;549803;255947;805750
2022.06_18-07-2022;Ивановская область;75_90_days;SputnikLite;572;512;1084;549803;255947;805750
2022.06_18-07-2022;Ивановская область;75_90_days;SputnikV;1000;699;1699;549803;255947;805750
2022.06_18-07-2022;Ивановская область;90_105_days;AllVaccines;2664;1617;4281;549803;255947;805750
2022.06_18-07-2022;Ивановская область;90_105_days;CoviVac;56;5;61;549803;255947;805750
2022.06_18-07-2022;Ивановская область;90_105_days;EpiVacCorona;108;63;171;549803;255947;805750
2022.06_18-07-2022;Ивановская область;90_105_days;SputnikLite;1033;831;1864;549803;255947;805750
2022.06_18-07-2022;Ивановская область;90_105_days;SputnikV;1467;718;2185;549803;255947;805750
2022.06_18-07-2022;Иркутская область;105_165_days;AllVaccines;99436;43192;142628;1316761;480655;1797416
2022.06_18-07-2022;Иркутская область;105_165_days;CoviVac;792;323;1115;1316761;480655;1797416
2022.06_18-07-2022;Иркутская область;105_165_days;EpiVacCorona;2715;1854;4569;1316761;480655;1797416
2022.06_18-07-2022;Иркутская область;105_165_days;SputnikLite;47899;26434;74333;1316761;480655;1797416
2022.06_18-07-2022;Иркутская область;105_165_days;SputnikV;48030;14581;62611;1316761;480655;1797416
2022.06_18-07-2022;Иркутская область;165_195_days;AllVaccines;175896;55089;230985;1316761;480655;1797416
2022.06_18-07-2022;Иркутская область;165_195_days;CoviVac;1637;361;1998;1316761;480655;1797416
2022.06_18-07-2022;Иркутская область;165_195_days;EpiVacCorona;3280;1109;4389;1316761;480655;1797416
2022.06_18-07-2022;Иркутская область;165_195_days;SputnikLite;37963;26935;64898;1316761;480655;1797416
2022.06_18-07-2022;Иркутская область;165_195_days;SputnikV;133016;26684;159700;1316761;480655;1797416
2022.06_18-07-2022;Иркутская область;21_45_days;AllVaccines;5619;3524;9143;1316761;480655;1797416
2022.06_18-07-2022;Иркутская область;21_45_days;CoviVac;423;89;512;1316761;480655;1797416
2022.06_18-07-2022;Иркутская область;21_45_days;EpiVacCorona;633;271;904;1316761;480655;1797416
2022.06_18-07-2022;Иркутская область;21_45_days;SputnikLite;345;88;433;1316761;480655;1797416
2022.06_18-07-2022;Иркутская область;21_45_days;SputnikV;4218;3076;7294;1316761;480655;1797416
2022.06_18-07-2022;Иркутская область;45_75_days;AllVaccines;8120;4278;12398;1316761;480655;1797416
2022.06_18-07-2022;Иркутская область;45_75_days;CoviVac;431;132;563;1316761;480655;1797416
2022.06_18-07-2022;Иркутская область;45_75_days;EpiVacCorona;908;358;1266;1316761;480655;1797416
2022.06_18-07-2022;Иркутская область;45_75_days;SputnikLite;904;407;1311;1316761;480655;1797416
2022.06_18-07-2022;Иркутская область;45_75_days;SputnikV;5877;3381;9258;1316761;480655;1797416
2022.06_18-07-2022;Иркутская область;75_90_days;AllVaccines;6102;2481;8583;1316761;480655;1797416
2022.06_18-07-2022;Иркутская область;75_90_days;CoviVac;162;42;204;1316761;480655;1797416
2022.06_18-07-2022;Иркутская область;75_90_days;EpiVacCorona;331;149;480;1316761;480655;1797416
2022.06_18-07-2022;Иркутская область;75_90_days;SputnikLite;916;279;1195;1316761;480655;1797416
2022.06_18-07-2022;Иркутская область;75_90_days;SputnikV;4693;2011;6704;1316761;480655;1797416
2022.06_18-07-2022;Иркутская область;90_105_days;AllVaccines;7690;2743;10433;1316761;480655;1797416
2022.06_18-07-2022;Иркутская область;90_105_days;CoviVac;164;27;191;1316761;480655;1797416
2022.06_18-07-2022;Иркутская область;90_105_days;EpiVacCorona;269;91;360;1316761;480655;1797416
2022.06_18-07-2022;Иркутская область;90_105_days;SputnikLite;1323;353;1676;1316761;480655;1797416
2022.06_18-07-2022;Иркутская область;90_105_days;SputnikV;5934;2272;8206;1316761;480655;1797416
2022.06_18-07-2022;Кабардино-Балкарская Республика;105_165_days;AllVaccines;25831;10018;35849;502388;159241;661629
2022.06_18-07-2022;Кабардино-Балкарская Республика;105_165_days;CoviVac;330;94;424;502388;159241;661629
2022.06_18-07-2022;Кабардино-Балкарская Республика;105_165_days;EpiVacCorona;1462;405;1867;502388;159241;661629
2022.06_18-07-2022;Кабардино-Балкарская Республика;105_165_days;SputnikLite;16157;5836;21993;502388;159241;661629
2022.06_18-07-2022;Кабардино-Балкарская Республика;105_165_days;SputnikV;7882;3683;11565;502388;159241;661629
2022.06_18-07-2022;Кабардино-Балкарская Республика;165_195_days;AllVaccines;18491;6617;25108;502388;159241;661629
2022.06_18-07-2022;Кабардино-Балкарская Республика;165_195_days;CoviVac;171;46;217;502388;159241;661629
2022.06_18-07-2022;Кабардино-Балкарская Республика;165_195_days;EpiVacCorona;906;257;1163;502388;159241;661629
2022.06_18-07-2022;Кабардино-Балкарская Республика;165_195_days;SputnikLite;9021;2823;11844;502388;159241;661629
2022.06_18-07-2022;Кабардино-Балкарская Республика;165_195_days;SputnikV;8393;3491;11884;502388;159241;661629
2022.06_18-07-2022;Кабардино-Балкарская Республика;21_45_days;AllVaccines;1606;596;2202;502388;159241;661629
2022.06_18-07-2022;Кабардино-Балкарская Республика;21_45_days;CoviVac;198;55;253;502388;159241;661629
2022.06_18-07-2022;Кабардино-Балкарская Республика;21_45_days;EpiVacCorona;117;13;130;502388;159241;661629
2022.06_18-07-2022;Кабардино-Балкарская Республика;21_45_days;SputnikLite;330;62;392;502388;159241;661629
2022.06_18-07-2022;Кабардино-Балкарская Республика;21_45_days;SputnikV;961;466;1427;502388;159241;661629
2022.06_18-07-2022;Кабардино-Балкарская Республика;45_75_days;AllVaccines;2386;956;3342;502388;159241;661629
2022.06_18-07-2022;Кабардино-Балкарская Республика;45_75_days;CoviVac;110;42;152;502388;159241;661629
2022.06_18-07-2022;Кабардино-Балкарская Республика;45_75_days;EpiVacCorona;137;26;163;502388;159241;661629
2022.06_18-07-2022;Кабардино-Балкарская Республика;45_75_days;SputnikLite;692;190;882;502388;159241;661629
2022.06_18-07-2022;Кабардино-Балкарская Республика;45_75_days;SputnikV;1447;698;2145;502388;159241;661629
2022.06_18-07-2022;Кабардино-Балкарская Республика;75_90_days;AllVaccines;1289;608;1897;502388;159241;661629
2022.06_18-07-2022;Кабардино-Балкарская Республика;75_90_days;CoviVac;43;9;52;502388;159241;661629
2022.06_18-07-2022;Кабардино-Балкарская Республика;75_90_days;EpiVacCorona;152;60;212;502388;159241;661629
2022.06_18-07-2022;Кабардино-Балкарская Республика;75_90_days;SputnikLite;285;108;393;502388;159241;661629
2022.06_18-07-2022;Кабардино-Балкарская Республика;75_90_days;SputnikV;809;431;1240;502388;159241;661629
2022.06_18-07-2022;Кабардино-Балкарская Республика;90_105_days;AllVaccines;1524;648;2172;502388;159241;661629
2022.06_18-07-2022;Кабардино-Балкарская Республика;90_105_days;CoviVac;29;3;32;502388;159241;661629
2022.06_18-07-2022;Кабардино-Балкарская Республика;90_105_days;EpiVacCorona;169;44;213;502388;159241;661629
2022.06_18-07-2022;Кабардино-Балкарская Республика;90_105_days;SputnikLite;428;171;599;502388;159241;661629
2022.06_18-07-2022;Кабардино-Балкарская Республика;90_105_days;SputnikV;898;430;1328;502388;159241;661629
2022.06_18-07-2022;Калининградская область;105_165_days;AllVaccines;40035;20457;60492;585700;231702;817402
2022.06_18-07-2022;Калининградская область;105_165_days;CoviVac;562;178;740;585700;231702;817402
2022.06_18-07-2022;Калининградская область;105_165_days;EpiVacCorona;1303;597;1900;585700;231702;817402
2022.06_18-07-2022;Калининградская область;105_165_days;SputnikLite;20545;11741;32286;585700;231702;817402
2022.06_18-07-2022;Калининградская область;105_165_days;SputnikV;17625;7941;25566;585700;231702;817402
2022.06_18-07-2022;Калининградская область;165_195_days;AllVaccines;50782;26027;76809;585700;231702;817402
2022.06_18-07-2022;Калининградская область;165_195_days;CoviVac;996;276;1272;585700;231702;817402
2022.06_18-07-2022;Калининградская область;165_195_days;EpiVacCorona;1524;498;2022;585700;231702;817402
2022.06_18-07-2022;Калининградская область;165_195_days;SputnikLite;11212;10251;21463;585700;231702;817402
2022.06_18-07-2022;Калининградская область;165_195_days;SputnikV;37050;15002;52052;585700;231702;817402
2022.06_18-07-2022;Калининградская область;21_45_days;AllVaccines;2414;2300;4714;585700;231702;817402
2022.06_18-07-2022;Калининградская область;21_45_days;CoviVac;62;52;114;585700;231702;817402
2022.06_18-07-2022;Калининградская область;21_45_days;EpiVacCorona;61;23;84;585700;231702;817402
2022.06_18-07-2022;Калининградская область;21_45_days;SputnikLite;958;920;1878;585700;231702;817402
2022.06_18-07-2022;Калининградская область;21_45_days;SputnikV;1333;1305;2638;585700;231702;817402
2022.06_18-07-2022;Калининградская область;45_75_days;AllVaccines;3668;3190;6858;585700;231702;817402
2022.06_18-07-2022;Калининградская область;45_75_days;CoviVac;113;60;173;585700;231702;817402
2022.06_18-07-2022;Калининградская область;45_75_days;EpiVacCorona;120;63;183;585700;231702;817402
2022.06_18-07-2022;Калининградская область;45_75_days;SputnikLite;1133;1052;2185;585700;231702;817402
2022.06_18-07-2022;Калининградская область;45_75_days;SputnikV;2302;2015;4317;585700;231702;817402
2022.06_18-07-2022;Калининградская область;75_90_days;AllVaccines;3128;2149;5277;585700;231702;817402
2022.06_18-07-2022;Калининградская область;75_90_days;CoviVac;77;34;111;585700;231702;817402
2022.06_18-07-2022;Калининградская область;75_90_days;EpiVacCorona;80;43;123;585700;231702;817402
2022.06_18-07-2022;Калининградская область;75_90_days;SputnikLite;551;419;970;585700;231702;817402
2022.06_18-07-2022;Калининградская область;75_90_days;SputnikV;2420;1653;4073;585700;231702;817402
2022.06_18-07-2022;Калининградская область;90_105_days;AllVaccines;2785;1463;4248;585700;231702;817402
2022.06_18-07-2022;Калининградская область;90_105_days;CoviVac;44;14;58;585700;231702;817402
2022.06_18-07-2022;Калининградская область;90_105_days;EpiVacCorona;70;54;124;585700;231702;817402
2022.06_18-07-2022;Калининградская область;90_105_days;SputnikLite;656;514;1170;585700;231702;817402
2022.06_18-07-2022;Калининградская область;90_105_days;SputnikV;2015;881;2896;585700;231702;817402
2022.06_18-07-2022;Калужская область;105_165_days;AllVaccines;34715;18641;53356;559789;253023;812812
2022.06_18-07-2022;Калужская область;105_165_days;CoviVac;433;160;593;559789;253023;812812
2022.06_18-07-2022;Калужская область;105_165_days;EpiVacCorona;949;499;1448;559789;253023;812812
2022.06_18-07-2022;Калужская область;105_165_days;SputnikLite;16812;11394;28206;559789;253023;812812
2022.06_18-07-2022;Калужская область;105_165_days;SputnikV;16521;6588;23109;559789;253023;812812
2022.06_18-07-2022;Калужская область;165_195_days;AllVaccines;67918;25902;93820;559789;253023;812812
2022.06_18-07-2022;Калужская область;165_195_days;CoviVac;495;126;621;559789;253023;812812
2022.06_18-07-2022;Калужская область;165_195_days;EpiVacCorona;2644;993;3637;559789;253023;812812
2022.06_18-07-2022;Калужская область;165_195_days;SputnikLite;12120;9298;21418;559789;253023;812812
2022.06_18-07-2022;Калужская область;165_195_days;SputnikV;52659;15485;68144;559789;253023;812812
2022.06_18-07-2022;Калужская область;21_45_days;AllVaccines;2712;2308;5020;559789;253023;812812
2022.06_18-07-2022;Калужская область;21_45_days;CoviVac;154;123;277;559789;253023;812812
2022.06_18-07-2022;Калужская область;21_45_days;EpiVacCorona;200;125;325;559789;253023;812812
2022.06_18-07-2022;Калужская область;21_45_days;SputnikLite;22;10;32;559789;253023;812812
2022.06_18-07-2022;Калужская область;21_45_days;SputnikV;2336;2050;4386;559789;253023;812812
2022.06_18-07-2022;Калужская область;45_75_days;AllVaccines;3106;2254;5360;559789;253023;812812
2022.06_18-07-2022;Калужская область;45_75_days;CoviVac;65;62;127;559789;253023;812812
2022.06_18-07-2022;Калужская область;45_75_days;EpiVacCorona;148;75;223;559789;253023;812812
2022.06_18-07-2022;Калужская область;45_75_days;SputnikLite;567;425;992;559789;253023;812812
2022.06_18-07-2022;Калужская область;45_75_days;SputnikV;2326;1692;4018;559789;253023;812812
2022.06_18-07-2022;Калужская область;75_90_days;AllVaccines;2388;1319;3707;559789;253023;812812
2022.06_18-07-2022;Калужская область;75_90_days;CoviVac;101;27;128;559789;253023;812812
2022.06_18-07-2022;Калужская область;75_90_days;EpiVacCorona;155;84;239;559789;253023;812812
2022.06_18-07-2022;Калужская область;75_90_days;SputnikLite;355;349;704;559789;253023;812812
2022.06_18-07-2022;Калужская область;75_90_days;SputnikV;1777;859;2636;559789;253023;812812
2022.06_18-07-2022;Калужская область;90_105_days;AllVaccines;3358;1798;5156;559789;253023;812812
2022.06_18-07-2022;Калужская область;90_105_days;CoviVac;73;32;105;559789;253023;812812
2022.06_18-07-2022;Калужская область;90_105_days;EpiVacCorona;218;93;311;559789;253023;812812
2022.06_18-07-2022;Калужская область;90_105_days;SputnikLite;855;689;1544;559789;253023;812812
2022.06_18-07-2022;Калужская область;90_105_days;SputnikV;2212;984;3196;559789;253023;812812
2022.06_18-07-2022;Камчатский край;105_165_days;AllVaccines;10537;3276;13813;189425;56856;246281
2022.06_18-07-2022;Камчатский край;105_165_days;CoviVac;64;10;74;189425;56856;246281
2022.06_18-07-2022;Камчатский край;105_165_days;EpiVacCorona;423;149;572;189425;56856;246281
2022.06_18-07-2022;Камчатский край;105_165_days;SputnikLite;5555;2099;7654;189425;56856;246281
2022.06_18-07-2022;Камчатский край;105_165_days;SputnikV;4495;1018;5513;189425;56856;246281
2022.06_18-07-2022;Камчатский край;165_195_days;AllVaccines;14909;4166;19075;189425;56856;246281
2022.06_18-07-2022;Камчатский край;165_195_days;CoviVac;206;51;257;189425;56856;246281
2022.06_18-07-2022;Камчатский край;165_195_days;EpiVacCorona;460;179;639;189425;56856;246281
2022.06_18-07-2022;Камчатский край;165_195_days;SputnikLite;5611;2001;7612;189425;56856;246281
2022.06_18-07-2022;Камчатский край;165_195_days;SputnikV;8632;1935;10567;189425;56856;246281
2022.06_18-07-2022;Камчатский край;21_45_days;AllVaccines;1371;357;1728;189425;56856;246281
2022.06_18-07-2022;Камчатский край;21_45_days;CoviVac;6;3;9;189425;56856;246281
2022.06_18-07-2022;Камчатский край;21_45_days;EpiVacCorona;128;24;152;189425;56856;246281
2022.06_18-07-2022;Камчатский край;21_45_days;SputnikLite;267;68;335;189425;56856;246281
2022.06_18-07-2022;Камчатский край;21_45_days;SputnikV;970;262;1232;189425;56856;246281
2022.06_18-07-2022;Камчатский край;45_75_days;AllVaccines;2160;565;2725;189425;56856;246281
2022.06_18-07-2022;Камчатский край;45_75_days;CoviVac;36;10;46;189425;56856;246281
2022.06_18-07-2022;Камчатский край;45_75_days;EpiVacCorona;91;24;115;189425;56856;246281
2022.06_18-07-2022;Камчатский край;45_75_days;SputnikLite;620;119;739;189425;56856;246281
2022.06_18-07-2022;Камчатский край;45_75_days;SputnikV;1413;412;1825;189425;56856;246281
2022.06_18-07-2022;Камчатский край;75_90_days;AllVaccines;1299;380;1679;189425;56856;246281
2022.06_18-07-2022;Камчатский край;75_90_days;CoviVac;12;5;17;189425;56856;246281
2022.06_18-07-2022;Камчатский край;75_90_days;EpiVacCorona;165;58;223;189425;56856;246281
2022.06_18-07-2022;Камчатский край;75_90_days;SputnikLite;199;68;267;189425;56856;246281
2022.06_18-07-2022;Камчатский край;75_90_days;SputnikV;923;249;1172;189425;56856;246281
2022.06_18-07-2022;Камчатский край;90_105_days;AllVaccines;1706;543;2249;189425;56856;246281
2022.06_18-07-2022;Камчатский край;90_105_days;CoviVac;48;7;55;189425;56856;246281
2022.06_18-07-2022;Камчатский край;90_105_days;EpiVacCorona;142;42;184;189425;56856;246281
2022.06_18-07-2022;Камчатский край;90_105_days;SputnikLite;345;116;461;189425;56856;246281
2022.06_18-07-2022;Камчатский край;90_105_days;SputnikV;1171;378;1549;189425;56856;246281
2022.06_18-07-2022;Карачаево-Черкесская Республика;105_165_days;AllVaccines;17666;6489;24155;266261;94005;360266
2022.06_18-07-2022;Карачаево-Черкесская Республика;105_165_days;CoviVac;195;68;263;266261;94005;360266
2022.06_18-07-2022;Карачаево-Черкесская Республика;105_165_days;EpiVacCorona;1204;307;1511;266261;94005;360266
2022.06_18-07-2022;Карачаево-Черкесская Республика;105_165_days;SputnikLite;8326;3011;11337;266261;94005;360266
2022.06_18-07-2022;Карачаево-Черкесская Республика;105_165_days;SputnikV;7941;3103;11044;266261;94005;360266
2022.06_18-07-2022;Карачаево-Черкесская Республика;165_195_days;AllVaccines;12242;4218;16460;266261;94005;360266
2022.06_18-07-2022;Карачаево-Черкесская Республика;165_195_days;CoviVac;121;46;167;266261;94005;360266
2022.06_18-07-2022;Карачаево-Черкесская Республика;165_195_days;EpiVacCorona;231;74;305;266261;94005;360266
2022.06_18-07-2022;Карачаево-Черкесская Республика;165_195_days;SputnikLite;7031;2290;9321;266261;94005;360266
2022.06_18-07-2022;Карачаево-Черкесская Республика;165_195_days;SputnikV;4859;1808;6667;266261;94005;360266
2022.06_18-07-2022;Карачаево-Черкесская Республика;21_45_days;AllVaccines;4772;2635;7407;266261;94005;360266
2022.06_18-07-2022;Карачаево-Черкесская Республика;21_45_days;CoviVac;142;32;174;266261;94005;360266
2022.06_18-07-2022;Карачаево-Черкесская Республика;21_45_days;EpiVacCorona;946;470;1416;266261;94005;360266
2022.06_18-07-2022;Карачаево-Черкесская Республика;21_45_days;SputnikLite;637;386;1023;266261;94005;360266
2022.06_18-07-2022;Карачаево-Черкесская Республика;21_45_days;SputnikV;3047;1747;4794;266261;94005;360266
2022.06_18-07-2022;Карачаево-Черкесская Республика;45_75_days;AllVaccines;6217;2754;8971;266261;94005;360266
2022.06_18-07-2022;Карачаево-Черкесская Республика;45_75_days;CoviVac;782;245;1027;266261;94005;360266
2022.06_18-07-2022;Карачаево-Черкесская Республика;45_75_days;EpiVacCorona;1310;784;2094;266261;94005;360266
2022.06_18-07-2022;Карачаево-Черкесская Республика;45_75_days;SputnikLite;890;393;1283;266261;94005;360266
2022.06_18-07-2022;Карачаево-Черкесская Республика;45_75_days;SputnikV;3235;1332;4567;266261;94005;360266
2022.06_18-07-2022;Карачаево-Черкесская Республика;75_90_days;AllVaccines;3521;1324;4845;266261;94005;360266
2022.06_18-07-2022;Карачаево-Черкесская Республика;75_90_days;CoviVac;228;76;304;266261;94005;360266
2022.06_18-07-2022;Карачаево-Черкесская Республика;75_90_days;EpiVacCorona;299;96;395;266261;94005;360266
2022.06_18-07-2022;Карачаево-Черкесская Республика;75_90_days;SputnikLite;598;256;854;266261;94005;360266
2022.06_18-07-2022;Карачаево-Черкесская Республика;75_90_days;SputnikV;2396;896;3292;266261;94005;360266
2022.06_18-07-2022;Карачаево-Черкесская Республика;90_105_days;AllVaccines;2797;883;3680;266261;94005;360266
2022.06_18-07-2022;Карачаево-Черкесская Республика;90_105_days;CoviVac;100;33;133;266261;94005;360266
2022.06_18-07-2022;Карачаево-Черкесская Республика;90_105_days;EpiVacCorona;549;164;713;266261;94005;360266
2022.06_18-07-2022;Карачаево-Черкесская Республика;90_105_days;SputnikLite;875;303;1178;266261;94005;360266
2022.06_18-07-2022;Карачаево-Черкесская Республика;90_105_days;SputnikV;1273;383;1656;266261;94005;360266
2022.06_18-07-2022;Кемеровская область;105_165_days;AllVaccines;142033;58936;200969;1453976;610256;2064232
2022.06_18-07-2022;Кемеровская область;105_165_days;CoviVac;1146;297;1443;1453976;610256;2064232
2022.06_18-07-2022;Кемеровская область;105_165_days;EpiVacCorona;8114;4508;12622;1453976;610256;2064232
2022.06_18-07-2022;Кемеровская область;105_165_days;SputnikLite;75418;32324;107742;1453976;610256;2064232
2022.06_18-07-2022;Кемеровская область;105_165_days;SputnikV;57355;21807;79162;1453976;610256;2064232
2022.06_18-07-2022;Кемеровская область;165_195_days;AllVaccines;140511;58497;199008;1453976;610256;2064232
2022.06_18-07-2022;Кемеровская область;165_195_days;CoviVac;1462;304;1766;1453976;610256;2064232
2022.06_18-07-2022;Кемеровская область;165_195_days;EpiVacCorona;5241;2103;7344;1453976;610256;2064232
2022.06_18-07-2022;Кемеровская область;165_195_days;SputnikLite;25039;19772;44811;1453976;610256;2064232
2022.06_18-07-2022;Кемеровская область;165_195_days;SputnikV;108769;36318;145087;1453976;610256;2064232
2022.06_18-07-2022;Кемеровская область;21_45_days;AllVaccines;4892;3131;8023;1453976;610256;2064232
2022.06_18-07-2022;Кемеровская область;21_45_days;CoviVac;319;109;428;1453976;610256;2064232
2022.06_18-07-2022;Кемеровская область;21_45_days;EpiVacCorona;522;337;859;1453976;610256;2064232
2022.06_18-07-2022;Кемеровская область;21_45_days;SputnikLite;157;106;263;1453976;610256;2064232
2022.06_18-07-2022;Кемеровская область;21_45_days;SputnikV;3894;2579;6473;1453976;610256;2064232
2022.06_18-07-2022;Кемеровская область;45_75_days;AllVaccines;9001;4204;13205;1453976;610256;2064232
2022.06_18-07-2022;Кемеровская область;45_75_days;CoviVac;409;135;544;1453976;610256;2064232
2022.06_18-07-2022;Кемеровская область;45_75_days;EpiVacCorona;1041;438;1479;1453976;610256;2064232
2022.06_18-07-2022;Кемеровская область;45_75_days;SputnikLite;390;237;627;1453976;610256;2064232
2022.06_18-07-2022;Кемеровская область;45_75_days;SputnikV;7161;3394;10555;1453976;610256;2064232
2022.06_18-07-2022;Кемеровская область;75_90_days;AllVaccines;6652;2414;9066;1453976;610256;2064232
2022.06_18-07-2022;Кемеровская область;75_90_days;CoviVac;181;63;244;1453976;610256;2064232
2022.06_18-07-2022;Кемеровская область;75_90_days;EpiVacCorona;501;205;706;1453976;610256;2064232
2022.06_18-07-2022;Кемеровская область;75_90_days;SputnikLite;609;196;805;1453976;610256;2064232
2022.06_18-07-2022;Кемеровская область;75_90_days;SputnikV;5361;1950;7311;1453976;610256;2064232
2022.06_18-07-2022;Кемеровская область;90_105_days;AllVaccines;9531;3195;12726;1453976;610256;2064232
2022.06_18-07-2022;Кемеровская область;90_105_days;CoviVac;244;75;319;1453976;610256;2064232
2022.06_18-07-2022;Кемеровская область;90_105_days;EpiVacCorona;560;289;849;1453976;610256;2064232
2022.06_18-07-2022;Кемеровская область;90_105_days;SputnikLite;1886;605;2491;1453976;610256;2064232
2022.06_18-07-2022;Кемеровская область;90_105_days;SputnikV;6841;2226;9067;1453976;610256;2064232
2022.06_18-07-2022;Кировская область;105_165_days;AllVaccines;50831;32389;83220;663621;334585;998206
2022.06_18-07-2022;Кировская область;105_165_days;CoviVac;823;159;982;663621;334585;998206
2022.06_18-07-2022;Кировская область;105_165_days;EpiVacCorona;1669;875;2544;663621;334585;998206
2022.06_18-07-2022;Кировская область;105_165_days;SputnikLite;34358;20365;54723;663621;334585;998206
2022.06_18-07-2022;Кировская область;105_165_days;SputnikV;13981;10990;24971;663621;334585;998206
2022.06_18-07-2022;Кировская область;165_195_days;AllVaccines;66183;40451;106634;663621;334585;998206
2022.06_18-07-2022;Кировская область;165_195_days;CoviVac;1186;167;1353;663621;334585;998206
2022.06_18-07-2022;Кировская область;165_195_days;EpiVacCorona;3452;1433;4885;663621;334585;998206
2022.06_18-07-2022;Кировская область;165_195_days;SputnikLite;20349;14333;34682;663621;334585;998206
2022.06_18-07-2022;Кировская область;165_195_days;SputnikV;41196;24518;65714;663621;334585;998206
2022.06_18-07-2022;Кировская область;21_45_days;AllVaccines;3233;4156;7389;663621;334585;998206
2022.06_18-07-2022;Кировская область;21_45_days;CoviVac;41;9;50;663621;334585;998206
2022.06_18-07-2022;Кировская область;21_45_days;EpiVacCorona;181;87;268;663621;334585;998206
2022.06_18-07-2022;Кировская область;21_45_days;SputnikLite;608;128;736;663621;334585;998206
2022.06_18-07-2022;Кировская область;21_45_days;SputnikV;2403;3932;6335;663621;334585;998206
2022.06_18-07-2022;Кировская область;45_75_days;AllVaccines;4048;4194;8242;663621;334585;998206
2022.06_18-07-2022;Кировская область;45_75_days;CoviVac;96;31;127;663621;334585;998206
2022.06_18-07-2022;Кировская область;45_75_days;EpiVacCorona;283;184;467;663621;334585;998206
2022.06_18-07-2022;Кировская область;45_75_days;SputnikLite;1421;1019;2440;663621;334585;998206
2022.06_18-07-2022;Кировская область;45_75_days;SputnikV;2248;2960;5208;663621;334585;998206
2022.06_18-07-2022;Кировская область;75_90_days;AllVaccines;2568;2565;5133;663621;334585;998206
2022.06_18-07-2022;Кировская область;75_90_days;CoviVac;27;5;32;663621;334585;998206
2022.06_18-07-2022;Кировская область;75_90_days;EpiVacCorona;63;39;102;663621;334585;998206
2022.06_18-07-2022;Кировская область;75_90_days;SputnikLite;1162;1022;2184;663621;334585;998206
2022.06_18-07-2022;Кировская область;75_90_days;SputnikV;1316;1499;2815;663621;334585;998206
2022.06_18-07-2022;Кировская область;90_105_days;AllVaccines;3831;3079;6910;663621;334585;998206
2022.06_18-07-2022;Кировская область;90_105_days;CoviVac;45;6;51;663621;334585;998206
2022.06_18-07-2022;Кировская область;90_105_days;EpiVacCorona;107;52;159;663621;334585;998206
2022.06_18-07-2022;Кировская область;90_105_days;SputnikLite;1830;1564;3394;663621;334585;998206
2022.06_18-07-2022;Кировская область;90_105_days;SputnikV;1849;1457;3306;663621;334585;998206
2022.06_18-07-2022;Костромская область;105_165_days;AllVaccines;19956;11233;31189;339046;160543;499589
2022.06_18-07-2022;Костромская область;105_165_days;CoviVac;626;211;837;339046;160543;499589
2022.06_18-07-2022;Костромская область;105_165_days;EpiVacCorona;1433;737;2170;339046;160543;499589
2022.06_18-07-2022;Костромская область;105_165_days;SputnikLite;10246;5889;16135;339046;160543;499589
2022.06_18-07-2022;Костромская область;105_165_days;SputnikV;7651;4396;12047;339046;160543;499589
2022.06_18-07-2022;Костромская область;165_195_days;AllVaccines;29194;15090;44284;339046;160543;499589
2022.06_18-07-2022;Костромская область;165_195_days;CoviVac;288;81;369;339046;160543;499589
2022.06_18-07-2022;Костромская область;165_195_days;EpiVacCorona;3770;1420;5190;339046;160543;499589
2022.06_18-07-2022;Костромская область;165_195_days;SputnikLite;11826;6500;18326;339046;160543;499589
2022.06_18-07-2022;Костромская область;165_195_days;SputnikV;13310;7089;20399;339046;160543;499589
2022.06_18-07-2022;Костромская область;21_45_days;AllVaccines;721;821;1542;339046;160543;499589
2022.06_18-07-2022;Костромская область;21_45_days;CoviVac;29;48;77;339046;160543;499589
2022.06_18-07-2022;Костромская область;21_45_days;EpiVacCorona;116;120;236;339046;160543;499589
2022.06_18-07-2022;Костромская область;21_45_days;SputnikLite;15;8;23;339046;160543;499589
2022.06_18-07-2022;Костромская область;21_45_days;SputnikV;561;645;1206;339046;160543;499589
2022.06_18-07-2022;Костромская область;45_75_days;AllVaccines;1467;1406;2873;339046;160543;499589
2022.06_18-07-2022;Костромская область;45_75_days;CoviVac;91;46;137;339046;160543;499589
2022.06_18-07-2022;Костромская область;45_75_days;EpiVacCorona;271;216;487;339046;160543;499589
2022.06_18-07-2022;Костромская область;45_75_days;SputnikLite;36;42;78;339046;160543;499589
2022.06_18-07-2022;Костромская область;45_75_days;SputnikV;1069;1102;2171;339046;160543;499589
2022.06_18-07-2022;Костромская область;75_90_days;AllVaccines;1386;952;2338;339046;160543;499589
2022.06_18-07-2022;Костромская область;75_90_days;CoviVac;76;27;103;339046;160543;499589
2022.06_18-07-2022;Костромская область;75_90_days;EpiVacCorona;248;151;399;339046;160543;499589
2022.06_18-07-2022;Костромская область;75_90_days;SputnikLite;113;86;199;339046;160543;499589
2022.06_18-07-2022;Костромская область;75_90_days;SputnikV;949;688;1637;339046;160543;499589
2022.06_18-07-2022;Костромская область;90_105_days;AllVaccines;1694;900;2594;339046;160543;499589
2022.06_18-07-2022;Костромская область;90_105_days;CoviVac;77;17;94;339046;160543;499589
2022.06_18-07-2022;Костромская область;90_105_days;EpiVacCorona;188;102;290;339046;160543;499589
2022.06_18-07-2022;Костромская область;90_105_days;SputnikLite;209;138;347;339046;160543;499589
2022.06_18-07-2022;Костромская область;90_105_days;SputnikV;1220;643;1863;339046;160543;499589
2022.06_18-07-2022;Краснодарский край;105_165_days;AllVaccines;236499;135328;371827;3157155;1334085;4491240
2022.06_18-07-2022;Краснодарский край;105_165_days;CoviVac;1972;608;2580;3157155;1334085;4491240
2022.06_18-07-2022;Краснодарский край;105_165_days;EpiVacCorona;6728;5588;12316;3157155;1334085;4491240
2022.06_18-07-2022;Краснодарский край;105_165_days;SputnikLite;89556;45501;135057;3157155;1334085;4491240
2022.06_18-07-2022;Краснодарский край;105_165_days;SputnikV;138243;83631;221874;3157155;1334085;4491240
2022.06_18-07-2022;Краснодарский край;165_195_days;AllVaccines;325668;152029;477697;3157155;1334085;4491240
2022.06_18-07-2022;Краснодарский край;165_195_days;CoviVac;2010;673;2683;3157155;1334085;4491240
2022.06_18-07-2022;Краснодарский край;165_195_days;EpiVacCorona;5642;2824;8466;3157155;1334085;4491240
2022.06_18-07-2022;Краснодарский край;165_195_days;SputnikLite;50257;45672;95929;3157155;1334085;4491240
2022.06_18-07-2022;Краснодарский край;165_195_days;SputnikV;267759;102860;370619;3157155;1334085;4491240
2022.06_18-07-2022;Краснодарский край;21_45_days;AllVaccines;21756;18808;40564;3157155;1334085;4491240
2022.06_18-07-2022;Краснодарский край;21_45_days;CoviVac;1688;1094;2782;3157155;1334085;4491240
2022.06_18-07-2022;Краснодарский край;21_45_days;EpiVacCorona;662;775;1437;3157155;1334085;4491240
2022.06_18-07-2022;Краснодарский край;21_45_days;SputnikLite;1159;524;1683;3157155;1334085;4491240
2022.06_18-07-2022;Краснодарский край;21_45_days;SputnikV;18247;16415;34662;3157155;1334085;4491240
2022.06_18-07-2022;Краснодарский край;45_75_days;AllVaccines;30681;32133;62814;3157155;1334085;4491240
2022.06_18-07-2022;Краснодарский край;45_75_days;CoviVac;1057;521;1578;3157155;1334085;4491240
2022.06_18-07-2022;Краснодарский край;45_75_days;EpiVacCorona;1907;1804;3711;3157155;1334085;4491240
2022.06_18-07-2022;Краснодарский край;45_75_days;SputnikLite;1498;744;2242;3157155;1334085;4491240
2022.06_18-07-2022;Краснодарский край;45_75_days;SputnikV;26219;29064;55283;3157155;1334085;4491240
2022.06_18-07-2022;Краснодарский край;75_90_days;AllVaccines;26434;32007;58441;3157155;1334085;4491240
2022.06_18-07-2022;Краснодарский край;75_90_days;CoviVac;175;80;255;3157155;1334085;4491240
2022.06_18-07-2022;Краснодарский край;75_90_days;EpiVacCorona;4912;3649;8561;3157155;1334085;4491240
2022.06_18-07-2022;Краснодарский край;75_90_days;SputnikLite;2574;2771;5345;3157155;1334085;4491240
2022.06_18-07-2022;Краснодарский край;75_90_days;SputnikV;18773;25507;44280;3157155;1334085;4491240
2022.06_18-07-2022;Краснодарский край;90_105_days;AllVaccines;31417;28000;59417;3157155;1334085;4491240
2022.06_18-07-2022;Краснодарский край;90_105_days;CoviVac;232;73;305;3157155;1334085;4491240
2022.06_18-07-2022;Краснодарский край;90_105_days;EpiVacCorona;2724;3175;5899;3157155;1334085;4491240
2022.06_18-07-2022;Краснодарский край;90_105_days;SputnikLite;2437;1464;3901;3157155;1334085;4491240
2022.06_18-07-2022;Краснодарский край;90_105_days;SputnikV;26024;23288;49312;3157155;1334085;4491240
2022.06_18-07-2022;Красноярский край;105_165_days;AllVaccines;162790;63934;226724;1637377;585822;2223199
2022.06_18-07-2022;Красноярский край;105_165_days;CoviVac;1998;698;2696;1637377;585822;2223199
2022.06_18-07-2022;Красноярский край;105_165_days;EpiVacCorona;4724;2820;7544;1637377;585822;2223199
2022.06_18-07-2022;Красноярский край;105_165_days;SputnikLite;86275;35505;121780;1637377;585822;2223199
2022.06_18-07-2022;Красноярский край;105_165_days;SputnikV;69793;24911;94704;1637377;585822;2223199
2022.06_18-07-2022;Красноярский край;165_195_days;AllVaccines;169855;64782;234637;1637377;585822;2223199
2022.06_18-07-2022;Красноярский край;165_195_days;CoviVac;1811;423;2234;1637377;585822;2223199
2022.06_18-07-2022;Красноярский край;165_195_days;EpiVacCorona;7463;3848;11311;1637377;585822;2223199
2022.06_18-07-2022;Красноярский край;165_195_days;SputnikLite;41856;23385;65241;1637377;585822;2223199
2022.06_18-07-2022;Красноярский край;165_195_days;SputnikV;118725;37126;155851;1637377;585822;2223199
2022.06_18-07-2022;Красноярский край;21_45_days;AllVaccines;9053;5594;14647;1637377;585822;2223199
2022.06_18-07-2022;Красноярский край;21_45_days;CoviVac;560;183;743;1637377;585822;2223199
2022.06_18-07-2022;Красноярский край;21_45_days;EpiVacCorona;929;637;1566;1637377;585822;2223199
2022.06_18-07-2022;Красноярский край;21_45_days;SputnikLite;1136;382;1518;1637377;585822;2223199
2022.06_18-07-2022;Красноярский край;21_45_days;SputnikV;6428;4392;10820;1637377;585822;2223199
2022.06_18-07-2022;Красноярский край;45_75_days;AllVaccines;18438;8047;26485;1637377;585822;2223199
2022.06_18-07-2022;Красноярский край;45_75_days;CoviVac;765;321;1086;1637377;585822;2223199
2022.06_18-07-2022;Красноярский край;45_75_days;EpiVacCorona;1344;796;2140;1637377;585822;2223199
2022.06_18-07-2022;Красноярский край;45_75_days;SputnikLite;4851;598;5449;1637377;585822;2223199
2022.06_18-07-2022;Красноярский край;45_75_days;SputnikV;11478;6332;17810;1637377;585822;2223199
2022.06_18-07-2022;Красноярский край;75_90_days;AllVaccines;12203;4853;17056;1637377;585822;2223199
2022.06_18-07-2022;Красноярский край;75_90_days;CoviVac;292;232;524;1637377;585822;2223199
2022.06_18-07-2022;Красноярский край;75_90_days;EpiVacCorona;771;362;1133;1637377;585822;2223199
2022.06_18-07-2022;Красноярский край;75_90_days;SputnikLite;1992;385;2377;1637377;585822;2223199
2022.06_18-07-2022;Красноярский край;75_90_days;SputnikV;9148;3874;13022;1637377;585822;2223199
2022.06_18-07-2022;Красноярский край;90_105_days;AllVaccines;13953;4428;18381;1637377;585822;2223199
2022.06_18-07-2022;Красноярский край;90_105_days;CoviVac;311;125;436;1637377;585822;2223199
2022.06_18-07-2022;Красноярский край;90_105_days;EpiVacCorona;560;287;847;1637377;585822;2223199
2022.06_18-07-2022;Красноярский край;90_105_days;SputnikLite;3127;540;3667;1637377;585822;2223199
2022.06_18-07-2022;Красноярский край;90_105_days;SputnikV;9955;3476;13431;1637377;585822;2223199
2022.06_18-07-2022;Курганская область;105_165_days;AllVaccines;46746;28459;75205;425081;217502;642583
2022.06_18-07-2022;Курганская область;105_165_days;CoviVac;374;109;483;425081;217502;642583
2022.06_18-07-2022;Курганская область;105_165_days;EpiVacCorona;2579;1860;4439;425081;217502;642583
2022.06_18-07-2022;Курганская область;105_165_days;SputnikLite;30950;18871;49821;425081;217502;642583
2022.06_18-07-2022;Курганская область;105_165_days;SputnikV;12843;7619;20462;425081;217502;642583
2022.06_18-07-2022;Курганская область;165_195_days;AllVaccines;35276;21978;57254;425081;217502;642583
2022.06_18-07-2022;Курганская область;165_195_days;CoviVac;632;229;861;425081;217502;642583
2022.06_18-07-2022;Курганская область;165_195_days;EpiVacCorona;731;473;1204;425081;217502;642583
2022.06_18-07-2022;Курганская область;165_195_days;SputnikLite;10164;10551;20715;425081;217502;642583
2022.06_18-07-2022;Курганская область;165_195_days;SputnikV;23749;10725;34474;425081;217502;642583
2022.06_18-07-2022;Курганская область;21_45_days;AllVaccines;2594;2663;5257;425081;217502;642583
2022.06_18-07-2022;Курганская область;21_45_days;CoviVac;30;42;72;425081;217502;642583
2022.06_18-07-2022;Курганская область;21_45_days;EpiVacCorona;345;311;656;425081;217502;642583
2022.06_18-07-2022;Курганская область;21_45_days;SputnikLite;628;307;935;425081;217502;642583
2022.06_18-07-2022;Курганская область;21_45_days;SputnikV;1591;2003;3594;425081;217502;642583
2022.06_18-07-2022;Курганская область;45_75_days;AllVaccines;3241;2862;6103;425081;217502;642583
2022.06_18-07-2022;Курганская область;45_75_days;CoviVac;65;114;179;425081;217502;642583
2022.06_18-07-2022;Курганская область;45_75_days;EpiVacCorona;423;382;805;425081;217502;642583
2022.06_18-07-2022;Курганская область;45_75_days;SputnikLite;698;395;1093;425081;217502;642583
2022.06_18-07-2022;Курганская область;45_75_days;SputnikV;2055;1971;4026;425081;217502;642583
2022.06_18-07-2022;Курганская область;75_90_days;AllVaccines;2691;1900;4591;425081;217502;642583
2022.06_18-07-2022;Курганская область;75_90_days;CoviVac;37;12;49;425081;217502;642583
2022.06_18-07-2022;Курганская область;75_90_days;EpiVacCorona;498;356;854;425081;217502;642583
2022.06_18-07-2022;Курганская область;75_90_days;SputnikLite;1005;679;1684;425081;217502;642583
2022.06_18-07-2022;Курганская область;75_90_days;SputnikV;1151;853;2004;425081;217502;642583
2022.06_18-07-2022;Курганская область;90_105_days;AllVaccines;3232;2053;5285;425081;217502;642583
2022.06_18-07-2022;Курганская область;90_105_days;CoviVac;38;4;42;425081;217502;642583
2022.06_18-07-2022;Курганская область;90_105_days;EpiVacCorona;230;155;385;425081;217502;642583
2022.06_18-07-2022;Курганская область;90_105_days;SputnikLite;1630;956;2586;425081;217502;642583
2022.06_18-07-2022;Курганская область;90_105_days;SputnikV;1334;938;2272;425081;217502;642583
2022.06_18-07-2022;Курская область;105_165_days;AllVaccines;52092;22441;74533;604409;285634;890043
2022.06_18-07-2022;Курская область;105_165_days;CoviVac;973;210;1183;604409;285634;890043
2022.06_18-07-2022;Курская область;105_165_days;EpiVacCorona;2743;1334;4077;604409;285634;890043
2022.06_18-07-2022;Курская область;105_165_days;SputnikLite;36566;15151;51717;604409;285634;890043
2022.06_18-07-2022;Курская область;105_165_days;SputnikV;11810;5746;17556;604409;285634;890043
2022.06_18-07-2022;Курская область;165_195_days;AllVaccines;47415;24446;71861;604409;285634;890043
2022.06_18-07-2022;Курская область;165_195_days;CoviVac;1666;389;2055;604409;285634;890043
2022.06_18-07-2022;Курская область;165_195_days;EpiVacCorona;3311;1605;4916;604409;285634;890043
2022.06_18-07-2022;Курская область;165_195_days;SputnikLite;15273;9199;24472;604409;285634;890043
2022.06_18-07-2022;Курская область;165_195_days;SputnikV;27165;13253;40418;604409;285634;890043
2022.06_18-07-2022;Курская область;21_45_days;AllVaccines;3267;2299;5566;604409;285634;890043
2022.06_18-07-2022;Курская область;21_45_days;CoviVac;7;2;9;604409;285634;890043
2022.06_18-07-2022;Курская область;21_45_days;EpiVacCorona;218;84;302;604409;285634;890043
2022.06_18-07-2022;Курская область;21_45_days;SputnikLite;948;314;1262;604409;285634;890043
2022.06_18-07-2022;Курская область;21_45_days;SputnikV;2094;1899;3993;604409;285634;890043
2022.06_18-07-2022;Курская область;45_75_days;AllVaccines;6707;3458;10165;604409;285634;890043
2022.06_18-07-2022;Курская область;45_75_days;CoviVac;200;27;227;604409;285634;890043
2022.06_18-07-2022;Курская область;45_75_days;EpiVacCorona;464;257;721;604409;285634;890043
2022.06_18-07-2022;Курская область;45_75_days;SputnikLite;1670;407;2077;604409;285634;890043
2022.06_18-07-2022;Курская область;45_75_days;SputnikV;4373;2767;7140;604409;285634;890043
2022.06_18-07-2022;Курская область;75_90_days;AllVaccines;5088;1789;6877;604409;285634;890043
2022.06_18-07-2022;Курская область;75_90_days;CoviVac;245;31;276;604409;285634;890043
2022.06_18-07-2022;Курская область;75_90_days;EpiVacCorona;257;82;339;604409;285634;890043
2022.06_18-07-2022;Курская область;75_90_days;SputnikLite;1039;165;1204;604409;285634;890043
2022.06_18-07-2022;Курская область;75_90_days;SputnikV;3547;1511;5058;604409;285634;890043
2022.06_18-07-2022;Курская область;90_105_days;AllVaccines;4661;1730;6391;604409;285634;890043
2022.06_18-07-2022;Курская область;90_105_days;CoviVac;268;69;337;604409;285634;890043
2022.06_18-07-2022;Курская область;90_105_days;EpiVacCorona;380;161;541;604409;285634;890043
2022.06_18-07-2022;Курская область;90_105_days;SputnikLite;1379;467;1846;604409;285634;890043
2022.06_18-07-2022;Курская область;90_105_days;SputnikV;2634;1033;3667;604409;285634;890043
2022.06_18-07-2022;Ленинградская область;105_165_days;AllVaccines;66127;35032;101159;1100343;462742;1563085
2022.06_18-07-2022;Ленинградская область;105_165_days;CoviVac;763;160;923;1100343;462742;1563085
2022.06_18-07-2022;Ленинградская область;105_165_days;EpiVacCorona;1498;843;2341;1100343;462742;1563085
2022.06_18-07-2022;Ленинградская область;105_165_days;SputnikLite;28374;19373;47747;1100343;462742;1563085
2022.06_18-07-2022;Ленинградская область;105_165_days;SputnikV;35492;14656;50148;1100343;462742;1563085
2022.06_18-07-2022;Ленинградская область;165_195_days;AllVaccines;93120;47514;140634;1100343;462742;1563085
2022.06_18-07-2022;Ленинградская область;165_195_days;CoviVac;1057;140;1197;1100343;462742;1563085
2022.06_18-07-2022;Ленинградская область;165_195_days;EpiVacCorona;2256;1363;3619;1100343;462742;1563085
2022.06_18-07-2022;Ленинградская область;165_195_days;SputnikLite;19889;16887;36776;1100343;462742;1563085
2022.06_18-07-2022;Ленинградская область;165_195_days;SputnikV;69918;29124;99042;1100343;462742;1563085
2022.06_18-07-2022;Ленинградская область;21_45_days;AllVaccines;3627;3025;6652;1100343;462742;1563085
2022.06_18-07-2022;Ленинградская область;21_45_days;CoviVac;84;28;112;1100343;462742;1563085
2022.06_18-07-2022;Ленинградская область;21_45_days;EpiVacCorona;53;26;79;1100343;462742;1563085
2022.06_18-07-2022;Ленинградская область;21_45_days;SputnikLite;710;513;1223;1100343;462742;1563085
2022.06_18-07-2022;Ленинградская область;21_45_days;SputnikV;2780;2458;5238;1100343;462742;1563085
2022.06_18-07-2022;Ленинградская область;45_75_days;AllVaccines;5246;4000;9246;1100343;462742;1563085
2022.06_18-07-2022;Ленинградская область;45_75_days;CoviVac;297;118;415;1100343;462742;1563085
2022.06_18-07-2022;Ленинградская область;45_75_days;EpiVacCorona;155;50;205;1100343;462742;1563085
2022.06_18-07-2022;Ленинградская область;45_75_days;SputnikLite;1037;799;1836;1100343;462742;1563085
2022.06_18-07-2022;Ленинградская область;45_75_days;SputnikV;3757;3033;6790;1100343;462742;1563085
2022.06_18-07-2022;Ленинградская область;75_90_days;AllVaccines;3837;2277;6114;1100343;462742;1563085
2022.06_18-07-2022;Ленинградская область;75_90_days;CoviVac;92;11;103;1100343;462742;1563085
2022.06_18-07-2022;Ленинградская область;75_90_days;EpiVacCorona;89;39;128;1100343;462742;1563085
2022.06_18-07-2022;Ленинградская область;75_90_days;SputnikLite;710;606;1316;1100343;462742;1563085
2022.06_18-07-2022;Ленинградская область;75_90_days;SputnikV;2946;1621;4567;1100343;462742;1563085
2022.06_18-07-2022;Ленинградская область;90_105_days;AllVaccines;6363;3064;9427;1100343;462742;1563085
2022.06_18-07-2022;Ленинградская область;90_105_days;CoviVac;123;11;134;1100343;462742;1563085
2022.06_18-07-2022;Ленинградская область;90_105_days;EpiVacCorona;115;38;153;1100343;462742;1563085
2022.06_18-07-2022;Ленинградская область;90_105_days;SputnikLite;1512;930;2442;1100343;462742;1563085
2022.06_18-07-2022;Ленинградская область;90_105_days;SputnikV;4613;2085;6698;1100343;462742;1563085
2022.06_18-07-2022;Липецкая область;105_165_days;AllVaccines;45282;20512;65794;621641;290878;912519
2022.06_18-07-2022;Липецкая область;105_165_days;CoviVac;593;46;639;621641;290878;912519
2022.06_18-07-2022;Липецкая область;105_165_days;EpiVacCorona;3936;1717;5653;621641;290878;912519
2022.06_18-07-2022;Липецкая область;105_165_days;SputnikLite;23923;12368;36291;621641;290878;912519
2022.06_18-07-2022;Липецкая область;105_165_days;SputnikV;16830;6381;23211;621641;290878;912519
2022.06_18-07-2022;Липецкая область;165_195_days;AllVaccines;54168;23299;77467;621641;290878;912519
2022.06_18-07-2022;Липецкая область;165_195_days;CoviVac;393;46;439;621641;290878;912519
2022.06_18-07-2022;Липецкая область;165_195_days;EpiVacCorona;3500;1218;4718;621641;290878;912519
2022.06_18-07-2022;Липецкая область;165_195_days;SputnikLite;10622;9677;20299;621641;290878;912519
2022.06_18-07-2022;Липецкая область;165_195_days;SputnikV;39653;12358;52011;621641;290878;912519
2022.06_18-07-2022;Липецкая область;21_45_days;AllVaccines;5683;4587;10270;621641;290878;912519
2022.06_18-07-2022;Липецкая область;21_45_days;CoviVac;186;67;253;621641;290878;912519
2022.06_18-07-2022;Липецкая область;21_45_days;EpiVacCorona;792;1172;1964;621641;290878;912519
2022.06_18-07-2022;Липецкая область;21_45_days;SputnikLite;93;57;150;621641;290878;912519
2022.06_18-07-2022;Липецкая область;21_45_days;SputnikV;4612;3291;7903;621641;290878;912519
2022.06_18-07-2022;Липецкая область;45_75_days;AllVaccines;10135;6821;16956;621641;290878;912519
2022.06_18-07-2022;Липецкая область;45_75_days;CoviVac;576;66;642;621641;290878;912519
2022.06_18-07-2022;Липецкая область;45_75_days;EpiVacCorona;868;859;1727;621641;290878;912519
2022.06_18-07-2022;Липецкая область;45_75_days;SputnikLite;633;305;938;621641;290878;912519
2022.06_18-07-2022;Липецкая область;45_75_days;SputnikV;8058;5591;13649;621641;290878;912519
2022.06_18-07-2022;Липецкая область;75_90_days;AllVaccines;7299;3339;10638;621641;290878;912519
2022.06_18-07-2022;Липецкая область;75_90_days;CoviVac;341;39;380;621641;290878;912519
2022.06_18-07-2022;Липецкая область;75_90_days;EpiVacCorona;379;344;723;621641;290878;912519
2022.06_18-07-2022;Липецкая область;75_90_days;SputnikLite;1009;514;1523;621641;290878;912519
2022.06_18-07-2022;Липецкая область;75_90_days;SputnikV;5570;2442;8012;621641;290878;912519
2022.06_18-07-2022;Липецкая область;90_105_days;AllVaccines;5598;2088;7686;621641;290878;912519
2022.06_18-07-2022;Липецкая область;90_105_days;CoviVac;427;13;440;621641;290878;912519
2022.06_18-07-2022;Липецкая область;90_105_days;EpiVacCorona;604;341;945;621641;290878;912519
2022.06_18-07-2022;Липецкая область;90_105_days;SputnikLite;1239;530;1769;621641;290878;912519
2022.06_18-07-2022;Липецкая область;90_105_days;SputnikV;3328;1204;4532;621641;290878;912519
2022.06_18-07-2022;Магаданская область;105_165_days;AllVaccines;9508;2608;12116;83196;26810;110006
2022.06_18-07-2022;Магаданская область;105_165_days;CoviVac;275;45;320;83196;26810;110006
2022.06_18-07-2022;Магаданская область;105_165_days;EpiVacCorona;510;122;632;83196;26810;110006
2022.06_18-07-2022;Магаданская область;105_165_days;SputnikLite;6144;1787;7931;83196;26810;110006
2022.06_18-07-2022;Магаданская область;105_165_days;SputnikV;2579;654;3233;83196;26810;110006
2022.06_18-07-2022;Магаданская область;165_195_days;AllVaccines;8213;2070;10283;83196;26810;110006
2022.06_18-07-2022;Магаданская область;165_195_days;CoviVac;79;9;88;83196;26810;110006
2022.06_18-07-2022;Магаданская область;165_195_days;EpiVacCorona;948;113;1061;83196;26810;110006
2022.06_18-07-2022;Магаданская область;165_195_days;SputnikLite;3498;1202;4700;83196;26810;110006
2022.06_18-07-2022;Магаданская область;165_195_days;SputnikV;3688;746;4434;83196;26810;110006
2022.06_18-07-2022;Магаданская область;21_45_days;AllVaccines;1008;284;1292;83196;26810;110006
2022.06_18-07-2022;Магаданская область;21_45_days;EpiVacCorona;28;7;35;83196;26810;110006
2022.06_18-07-2022;Магаданская область;21_45_days;SputnikLite;780;223;1003;83196;26810;110006
2022.06_18-07-2022;Магаданская область;21_45_days;SputnikV;200;54;254;83196;26810;110006
2022.06_18-07-2022;Магаданская область;45_75_days;AllVaccines;1239;409;1648;83196;26810;110006
2022.06_18-07-2022;Магаданская область;45_75_days;CoviVac;1;0;1;83196;26810;110006
2022.06_18-07-2022;Магаданская область;45_75_days;EpiVacCorona;29;10;39;83196;26810;110006
2022.06_18-07-2022;Магаданская область;45_75_days;SputnikLite;916;315;1231;83196;26810;110006
2022.06_18-07-2022;Магаданская область;45_75_days;SputnikV;293;84;377;83196;26810;110006
2022.06_18-07-2022;Магаданская область;75_90_days;AllVaccines;724;256;980;83196;26810;110006
2022.06_18-07-2022;Магаданская область;75_90_days;CoviVac;2;0;2;83196;26810;110006
2022.06_18-07-2022;Магаданская область;75_90_days;EpiVacCorona;37;8;45;83196;26810;110006
2022.06_18-07-2022;Магаданская область;75_90_days;SputnikLite;459;168;627;83196;26810;110006
2022.06_18-07-2022;Магаданская область;75_90_days;SputnikV;226;80;306;83196;26810;110006
2022.06_18-07-2022;Магаданская область;90_105_days;AllVaccines;960;289;1249;83196;26810;110006
2022.06_18-07-2022;Магаданская область;90_105_days;CoviVac;5;4;9;83196;26810;110006
2022.06_18-07-2022;Магаданская область;90_105_days;EpiVacCorona;40;11;51;83196;26810;110006
2022.06_18-07-2022;Магаданская область;90_105_days;SputnikLite;514;169;683;83196;26810;110006
2022.06_18-07-2022;Магаданская область;90_105_days;SputnikV;401;105;506;83196;26810;110006
2022.06_18-07-2022;Московская область;105_165_days;AllVaccines;333014;138757;471771;4485323;1674471;6159794
2022.06_18-07-2022;Московская область;105_165_days;CoviVac;2774;901;3675;4485323;1674471;6159794
2022.06_18-07-2022;Московская область;105_165_days;EpiVacCorona;4497;2889;7386;4485323;1674471;6159794
2022.06_18-07-2022;Московская область;105_165_days;SputnikLite;173336;86262;259598;4485323;1674471;6159794
2022.06_18-07-2022;Московская область;105_165_days;SputnikV;152407;48705;201112;4485323;1674471;6159794
2022.06_18-07-2022;Московская область;165_195_days;AllVaccines;276360;133223;409583;4485323;1674471;6159794
2022.06_18-07-2022;Московская область;165_195_days;CoviVac;3760;1443;5203;4485323;1674471;6159794
2022.06_18-07-2022;Московская область;165_195_days;EpiVacCorona;4702;3761;8463;4485323;1674471;6159794
2022.06_18-07-2022;Московская область;165_195_days;SputnikLite;54721;46480;101201;4485323;1674471;6159794
2022.06_18-07-2022;Московская область;165_195_days;SputnikV;213177;81539;294716;4485323;1674471;6159794
2022.06_18-07-2022;Московская область;21_45_days;AllVaccines;26366;15783;42149;4485323;1674471;6159794
2022.06_18-07-2022;Московская область;21_45_days;CoviVac;184;83;267;4485323;1674471;6159794
2022.06_18-07-2022;Московская область;21_45_days;EpiVacCorona;1287;802;2089;4485323;1674471;6159794
2022.06_18-07-2022;Московская область;21_45_days;SputnikLite;9784;7177;16961;4485323;1674471;6159794
2022.06_18-07-2022;Московская область;21_45_days;SputnikV;15111;7721;22832;4485323;1674471;6159794
2022.06_18-07-2022;Московская область;45_75_days;AllVaccines;38018;20669;58687;4485323;1674471;6159794
2022.06_18-07-2022;Московская область;45_75_days;CoviVac;463;126;589;4485323;1674471;6159794
2022.06_18-07-2022;Московская область;45_75_days;EpiVacCorona;1511;1180;2691;4485323;1674471;6159794
2022.06_18-07-2022;Московская область;45_75_days;SputnikLite;15045;10394;25439;4485323;1674471;6159794
2022.06_18-07-2022;Московская область;45_75_days;SputnikV;20999;8969;29968;4485323;1674471;6159794
2022.06_18-07-2022;Московская область;75_90_days;AllVaccines;28789;12393;41182;4485323;1674471;6159794
2022.06_18-07-2022;Московская область;75_90_days;CoviVac;388;115;503;4485323;1674471;6159794
2022.06_18-07-2022;Московская область;75_90_days;EpiVacCorona;695;498;1193;4485323;1674471;6159794
2022.06_18-07-2022;Московская область;75_90_days;SputnikLite;10372;5809;16181;4485323;1674471;6159794
2022.06_18-07-2022;Московская область;75_90_days;SputnikV;17334;5971;23305;4485323;1674471;6159794
2022.06_18-07-2022;Московская область;90_105_days;AllVaccines;40041;15700;55741;4485323;1674471;6159794
2022.06_18-07-2022;Московская область;90_105_days;CoviVac;355;102;457;4485323;1674471;6159794
2022.06_18-07-2022;Московская область;90_105_days;EpiVacCorona;835;645;1480;4485323;1674471;6159794
2022.06_18-07-2022;Московская область;90_105_days;SputnikLite;13936;8255;22191;4485323;1674471;6159794
2022.06_18-07-2022;Московская область;90_105_days;SputnikV;24915;6698;31613;4485323;1674471;6159794
2022.06_18-07-2022;Мурманская область;105_165_days;AllVaccines;34522;13142;47664;436555;144366;580921
2022.06_18-07-2022;Мурманская область;105_165_days;CoviVac;534;80;614;436555;144366;580921
2022.06_18-07-2022;Мурманская область;105_165_days;EpiVacCorona;606;255;861;436555;144366;580921
2022.06_18-07-2022;Мурманская область;105_165_days;SputnikLite;20254;8579;28833;436555;144366;580921
2022.06_18-07-2022;Мурманская область;105_165_days;SputnikV;13128;4228;17356;436555;144366;580921
2022.06_18-07-2022;Мурманская область;165_195_days;AllVaccines;44276;14216;58492;436555;144366;580921
2022.06_18-07-2022;Мурманская область;165_195_days;CoviVac;813;83;896;436555;144366;580921
2022.06_18-07-2022;Мурманская область;165_195_days;EpiVacCorona;2075;619;2694;436555;144366;580921
2022.06_18-07-2022;Мурманская область;165_195_days;SputnikLite;16594;6669;23263;436555;144366;580921
2022.06_18-07-2022;Мурманская область;165_195_days;SputnikV;24794;6845;31639;436555;144366;580921
2022.06_18-07-2022;Мурманская область;21_45_days;AllVaccines;2752;1125;3877;436555;144366;580921
2022.06_18-07-2022;Мурманская область;21_45_days;CoviVac;39;11;50;436555;144366;580921
2022.06_18-07-2022;Мурманская область;21_45_days;EpiVacCorona;55;14;69;436555;144366;580921
2022.06_18-07-2022;Мурманская область;21_45_days;SputnikLite;970;322;1292;436555;144366;580921
2022.06_18-07-2022;Мурманская область;21_45_days;SputnikV;1688;778;2466;436555;144366;580921
2022.06_18-07-2022;Мурманская область;45_75_days;AllVaccines;5680;2367;8047;436555;144366;580921
2022.06_18-07-2022;Мурманская область;45_75_days;CoviVac;183;48;231;436555;144366;580921
2022.06_18-07-2022;Мурманская область;45_75_days;EpiVacCorona;37;33;70;436555;144366;580921
2022.06_18-07-2022;Мурманская область;45_75_days;SputnikLite;3297;1486;4783;436555;144366;580921
2022.06_18-07-2022;Мурманская область;45_75_days;SputnikV;2163;800;2963;436555;144366;580921
2022.06_18-07-2022;Мурманская область;75_90_days;AllVaccines;3549;1384;4933;436555;144366;580921
2022.06_18-07-2022;Мурманская область;75_90_days;CoviVac;132;31;163;436555;144366;580921
2022.06_18-07-2022;Мурманская область;75_90_days;EpiVacCorona;22;6;28;436555;144366;580921
2022.06_18-07-2022;Мурманская область;75_90_days;SputnikLite;1914;857;2771;436555;144366;580921
2022.06_18-07-2022;Мурманская область;75_90_days;SputnikV;1481;490;1971;436555;144366;580921
2022.06_18-07-2022;Мурманская область;90_105_days;AllVaccines;4013;1492;5505;436555;144366;580921
2022.06_18-07-2022;Мурманская область;90_105_days;CoviVac;66;5;71;436555;144366;580921
2022.06_18-07-2022;Мурманская область;90_105_days;EpiVacCorona;20;8;28;436555;144366;580921
2022.06_18-07-2022;Мурманская область;90_105_days;SputnikLite;2093;942;3035;436555;144366;580921
2022.06_18-07-2022;Мурманская область;90_105_days;SputnikV;1834;537;2371;436555;144366;580921
2022.06_18-07-2022;Ненецкий автономный округ;105_165_days;AllVaccines;1476;565;2041;24931;7449;32380
2022.06_18-07-2022;Ненецкий автономный округ;105_165_days;EpiVacCorona;14;2;16;24931;7449;32380
2022.06_18-07-2022;Ненецкий автономный округ;105_165_days;SputnikLite;1198;513;1711;24931;7449;32380
2022.06_18-07-2022;Ненецкий автономный округ;105_165_days;SputnikV;264;50;314;24931;7449;32380
2022.06_18-07-2022;Ненецкий автономный округ;165_195_days;AllVaccines;1662;569;2231;24931;7449;32380
2022.06_18-07-2022;Ненецкий автономный округ;165_195_days;EpiVacCorona;81;12;93;24931;7449;32380
2022.06_18-07-2022;Ненецкий автономный округ;165_195_days;SputnikLite;1149;484;1633;24931;7449;32380
2022.06_18-07-2022;Ненецкий автономный округ;165_195_days;SputnikV;432;73;505;24931;7449;32380
2022.06_18-07-2022;Ненецкий автономный округ;21_45_days;AllVaccines;225;118;343;24931;7449;32380
2022.06_18-07-2022;Ненецкий автономный округ;21_45_days;SputnikLite;210;110;320;24931;7449;32380
2022.06_18-07-2022;Ненецкий автономный округ;21_45_days;SputnikV;15;8;23;24931;7449;32380
2022.06_18-07-2022;Ненецкий автономный округ;45_75_days;AllVaccines;248;118;366;24931;7449;32380
2022.06_18-07-2022;Ненецкий автономный округ;45_75_days;EpiVacCorona;4;0;4;24931;7449;32380
2022.06_18-07-2022;Ненецкий автономный округ;45_75_days;SputnikLite;226;111;337;24931;7449;32380
2022.06_18-07-2022;Ненецкий автономный округ;45_75_days;SputnikV;18;7;25;24931;7449;32380
2022.06_18-07-2022;Ненецкий автономный округ;75_90_days;AllVaccines;123;76;199;24931;7449;32380
2022.06_18-07-2022;Ненецкий автономный округ;75_90_days;EpiVacCorona;3;0;3;24931;7449;32380
2022.06_18-07-2022;Ненецкий автономный округ;75_90_days;SputnikLite;109;65;174;24931;7449;32380
2022.06_18-07-2022;Ненецкий автономный округ;75_90_days;SputnikV;11;11;22;24931;7449;32380
2022.06_18-07-2022;Ненецкий автономный округ;90_105_days;AllVaccines;162;72;234;24931;7449;32380
2022.06_18-07-2022;Ненецкий автономный округ;90_105_days;SputnikLite;130;60;190;24931;7449;32380
2022.06_18-07-2022;Ненецкий автономный округ;90_105_days;SputnikV;32;12;44;24931;7449;32380
2022.06_18-07-2022;Нижегородская область;105_165_days;AllVaccines;106021;57121;163142;1769909;800663;2570572
2022.06_18-07-2022;Нижегородская область;105_165_days;CoviVac;1394;448;1842;1769909;800663;2570572
2022.06_18-07-2022;Нижегородская область;105_165_days;EpiVacCorona;3568;2706;6274;1769909;800663;2570572
2022.06_18-07-2022;Нижегородская область;105_165_days;SputnikLite;64722;35328;100050;1769909;800663;2570572
2022.06_18-07-2022;Нижегородская область;105_165_days;SputnikV;36337;18639;54976;1769909;800663;2570572
2022.06_18-07-2022;Нижегородская область;165_195_days;AllVaccines;136384;84891;221275;1769909;800663;2570572
2022.06_18-07-2022;Нижегородская область;165_195_days;CoviVac;376;86;462;1769909;800663;2570572
2022.06_18-07-2022;Нижегородская область;165_195_days;EpiVacCorona;3419;2674;6093;1769909;800663;2570572
2022.06_18-07-2022;Нижегородская область;165_195_days;SputnikLite;39703;33925;73628;1769909;800663;2570572
2022.06_18-07-2022;Нижегородская область;165_195_days;SputnikV;92886;48206;141092;1769909;800663;2570572
2022.06_18-07-2022;Нижегородская область;21_45_days;AllVaccines;5423;5270;10693;1769909;800663;2570572
2022.06_18-07-2022;Нижегородская область;21_45_days;CoviVac;128;44;172;1769909;800663;2570572
2022.06_18-07-2022;Нижегородская область;21_45_days;EpiVacCorona;441;276;717;1769909;800663;2570572
2022.06_18-07-2022;Нижегородская область;21_45_days;SputnikLite;447;244;691;1769909;800663;2570572
2022.06_18-07-2022;Нижегородская область;21_45_days;SputnikV;4407;4706;9113;1769909;800663;2570572
2022.06_18-07-2022;Нижегородская область;45_75_days;AllVaccines;9546;8360;17906;1769909;800663;2570572
2022.06_18-07-2022;Нижегородская область;45_75_days;CoviVac;257;71;328;1769909;800663;2570572
2022.06_18-07-2022;Нижегородская область;45_75_days;EpiVacCorona;754;547;1301;1769909;800663;2570572
2022.06_18-07-2022;Нижегородская область;45_75_days;SputnikLite;1297;842;2139;1769909;800663;2570572
2022.06_18-07-2022;Нижегородская область;45_75_days;SputnikV;7238;6900;14138;1769909;800663;2570572
2022.06_18-07-2022;Нижегородская область;75_90_days;AllVaccines;7064;4043;11107;1769909;800663;2570572
2022.06_18-07-2022;Нижегородская область;75_90_days;CoviVac;187;99;286;1769909;800663;2570572
2022.06_18-07-2022;Нижегородская область;75_90_days;EpiVacCorona;654;606;1260;1769909;800663;2570572
2022.06_18-07-2022;Нижегородская область;75_90_days;SputnikLite;1014;649;1663;1769909;800663;2570572
2022.06_18-07-2022;Нижегородская область;75_90_days;SputnikV;5209;2689;7898;1769909;800663;2570572
2022.06_18-07-2022;Нижегородская область;90_105_days;AllVaccines;8166;3709;11875;1769909;800663;2570572
2022.06_18-07-2022;Нижегородская область;90_105_days;CoviVac;282;52;334;1769909;800663;2570572
2022.06_18-07-2022;Нижегородская область;90_105_days;EpiVacCorona;508;323;831;1769909;800663;2570572
2022.06_18-07-2022;Нижегородская область;90_105_days;SputnikLite;1656;1030;2686;1769909;800663;2570572
2022.06_18-07-2022;Нижегородская область;90_105_days;SputnikV;5720;2304;8024;1769909;800663;2570572
2022.06_18-07-2022;Новгородская область;105_165_days;AllVaccines;16952;12373;29325;317276;158308;475584
2022.06_18-07-2022;Новгородская область;105_165_days;CoviVac;622;270;892;317276;158308;475584
2022.06_18-07-2022;Новгородская область;105_165_days;EpiVacCorona;1273;859;2132;317276;158308;475584
2022.06_18-07-2022;Новгородская область;105_165_days;SputnikLite;7532;5753;13285;317276;158308;475584
2022.06_18-07-2022;Новгородская область;105_165_days;SputnikV;7525;5491;13016;317276;158308;475584
2022.06_18-07-2022;Новгородская область;165_195_days;AllVaccines;21594;13881;35475;317276;158308;475584
2022.06_18-07-2022;Новгородская область;165_195_days;CoviVac;893;310;1203;317276;158308;475584
2022.06_18-07-2022;Новгородская область;165_195_days;EpiVacCorona;1943;1104;3047;317276;158308;475584
2022.06_18-07-2022;Новгородская область;165_195_days;SputnikLite;4833;4680;9513;317276;158308;475584
2022.06_18-07-2022;Новгородская область;165_195_days;SputnikV;13925;7787;21712;317276;158308;475584
2022.06_18-07-2022;Новгородская область;21_45_days;AllVaccines;1025;981;2006;317276;158308;475584
2022.06_18-07-2022;Новгородская область;21_45_days;CoviVac;78;22;100;317276;158308;475584
2022.06_18-07-2022;Новгородская область;21_45_days;EpiVacCorona;16;41;57;317276;158308;475584
2022.06_18-07-2022;Новгородская область;21_45_days;SputnikLite;343;312;655;317276;158308;475584
2022.06_18-07-2022;Новгородская область;21_45_days;SputnikV;588;606;1194;317276;158308;475584
2022.06_18-07-2022;Новгородская область;45_75_days;AllVaccines;1691;1548;3239;317276;158308;475584
2022.06_18-07-2022;Новгородская область;45_75_days;CoviVac;113;46;159;317276;158308;475584
2022.06_18-07-2022;Новгородская область;45_75_days;EpiVacCorona;72;92;164;317276;158308;475584
2022.06_18-07-2022;Новгородская область;45_75_days;SputnikLite;473;445;918;317276;158308;475584
2022.06_18-07-2022;Новгородская область;45_75_days;SputnikV;1033;965;1998;317276;158308;475584
2022.06_18-07-2022;Новгородская область;75_90_days;AllVaccines;1095;907;2002;317276;158308;475584
2022.06_18-07-2022;Новгородская область;75_90_days;CoviVac;108;35;143;317276;158308;475584
2022.06_18-07-2022;Новгородская область;75_90_days;EpiVacCorona;79;83;162;317276;158308;475584
2022.06_18-07-2022;Новгородская область;75_90_days;SputnikLite;212;207;419;317276;158308;475584
2022.06_18-07-2022;Новгородская область;75_90_days;SputnikV;696;582;1278;317276;158308;475584
2022.06_18-07-2022;Новгородская область;90_105_days;AllVaccines;1582;1179;2761;317276;158308;475584
2022.06_18-07-2022;Новгородская область;90_105_days;CoviVac;69;21;90;317276;158308;475584
2022.06_18-07-2022;Новгородская область;90_105_days;EpiVacCorona;80;83;163;317276;158308;475584
2022.06_18-07-2022;Новгородская область;90_105_days;SputnikLite;243;282;525;317276;158308;475584
2022.06_18-07-2022;Новгородская область;90_105_days;SputnikV;1190;793;1983;317276;158308;475584
2022.06_18-07-2022;Новосибирская область;105_165_days;AllVaccines;133437;70676;204113;1571829;624100;2195929
2022.06_18-07-2022;Новосибирская область;105_165_days;CoviVac;1964;475;2439;1571829;624100;2195929
2022.06_18-07-2022;Новосибирская область;105_165_days;EpiVacCorona;2955;1946;4901;1571829;624100;2195929
2022.06_18-07-2022;Новосибирская область;105_165_days;SputnikLite;73320;45080;118400;1571829;624100;2195929
2022.06_18-07-2022;Новосибирская область;105_165_days;SputnikV;55198;23175;78373;1571829;624100;2195929
2022.06_18-07-2022;Новосибирская область;165_195_days;AllVaccines;202569;81640;284209;1571829;624100;2195929
2022.06_18-07-2022;Новосибирская область;165_195_days;CoviVac;474;110;584;1571829;624100;2195929
2022.06_18-07-2022;Новосибирская область;165_195_days;EpiVacCorona;4803;1856;6659;1571829;624100;2195929
2022.06_18-07-2022;Новосибирская область;165_195_days;SputnikLite;43070;35195;78265;1571829;624100;2195929
2022.06_18-07-2022;Новосибирская область;165_195_days;SputnikV;154222;44479;198701;1571829;624100;2195929
2022.06_18-07-2022;Новосибирская область;21_45_days;AllVaccines;5398;4891;10289;1571829;624100;2195929
2022.06_18-07-2022;Новосибирская область;21_45_days;CoviVac;530;138;668;1571829;624100;2195929
2022.06_18-07-2022;Новосибирская область;21_45_days;EpiVacCorona;826;756;1582;1571829;624100;2195929
2022.06_18-07-2022;Новосибирская область;21_45_days;SputnikLite;224;88;312;1571829;624100;2195929
2022.06_18-07-2022;Новосибирская область;21_45_days;SputnikV;3818;3909;7727;1571829;624100;2195929
2022.06_18-07-2022;Новосибирская область;45_75_days;AllVaccines;9517;7176;16693;1571829;624100;2195929
2022.06_18-07-2022;Новосибирская область;45_75_days;CoviVac;520;159;679;1571829;624100;2195929
2022.06_18-07-2022;Новосибирская область;45_75_days;EpiVacCorona;523;519;1042;1571829;624100;2195929
2022.06_18-07-2022;Новосибирская область;45_75_days;SputnikLite;738;442;1180;1571829;624100;2195929
2022.06_18-07-2022;Новосибирская область;45_75_days;SputnikV;7736;6056;13792;1571829;624100;2195929
2022.06_18-07-2022;Новосибирская область;75_90_days;AllVaccines;6557;4231;10788;1571829;624100;2195929
2022.06_18-07-2022;Новосибирская область;75_90_days;CoviVac;435;130;565;1571829;624100;2195929
2022.06_18-07-2022;Новосибирская область;75_90_days;EpiVacCorona;313;161;474;1571829;624100;2195929
2022.06_18-07-2022;Новосибирская область;75_90_days;SputnikLite;339;175;514;1571829;624100;2195929
2022.06_18-07-2022;Новосибирская область;75_90_days;SputnikV;5470;3765;9235;1571829;624100;2195929
2022.06_18-07-2022;Новосибирская область;90_105_days;AllVaccines;6909;2935;9844;1571829;624100;2195929
2022.06_18-07-2022;Новосибирская область;90_105_days;CoviVac;189;41;230;1571829;624100;2195929
2022.06_18-07-2022;Новосибирская область;90_105_days;EpiVacCorona;245;123;368;1571829;624100;2195929
2022.06_18-07-2022;Новосибирская область;90_105_days;SputnikLite;564;384;948;1571829;624100;2195929
2022.06_18-07-2022;Новосибирская область;90_105_days;SputnikV;5911;2387;8298;1571829;624100;2195929
2022.06_18-07-2022;Омская область;105_165_days;AllVaccines;90284;38085;128369;1058291;431046;1489337
2022.06_18-07-2022;Омская область;105_165_days;CoviVac;1042;264;1306;1058291;431046;1489337
2022.06_18-07-2022;Омская область;105_165_days;EpiVacCorona;2988;1276;4264;1058291;431046;1489337
2022.06_18-07-2022;Омская область;105_165_days;SputnikLite;43802;19098;62900;1058291;431046;1489337
2022.06_18-07-2022;Омская область;105_165_days;SputnikV;42452;17447;59899;1058291;431046;1489337
2022.06_18-07-2022;Омская область;165_195_days;AllVaccines;117391;49105;166496;1058291;431046;1489337
2022.06_18-07-2022;Омская область;165_195_days;CoviVac;689;158;847;1058291;431046;1489337
2022.06_18-07-2022;Омская область;165_195_days;EpiVacCorona;3165;1162;4327;1058291;431046;1489337
2022.06_18-07-2022;Омская область;165_195_days;SputnikLite;24116;15429;39545;1058291;431046;1489337
2022.06_18-07-2022;Омская область;165_195_days;SputnikV;89421;32356;121777;1058291;431046;1489337
2022.06_18-07-2022;Омская область;21_45_days;AllVaccines;6530;3309;9839;1058291;431046;1489337
2022.06_18-07-2022;Омская область;21_45_days;CoviVac;290;74;364;1058291;431046;1489337
2022.06_18-07-2022;Омская область;21_45_days;EpiVacCorona;825;392;1217;1058291;431046;1489337
2022.06_18-07-2022;Омская область;21_45_days;SputnikLite;350;190;540;1058291;431046;1489337
2022.06_18-07-2022;Омская область;21_45_days;SputnikV;5065;2653;7718;1058291;431046;1489337
2022.06_18-07-2022;Омская область;45_75_days;AllVaccines;10128;4875;15003;1058291;431046;1489337
2022.06_18-07-2022;Омская область;45_75_days;CoviVac;517;137;654;1058291;431046;1489337
2022.06_18-07-2022;Омская область;45_75_days;EpiVacCorona;1098;465;1563;1058291;431046;1489337
2022.06_18-07-2022;Омская область;45_75_days;SputnikLite;1808;801;2609;1058291;431046;1489337
2022.06_18-07-2022;Омская область;45_75_days;SputnikV;6705;3472;10177;1058291;431046;1489337
2022.06_18-07-2022;Омская область;75_90_days;AllVaccines;8305;3353;11658;1058291;431046;1489337
2022.06_18-07-2022;Омская область;75_90_days;CoviVac;232;57;289;1058291;431046;1489337
2022.06_18-07-2022;Омская область;75_90_days;EpiVacCorona;657;295;952;1058291;431046;1489337
2022.06_18-07-2022;Омская область;75_90_days;SputnikLite;2304;858;3162;1058291;431046;1489337
2022.06_18-07-2022;Омская область;75_90_days;SputnikV;5112;2143;7255;1058291;431046;1489337
2022.06_18-07-2022;Омская область;90_105_days;AllVaccines;10140;3384;13524;1058291;431046;1489337
2022.06_18-07-2022;Омская область;90_105_days;CoviVac;213;34;247;1058291;431046;1489337
2022.06_18-07-2022;Омская область;90_105_days;EpiVacCorona;471;169;640;1058291;431046;1489337
2022.06_18-07-2022;Омская область;90_105_days;SputnikLite;3275;1062;4337;1058291;431046;1489337
2022.06_18-07-2022;Омская область;90_105_days;SputnikV;6181;2119;8300;1058291;431046;1489337
2022.06_18-07-2022;Оренбургская область;105_165_days;AllVaccines;120336;43693;164029;1068899;440686;1509585
2022.06_18-07-2022;Оренбургская область;105_165_days;CoviVac;1432;142;1574;1068899;440686;1509585
2022.06_18-07-2022;Оренбургская область;105_165_days;EpiVacCorona;4641;1808;6449;1068899;440686;1509585
2022.06_18-07-2022;Оренбургская область;105_165_days;SputnikLite;80930;29824;110754;1068899;440686;1509585
2022.06_18-07-2022;Оренбургская область;105_165_days;SputnikV;33333;11919;45252;1068899;440686;1509585
2022.06_18-07-2022;Оренбургская область;165_195_days;AllVaccines;78260;42458;120718;1068899;440686;1509585
2022.06_18-07-2022;Оренбургская область;165_195_days;CoviVac;949;144;1093;1068899;440686;1509585
2022.06_18-07-2022;Оренбургская область;165_195_days;EpiVacCorona;5172;2457;7629;1068899;440686;1509585
2022.06_18-07-2022;Оренбургская область;165_195_days;SputnikLite;25916;19288;45204;1068899;440686;1509585
2022.06_18-07-2022;Оренбургская область;165_195_days;SputnikV;46223;20569;66792;1068899;440686;1509585
2022.06_18-07-2022;Оренбургская область;21_45_days;AllVaccines;6036;3540;9576;1068899;440686;1509585
2022.06_18-07-2022;Оренбургская область;21_45_days;CoviVac;392;12;404;1068899;440686;1509585
2022.06_18-07-2022;Оренбургская область;21_45_days;EpiVacCorona;275;169;444;1068899;440686;1509585
2022.06_18-07-2022;Оренбургская область;21_45_days;SputnikLite;133;47;180;1068899;440686;1509585
2022.06_18-07-2022;Оренбургская область;21_45_days;SputnikV;5236;3312;8548;1068899;440686;1509585
2022.06_18-07-2022;Оренбургская область;45_75_days;AllVaccines;10478;5401;15879;1068899;440686;1509585
2022.06_18-07-2022;Оренбургская область;45_75_days;CoviVac;773;87;860;1068899;440686;1509585
2022.06_18-07-2022;Оренбургская область;45_75_days;EpiVacCorona;563;274;837;1068899;440686;1509585
2022.06_18-07-2022;Оренбургская область;45_75_days;SputnikLite;130;70;200;1068899;440686;1509585
2022.06_18-07-2022;Оренбургская область;45_75_days;SputnikV;9012;4970;13982;1068899;440686;1509585
2022.06_18-07-2022;Оренбургская область;75_90_days;AllVaccines;6330;2531;8861;1068899;440686;1509585
2022.06_18-07-2022;Оренбургская область;75_90_days;CoviVac;390;30;420;1068899;440686;1509585
2022.06_18-07-2022;Оренбургская область;75_90_days;EpiVacCorona;309;128;437;1068899;440686;1509585
2022.06_18-07-2022;Оренбургская область;75_90_days;SputnikLite;233;39;272;1068899;440686;1509585
2022.06_18-07-2022;Оренбургская область;75_90_days;SputnikV;5398;2334;7732;1068899;440686;1509585
2022.06_18-07-2022;Оренбургская область;90_105_days;AllVaccines;6264;1783;8047;1068899;440686;1509585
2022.06_18-07-2022;Оренбургская область;90_105_days;CoviVac;229;23;252;1068899;440686;1509585
2022.06_18-07-2022;Оренбургская область;90_105_days;EpiVacCorona;398;119;517;1068899;440686;1509585
2022.06_18-07-2022;Оренбургская область;90_105_days;SputnikLite;626;196;822;1068899;440686;1509585
2022.06_18-07-2022;Оренбургская область;90_105_days;SputnikV;5011;1445;6456;1068899;440686;1509585
2022.06_18-07-2022;Орловская область;105_165_days;AllVaccines;25640;14146;39786;398663;193123;591786
2022.06_18-07-2022;Орловская область;105_165_days;CoviVac;550;117;667;398663;193123;591786
2022.06_18-07-2022;Орловская область;105_165_days;EpiVacCorona;1051;447;1498;398663;193123;591786
2022.06_18-07-2022;Орловская область;105_165_days;SputnikLite;15406;9342;24748;398663;193123;591786
2022.06_18-07-2022;Орловская область;105_165_days;SputnikV;8633;4240;12873;398663;193123;591786
2022.06_18-07-2022;Орловская область;165_195_days;AllVaccines;46612;21002;67614;398663;193123;591786
2022.06_18-07-2022;Орловская область;165_195_days;CoviVac;1745;486;2231;398663;193123;591786
2022.06_18-07-2022;Орловская область;165_195_days;EpiVacCorona;733;328;1061;398663;193123;591786
2022.06_18-07-2022;Орловская область;165_195_days;SputnikLite;8054;7268;15322;398663;193123;591786
2022.06_18-07-2022;Орловская область;165_195_days;SputnikV;36080;12920;49000;398663;193123;591786
2022.06_18-07-2022;Орловская область;21_45_days;AllVaccines;1251;1002;2253;398663;193123;591786
2022.06_18-07-2022;Орловская область;21_45_days;CoviVac;3;0;3;398663;193123;591786
2022.06_18-07-2022;Орловская область;21_45_days;EpiVacCorona;95;25;120;398663;193123;591786
2022.06_18-07-2022;Орловская область;21_45_days;SputnikLite;98;66;164;398663;193123;591786
2022.06_18-07-2022;Орловская область;21_45_days;SputnikV;1055;911;1966;398663;193123;591786
2022.06_18-07-2022;Орловская область;45_75_days;AllVaccines;2494;1637;4131;398663;193123;591786
2022.06_18-07-2022;Орловская область;45_75_days;CoviVac;107;9;116;398663;193123;591786
2022.06_18-07-2022;Орловская область;45_75_days;EpiVacCorona;243;64;307;398663;193123;591786
2022.06_18-07-2022;Орловская область;45_75_days;SputnikLite;138;83;221;398663;193123;591786
2022.06_18-07-2022;Орловская область;45_75_days;SputnikV;2006;1481;3487;398663;193123;591786
2022.06_18-07-2022;Орловская область;75_90_days;AllVaccines;1561;840;2401;398663;193123;591786
2022.06_18-07-2022;Орловская область;75_90_days;CoviVac;82;13;95;398663;193123;591786
2022.06_18-07-2022;Орловская область;75_90_days;EpiVacCorona;155;72;227;398663;193123;591786
2022.06_18-07-2022;Орловская область;75_90_days;SputnikLite;134;77;211;398663;193123;591786
2022.06_18-07-2022;Орловская область;75_90_days;SputnikV;1190;678;1868;398663;193123;591786
2022.06_18-07-2022;Орловская область;90_105_days;AllVaccines;2117;765;2882;398663;193123;591786
2022.06_18-07-2022;Орловская область;90_105_days;CoviVac;66;10;76;398663;193123;591786
2022.06_18-07-2022;Орловская область;90_105_days;EpiVacCorona;219;38;257;398663;193123;591786
2022.06_18-07-2022;Орловская область;90_105_days;SputnikLite;227;97;324;398663;193123;591786
2022.06_18-07-2022;Орловская область;90_105_days;SputnikV;1605;620;2225;398663;193123;591786
2022.06_18-07-2022;Пензенская область;105_165_days;AllVaccines;64114;53788;117902;710438;350687;1061125
2022.06_18-07-2022;Пензенская область;105_165_days;CoviVac;727;328;1055;710438;350687;1061125
2022.06_18-07-2022;Пензенская область;105_165_days;EpiVacCorona;2627;5548;8175;710438;350687;1061125
2022.06_18-07-2022;Пензенская область;105_165_days;SputnikLite;38154;19489;57643;710438;350687;1061125
2022.06_18-07-2022;Пензенская область;105_165_days;SputnikV;22606;28423;51029;710438;350687;1061125
2022.06_18-07-2022;Пензенская область;165_195_days;AllVaccines;59225;42205;101430;710438;350687;1061125
2022.06_18-07-2022;Пензенская область;165_195_days;CoviVac;826;262;1088;710438;350687;1061125
2022.06_18-07-2022;Пензенская область;165_195_days;EpiVacCorona;1078;1226;2304;710438;350687;1061125
2022.06_18-07-2022;Пензенская область;165_195_days;SputnikLite;15759;10478;26237;710438;350687;1061125
2022.06_18-07-2022;Пензенская область;165_195_days;SputnikV;41562;30239;71801;710438;350687;1061125
2022.06_18-07-2022;Пензенская область;21_45_days;AllVaccines;12819;13717;26536;710438;350687;1061125
2022.06_18-07-2022;Пензенская область;21_45_days;CoviVac;5;2;7;710438;350687;1061125
2022.06_18-07-2022;Пензенская область;21_45_days;EpiVacCorona;1485;1791;3276;710438;350687;1061125
2022.06_18-07-2022;Пензенская область;21_45_days;SputnikLite;295;282;577;710438;350687;1061125
2022.06_18-07-2022;Пензенская область;21_45_days;SputnikV;11034;11642;22676;710438;350687;1061125
2022.06_18-07-2022;Пензенская область;45_75_days;AllVaccines;20081;33831;53912;710438;350687;1061125
2022.06_18-07-2022;Пензенская область;45_75_days;CoviVac;461;207;668;710438;350687;1061125
2022.06_18-07-2022;Пензенская область;45_75_days;EpiVacCorona;1357;2144;3501;710438;350687;1061125
2022.06_18-07-2022;Пензенская область;45_75_days;SputnikLite;659;423;1082;710438;350687;1061125
2022.06_18-07-2022;Пензенская область;45_75_days;SputnikV;17604;31057;48661;710438;350687;1061125
2022.06_18-07-2022;Пензенская область;75_90_days;AllVaccines;11452;21000;32452;710438;350687;1061125
2022.06_18-07-2022;Пензенская область;75_90_days;CoviVac;882;524;1406;710438;350687;1061125
2022.06_18-07-2022;Пензенская область;75_90_days;EpiVacCorona;927;2761;3688;710438;350687;1061125
2022.06_18-07-2022;Пензенская область;75_90_days;SputnikLite;1460;1071;2531;710438;350687;1061125
2022.06_18-07-2022;Пензенская область;75_90_days;SputnikV;8183;16644;24827;710438;350687;1061125
2022.06_18-07-2022;Пензенская область;90_105_days;AllVaccines;9561;10920;20481;710438;350687;1061125
2022.06_18-07-2022;Пензенская область;90_105_days;CoviVac;193;106;299;710438;350687;1061125
2022.06_18-07-2022;Пензенская область;90_105_days;EpiVacCorona;817;1856;2673;710438;350687;1061125
2022.06_18-07-2022;Пензенская область;90_105_days;SputnikLite;3493;1865;5358;710438;350687;1061125
2022.06_18-07-2022;Пензенская область;90_105_days;SputnikV;5058;7093;12151;710438;350687;1061125
2022.06_18-07-2022;Пермский край;105_165_days;AllVaccines;92540;49077;141617;1423011;574038;1997049
2022.06_18-07-2022;Пермский край;105_165_days;CoviVac;1669;331;2000;1423011;574038;1997049
2022.06_18-07-2022;Пермский край;105_165_days;EpiVacCorona;1789;874;2663;1423011;574038;1997049
2022.06_18-07-2022;Пермский край;105_165_days;SputnikLite;51901;32275;84176;1423011;574038;1997049
2022.06_18-07-2022;Пермский край;105_165_days;SputnikV;37181;15597;52778;1423011;574038;1997049
2022.06_18-07-2022;Пермский край;165_195_days;AllVaccines;132428;63502;195930;1423011;574038;1997049
2022.06_18-07-2022;Пермский край;165_195_days;CoviVac;1248;273;1521;1423011;574038;1997049
2022.06_18-07-2022;Пермский край;165_195_days;EpiVacCorona;1678;614;2292;1423011;574038;1997049
2022.06_18-07-2022;Пермский край;165_195_days;SputnikLite;29259;27215;56474;1423011;574038;1997049
2022.06_18-07-2022;Пермский край;165_195_days;SputnikV;100243;35400;135643;1423011;574038;1997049
2022.06_18-07-2022;Пермский край;21_45_days;AllVaccines;3860;3808;7668;1423011;574038;1997049
2022.06_18-07-2022;Пермский край;21_45_days;CoviVac;109;70;179;1423011;574038;1997049
2022.06_18-07-2022;Пермский край;21_45_days;EpiVacCorona;248;298;546;1423011;574038;1997049
2022.06_18-07-2022;Пермский край;21_45_days;SputnikLite;671;333;1004;1423011;574038;1997049
2022.06_18-07-2022;Пермский край;21_45_days;SputnikV;2832;3107;5939;1423011;574038;1997049
2022.06_18-07-2022;Пермский край;45_75_days;AllVaccines;6937;5913;12850;1423011;574038;1997049
2022.06_18-07-2022;Пермский край;45_75_days;CoviVac;280;151;431;1423011;574038;1997049
2022.06_18-07-2022;Пермский край;45_75_days;EpiVacCorona;342;306;648;1423011;574038;1997049
2022.06_18-07-2022;Пермский край;45_75_days;SputnikLite;1173;602;1775;1423011;574038;1997049
2022.06_18-07-2022;Пермский край;45_75_days;SputnikV;5142;4854;9996;1423011;574038;1997049
2022.06_18-07-2022;Пермский край;75_90_days;AllVaccines;5336;3257;8593;1423011;574038;1997049
2022.06_18-07-2022;Пермский край;75_90_days;CoviVac;201;44;245;1423011;574038;1997049
2022.06_18-07-2022;Пермский край;75_90_days;EpiVacCorona;334;186;520;1423011;574038;1997049
2022.06_18-07-2022;Пермский край;75_90_days;SputnikLite;733;475;1208;1423011;574038;1997049
2022.06_18-07-2022;Пермский край;75_90_days;SputnikV;4068;2552;6620;1423011;574038;1997049
2022.06_18-07-2022;Пермский край;90_105_days;AllVaccines;6902;3146;10048;1423011;574038;1997049
2022.06_18-07-2022;Пермский край;90_105_days;CoviVac;150;22;172;1423011;574038;1997049
2022.06_18-07-2022;Пермский край;90_105_days;EpiVacCorona;230;133;363;1423011;574038;1997049
2022.06_18-07-2022;Пермский край;90_105_days;SputnikLite;2025;876;2901;1423011;574038;1997049
2022.06_18-07-2022;Пермский край;90_105_days;SputnikV;4497;2115;6612;1423011;574038;1997049
2022.06_18-07-2022;Приморский край;105_165_days;AllVaccines;78324;39064;117388;1086430;416518;1502948
2022.06_18-07-2022;Приморский край;105_165_days;CoviVac;619;71;690;1086430;416518;1502948
2022.06_18-07-2022;Приморский край;105_165_days;EpiVacCorona;3032;1490;4522;1086430;416518;1502948
2022.06_18-07-2022;Приморский край;105_165_days;SputnikLite;42842;27241;70083;1086430;416518;1502948
2022.06_18-07-2022;Приморский край;105_165_days;SputnikV;31831;10262;42093;1086430;416518;1502948
2022.06_18-07-2022;Приморский край;165_195_days;AllVaccines;159007;48223;207230;1086430;416518;1502948
2022.06_18-07-2022;Приморский край;165_195_days;CoviVac;1069;87;1156;1086430;416518;1502948
2022.06_18-07-2022;Приморский край;165_195_days;EpiVacCorona;1828;963;2791;1086430;416518;1502948
2022.06_18-07-2022;Приморский край;165_195_days;SputnikLite;23791;18492;42283;1086430;416518;1502948
2022.06_18-07-2022;Приморский край;165_195_days;SputnikV;132319;28681;161000;1086430;416518;1502948
2022.06_18-07-2022;Приморский край;21_45_days;AllVaccines;5166;3719;8885;1086430;416518;1502948
2022.06_18-07-2022;Приморский край;21_45_days;CoviVac;192;34;226;1086430;416518;1502948
2022.06_18-07-2022;Приморский край;21_45_days;EpiVacCorona;358;374;732;1086430;416518;1502948
2022.06_18-07-2022;Приморский край;21_45_days;SputnikLite;2589;1866;4455;1086430;416518;1502948
2022.06_18-07-2022;Приморский край;21_45_days;SputnikV;2027;1445;3472;1086430;416518;1502948
2022.06_18-07-2022;Приморский край;45_75_days;AllVaccines;7556;4010;11566;1086430;416518;1502948
2022.06_18-07-2022;Приморский край;45_75_days;CoviVac;440;72;512;1086430;416518;1502948
2022.06_18-07-2022;Приморский край;45_75_days;EpiVacCorona;655;552;1207;1086430;416518;1502948
2022.06_18-07-2022;Приморский край;45_75_days;SputnikLite;4011;2184;6195;1086430;416518;1502948
2022.06_18-07-2022;Приморский край;45_75_days;SputnikV;2450;1202;3652;1086430;416518;1502948
2022.06_18-07-2022;Приморский край;75_90_days;AllVaccines;7134;3099;10233;1086430;416518;1502948
2022.06_18-07-2022;Приморский край;75_90_days;CoviVac;132;4;136;1086430;416518;1502948
2022.06_18-07-2022;Приморский край;75_90_days;EpiVacCorona;592;315;907;1086430;416518;1502948
2022.06_18-07-2022;Приморский край;75_90_days;SputnikLite;3742;1851;5593;1086430;416518;1502948
2022.06_18-07-2022;Приморский край;75_90_days;SputnikV;2668;929;3597;1086430;416518;1502948
2022.06_18-07-2022;Приморский край;90_105_days;AllVaccines;8536;3384;11920;1086430;416518;1502948
2022.06_18-07-2022;Приморский край;90_105_days;CoviVac;164;13;177;1086430;416518;1502948
2022.06_18-07-2022;Приморский край;90_105_days;EpiVacCorona;857;473;1330;1086430;416518;1502948
2022.06_18-07-2022;Приморский край;90_105_days;SputnikLite;4472;2057;6529;1086430;416518;1502948
2022.06_18-07-2022;Приморский край;90_105_days;SputnikV;3043;841;3884;1086430;416518;1502948
2022.06_18-07-2022;Псковская область;105_165_days;AllVaccines;24634;13304;37938;337881;166663;504544
2022.06_18-07-2022;Псковская область;105_165_days;CoviVac;613;63;676;337881;166663;504544
2022.06_18-07-2022;Псковская область;105_165_days;EpiVacCorona;1115;696;1811;337881;166663;504544
2022.06_18-07-2022;Псковская область;105_165_days;SputnikLite;10778;7052;17830;337881;166663;504544
2022.06_18-07-2022;Псковская область;105_165_days;SputnikV;12128;5493;17621;337881;166663;504544
2022.06_18-07-2022;Псковская область;165_195_days;AllVaccines;24462;14156;38618;337881;166663;504544
2022.06_18-07-2022;Псковская область;165_195_days;CoviVac;451;67;518;337881;166663;504544
2022.06_18-07-2022;Псковская область;165_195_days;EpiVacCorona;884;426;1310;337881;166663;504544
2022.06_18-07-2022;Псковская область;165_195_days;SputnikLite;6796;6515;13311;337881;166663;504544
2022.06_18-07-2022;Псковская область;165_195_days;SputnikV;16331;7148;23479;337881;166663;504544
2022.06_18-07-2022;Псковская область;21_45_days;AllVaccines;1290;2259;3549;337881;166663;504544
2022.06_18-07-2022;Псковская область;21_45_days;CoviVac;52;16;68;337881;166663;504544
2022.06_18-07-2022;Псковская область;21_45_days;EpiVacCorona;115;85;200;337881;166663;504544
2022.06_18-07-2022;Псковская область;21_45_days;SputnikLite;101;17;118;337881;166663;504544
2022.06_18-07-2022;Псковская область;21_45_days;SputnikV;1022;2141;3163;337881;166663;504544
2022.06_18-07-2022;Псковская область;45_75_days;AllVaccines;1936;1643;3579;337881;166663;504544
2022.06_18-07-2022;Псковская область;45_75_days;CoviVac;59;18;77;337881;166663;504544
2022.06_18-07-2022;Псковская область;45_75_days;EpiVacCorona;177;102;279;337881;166663;504544
2022.06_18-07-2022;Псковская область;45_75_days;SputnikLite;83;19;102;337881;166663;504544
2022.06_18-07-2022;Псковская область;45_75_days;SputnikV;1617;1504;3121;337881;166663;504544
2022.06_18-07-2022;Псковская область;75_90_days;AllVaccines;1468;784;2252;337881;166663;504544
2022.06_18-07-2022;Псковская область;75_90_days;CoviVac;25;2;27;337881;166663;504544
2022.06_18-07-2022;Псковская область;75_90_days;EpiVacCorona;93;40;133;337881;166663;504544
2022.06_18-07-2022;Псковская область;75_90_days;SputnikLite;25;9;34;337881;166663;504544
2022.06_18-07-2022;Псковская область;75_90_days;SputnikV;1325;733;2058;337881;166663;504544
2022.06_18-07-2022;Псковская область;90_105_days;AllVaccines;1965;853;2818;337881;166663;504544
2022.06_18-07-2022;Псковская область;90_105_days;CoviVac;77;5;82;337881;166663;504544
2022.06_18-07-2022;Псковская область;90_105_days;EpiVacCorona;122;75;197;337881;166663;504544
2022.06_18-07-2022;Псковская область;90_105_days;SputnikLite;126;89;215;337881;166663;504544
2022.06_18-07-2022;Псковская область;90_105_days;SputnikV;1640;684;2324;337881;166663;504544
2022.06_18-07-2022;РФ;105_165_days;AllVaccines;6399994;2895696;9295690;82332898;33454776;115787674
2022.06_18-07-2022;РФ;105_165_days;CoviVac;75789;18441;94230;82332898;33454776;115787674
2022.06_18-07-2022;РФ;105_165_days;EpiVacCorona;231592;128473;360065;82332898;33454776;115787674
2022.06_18-07-2022;РФ;105_165_days;SputnikLite;3456784;1597689;5054473;82332898;33454776;115787674
2022.06_18-07-2022;РФ;105_165_days;SputnikV;2635829;1151093;3786922;82332898;33454776;115787674
2022.06_18-07-2022;РФ;165_195_days;AllVaccines;7056876;3215448;10272324;82332898;33454776;115787674
2022.06_18-07-2022;РФ;165_195_days;CoviVac;91442;19844;111286;82332898;33454776;115787674
2022.06_18-07-2022;РФ;165_195_days;EpiVacCorona;201482;94941;296423;82332898;33454776;115787674
2022.06_18-07-2022;РФ;165_195_days;SputnikLite;1820948;1226535;3047483;82332898;33454776;115787674
2022.06_18-07-2022;РФ;165_195_days;SputnikV;4943004;1874128;6817132;82332898;33454776;115787674
2022.06_18-07-2022;РФ;21_45_days;AllVaccines;497449;336242;833691;82332898;33454776;115787674
2022.06_18-07-2022;РФ;21_45_days;CoviVac;20172;7529;27701;82332898;33454776;115787674
2022.06_18-07-2022;РФ;21_45_days;EpiVacCorona;32560;24474;57034;82332898;33454776;115787674
2022.06_18-07-2022;РФ;21_45_days;SputnikLite;76755;42883;119638;82332898;33454776;115787674
2022.06_18-07-2022;РФ;21_45_days;SputnikV;367962;261356;629318;82332898;33454776;115787674
2022.06_18-07-2022;РФ;45_75_days;AllVaccines;755654;482252;1237906;82332898;33454776;115787674
2022.06_18-07-2022;РФ;45_75_days;CoviVac;36817;12717;49534;82332898;33454776;115787674
2022.06_18-07-2022;РФ;45_75_days;EpiVacCorona;59752;40315;100067;82332898;33454776;115787674
2022.06_18-07-2022;РФ;45_75_days;SputnikLite;154464;78259;232723;82332898;33454776;115787674
2022.06_18-07-2022;РФ;45_75_days;SputnikV;504621;350961;855582;82332898;33454776;115787674
2022.06_18-07-2022;РФ;75_90_days;AllVaccines;551962;312375;864337;82332898;33454776;115787674
2022.06_18-07-2022;РФ;75_90_days;CoviVac;18098;5728;23826;82332898;33454776;115787674
2022.06_18-07-2022;РФ;75_90_days;EpiVacCorona;45141;29398;74539;82332898;33454776;115787674
2022.06_18-07-2022;РФ;75_90_days;SputnikLite;121552;58007;179559;82332898;33454776;115787674
2022.06_18-07-2022;РФ;75_90_days;SputnikV;367171;219242;586413;82332898;33454776;115787674
2022.06_18-07-2022;РФ;90_105_days;AllVaccines;637092;287272;924364;82332898;33454776;115787674
2022.06_18-07-2022;РФ;90_105_days;CoviVac;14600;3870;18470;82332898;33454776;115787674
2022.06_18-07-2022;РФ;90_105_days;EpiVacCorona;37176;21168;58344;82332898;33454776;115787674
2022.06_18-07-2022;РФ;90_105_days;SputnikLite;172753;78918;251671;82332898;33454776;115787674
2022.06_18-07-2022;РФ;90_105_days;SputnikV;412563;183316;595879;82332898;33454776;115787674
2022.06_18-07-2022;Республика Адыгея;105_165_days;AllVaccines;16264;7729;23993;256368;104563;360931
2022.06_18-07-2022;Республика Адыгея;105_165_days;CoviVac;106;24;130;256368;104563;360931
2022.06_18-07-2022;Республика Адыгея;105_165_days;EpiVacCorona;496;197;693;256368;104563;360931
2022.06_18-07-2022;Республика Адыгея;105_165_days;SputnikLite;10487;5012;15499;256368;104563;360931
2022.06_18-07-2022;Республика Адыгея;105_165_days;SputnikV;5175;2496;7671;256368;104563;360931
2022.06_18-07-2022;Республика Адыгея;165_195_days;AllVaccines;13734;7231;20965;256368;104563;360931
2022.06_18-07-2022;Республика Адыгея;165_195_days;CoviVac;143;42;185;256368;104563;360931
2022.06_18-07-2022;Республика Адыгея;165_195_days;EpiVacCorona;418;277;695;256368;104563;360931
2022.06_18-07-2022;Республика Адыгея;165_195_days;SputnikLite;5427;3456;8883;256368;104563;360931
2022.06_18-07-2022;Республика Адыгея;165_195_days;SputnikV;7746;3456;11202;256368;104563;360931
2022.06_18-07-2022;Республика Адыгея;21_45_days;AllVaccines;492;538;1030;256368;104563;360931
2022.06_18-07-2022;Республика Адыгея;21_45_days;CoviVac;5;0;5;256368;104563;360931
2022.06_18-07-2022;Республика Адыгея;21_45_days;EpiVacCorona;7;6;13;256368;104563;360931
2022.06_18-07-2022;Республика Адыгея;21_45_days;SputnikLite;265;211;476;256368;104563;360931
2022.06_18-07-2022;Республика Адыгея;21_45_days;SputnikV;215;321;536;256368;104563;360931
2022.06_18-07-2022;Республика Адыгея;45_75_days;AllVaccines;1272;900;2172;256368;104563;360931
2022.06_18-07-2022;Республика Адыгея;45_75_days;CoviVac;3;0;3;256368;104563;360931
2022.06_18-07-2022;Республика Адыгея;45_75_days;EpiVacCorona;4;4;8;256368;104563;360931
2022.06_18-07-2022;Республика Адыгея;45_75_days;SputnikLite;791;507;1298;256368;104563;360931
2022.06_18-07-2022;Республика Адыгея;45_75_days;SputnikV;474;389;863;256368;104563;360931
2022.06_18-07-2022;Республика Адыгея;75_90_days;AllVaccines;854;651;1505;256368;104563;360931
2022.06_18-07-2022;Республика Адыгея;75_90_days;CoviVac;7;2;9;256368;104563;360931
2022.06_18-07-2022;Республика Адыгея;75_90_days;EpiVacCorona;2;5;7;256368;104563;360931
2022.06_18-07-2022;Республика Адыгея;75_90_days;SputnikLite;555;428;983;256368;104563;360931
2022.06_18-07-2022;Республика Адыгея;75_90_days;SputnikV;290;216;506;256368;104563;360931
2022.06_18-07-2022;Республика Адыгея;90_105_days;AllVaccines;1202;732;1934;256368;104563;360931
2022.06_18-07-2022;Республика Адыгея;90_105_days;CoviVac;11;0;11;256368;104563;360931
2022.06_18-07-2022;Республика Адыгея;90_105_days;EpiVacCorona;7;4;11;256368;104563;360931
2022.06_18-07-2022;Республика Адыгея;90_105_days;SputnikLite;685;445;1130;256368;104563;360931
2022.06_18-07-2022;Республика Адыгея;90_105_days;SputnikV;499;283;782;256368;104563;360931
2022.06_18-07-2022;Республика Алтай;105_165_days;AllVaccines;13685;4314;17999;117210;36468;153678
2022.06_18-07-2022;Республика Алтай;105_165_days;CoviVac;277;60;337;117210;36468;153678
2022.06_18-07-2022;Республика Алтай;105_165_days;EpiVacCorona;490;144;634;117210;36468;153678
2022.06_18-07-2022;Республика Алтай;105_165_days;SputnikLite;8647;2463;11110;117210;36468;153678
2022.06_18-07-2022;Республика Алтай;105_165_days;SputnikV;4271;1647;5918;117210;36468;153678
2022.06_18-07-2022;Республика Алтай;165_195_days;AllVaccines;10758;3893;14651;117210;36468;153678
2022.06_18-07-2022;Республика Алтай;165_195_days;CoviVac;185;33;218;117210;36468;153678
2022.06_18-07-2022;Республика Алтай;165_195_days;EpiVacCorona;265;89;354;117210;36468;153678
2022.06_18-07-2022;Республика Алтай;165_195_days;SputnikLite;6228;2418;8646;117210;36468;153678
2022.06_18-07-2022;Республика Алтай;165_195_days;SputnikV;4080;1353;5433;117210;36468;153678
2022.06_18-07-2022;Республика Алтай;21_45_days;AllVaccines;737;576;1313;117210;36468;153678
2022.06_18-07-2022;Республика Алтай;21_45_days;CoviVac;41;19;60;117210;36468;153678
2022.06_18-07-2022;Республика Алтай;21_45_days;EpiVacCorona;49;41;90;117210;36468;153678
2022.06_18-07-2022;Республика Алтай;21_45_days;SputnikLite;141;64;205;117210;36468;153678
2022.06_18-07-2022;Республика Алтай;21_45_days;SputnikV;506;452;958;117210;36468;153678
2022.06_18-07-2022;Республика Алтай;45_75_days;AllVaccines;1779;1076;2855;117210;36468;153678
2022.06_18-07-2022;Республика Алтай;45_75_days;CoviVac;216;130;346;117210;36468;153678
2022.06_18-07-2022;Республика Алтай;45_75_days;EpiVacCorona;284;84;368;117210;36468;153678
2022.06_18-07-2022;Республика Алтай;45_75_days;SputnikLite;345;185;530;117210;36468;153678
2022.06_18-07-2022;Республика Алтай;45_75_days;SputnikV;934;677;1611;117210;36468;153678
2022.06_18-07-2022;Республика Алтай;75_90_days;AllVaccines;1370;539;1909;117210;36468;153678
2022.06_18-07-2022;Республика Алтай;75_90_days;CoviVac;89;17;106;117210;36468;153678
2022.06_18-07-2022;Республика Алтай;75_90_days;EpiVacCorona;127;28;155;117210;36468;153678
2022.06_18-07-2022;Республика Алтай;75_90_days;SputnikLite;482;190;672;117210;36468;153678
2022.06_18-07-2022;Республика Алтай;75_90_days;SputnikV;672;304;976;117210;36468;153678
2022.06_18-07-2022;Республика Алтай;90_105_days;AllVaccines;1116;386;1502;117210;36468;153678
2022.06_18-07-2022;Республика Алтай;90_105_days;CoviVac;46;5;51;117210;36468;153678
2022.06_18-07-2022;Республика Алтай;90_105_days;EpiVacCorona;65;15;80;117210;36468;153678
2022.06_18-07-2022;Республика Алтай;90_105_days;SputnikLite;509;127;636;117210;36468;153678
2022.06_18-07-2022;Республика Алтай;90_105_days;SputnikV;496;239;735;117210;36468;153678
2022.06_18-07-2022;Республика Башкортостан;105_165_days;AllVaccines;189647;81620;271267;2235962;869874;3105836
2022.06_18-07-2022;Республика Башкортостан;105_165_days;CoviVac;2410;477;2887;2235962;869874;3105836
2022.06_18-07-2022;Республика Башкортостан;105_165_days;EpiVacCorona;9771;6265;16036;2235962;869874;3105836
2022.06_18-07-2022;Республика Башкортостан;105_165_days;SputnikLite;84526;31414;115940;2235962;869874;3105836
2022.06_18-07-2022;Республика Башкортостан;105_165_days;SputnikV;92940;43464;136404;2235962;869874;3105836
2022.06_18-07-2022;Республика Башкортостан;165_195_days;AllVaccines;208403;80843;289246;2235962;869874;3105836
2022.06_18-07-2022;Республика Башкортостан;165_195_days;CoviVac;7015;1837;8852;2235962;869874;3105836
2022.06_18-07-2022;Республика Башкортостан;165_195_days;EpiVacCorona;5076;2568;7644;2235962;869874;3105836
2022.06_18-07-2022;Республика Башкортостан;165_195_days;SputnikLite;50314;24856;75170;2235962;869874;3105836
2022.06_18-07-2022;Республика Башкортостан;165_195_days;SputnikV;145998;51582;197580;2235962;869874;3105836
2022.06_18-07-2022;Республика Башкортостан;21_45_days;AllVaccines;29302;21874;51176;2235962;869874;3105836
2022.06_18-07-2022;Республика Башкортостан;21_45_days;CoviVac;2040;682;2722;2235962;869874;3105836
2022.06_18-07-2022;Республика Башкортостан;21_45_days;EpiVacCorona;2073;1506;3579;2235962;869874;3105836
2022.06_18-07-2022;Республика Башкортостан;21_45_days;SputnikLite;4539;1084;5623;2235962;869874;3105836
2022.06_18-07-2022;Республика Башкортостан;21_45_days;SputnikV;20650;18602;39252;2235962;869874;3105836
2022.06_18-07-2022;Республика Башкортостан;45_75_days;AllVaccines;32826;20791;53617;2235962;869874;3105836
2022.06_18-07-2022;Республика Башкортостан;45_75_days;CoviVac;4035;2267;6302;2235962;869874;3105836
2022.06_18-07-2022;Республика Башкортостан;45_75_days;EpiVacCorona;3131;2545;5676;2235962;869874;3105836
2022.06_18-07-2022;Республика Башкортостан;45_75_days;SputnikLite;6986;1832;8818;2235962;869874;3105836
2022.06_18-07-2022;Республика Башкортостан;45_75_days;SputnikV;18674;14147;32821;2235962;869874;3105836
2022.06_18-07-2022;Республика Башкортостан;75_90_days;AllVaccines;26243;15880;42123;2235962;869874;3105836
2022.06_18-07-2022;Республика Башкортостан;75_90_days;CoviVac;889;290;1179;2235962;869874;3105836
2022.06_18-07-2022;Республика Башкортостан;75_90_days;EpiVacCorona;3995;3684;7679;2235962;869874;3105836
2022.06_18-07-2022;Республика Башкортостан;75_90_days;SputnikLite;7676;2597;10273;2235962;869874;3105836
2022.06_18-07-2022;Республика Башкортостан;75_90_days;SputnikV;13683;9309;22992;2235962;869874;3105836
2022.06_18-07-2022;Республика Башкортостан;90_105_days;AllVaccines;24764;12005;36769;2235962;869874;3105836
2022.06_18-07-2022;Республика Башкортостан;90_105_days;CoviVac;132;69;201;2235962;869874;3105836
2022.06_18-07-2022;Республика Башкортостан;90_105_days;EpiVacCorona;1726;759;2485;2235962;869874;3105836
2022.06_18-07-2022;Республика Башкортостан;90_105_days;SputnikLite;6055;2133;8188;2235962;869874;3105836
2022.06_18-07-2022;Республика Башкортостан;90_105_days;SputnikV;16851;9044;25895;2235962;869874;3105836
2022.06_18-07-2022;Республика Бурятия;105_165_days;AllVaccines;58245;22913;81158;542372;176777;719149
2022.06_18-07-2022;Республика Бурятия;105_165_days;CoviVac;458;157;615;542372;176777;719149
2022.06_18-07-2022;Республика Бурятия;105_165_days;EpiVacCorona;1925;1049;2974;542372;176777;719149
2022.06_18-07-2022;Республика Бурятия;105_165_days;SputnikLite;28726;10985;39711;542372;176777;719149
2022.06_18-07-2022;Республика Бурятия;105_165_days;SputnikV;27136;10722;37858;542372;176777;719149
2022.06_18-07-2022;Республика Бурятия;165_195_days;AllVaccines;51105;21386;72491;542372;176777;719149
2022.06_18-07-2022;Республика Бурятия;165_195_days;CoviVac;753;230;983;542372;176777;719149
2022.06_18-07-2022;Республика Бурятия;165_195_days;EpiVacCorona;494;325;819;542372;176777;719149
2022.06_18-07-2022;Республика Бурятия;165_195_days;SputnikLite;16531;9363;25894;542372;176777;719149
2022.06_18-07-2022;Республика Бурятия;165_195_days;SputnikV;33327;11468;44795;542372;176777;719149
2022.06_18-07-2022;Республика Бурятия;21_45_days;AllVaccines;3258;1925;5183;542372;176777;719149
2022.06_18-07-2022;Республика Бурятия;21_45_days;CoviVac;337;137;474;542372;176777;719149
2022.06_18-07-2022;Республика Бурятия;21_45_days;EpiVacCorona;401;211;612;542372;176777;719149
2022.06_18-07-2022;Республика Бурятия;21_45_days;SputnikLite;129;31;160;542372;176777;719149
2022.06_18-07-2022;Республика Бурятия;21_45_days;SputnikV;2391;1546;3937;542372;176777;719149
2022.06_18-07-2022;Республика Бурятия;45_75_days;AllVaccines;6202;2875;9077;542372;176777;719149
2022.06_18-07-2022;Республика Бурятия;45_75_days;CoviVac;553;194;747;542372;176777;719149
2022.06_18-07-2022;Республика Бурятия;45_75_days;EpiVacCorona;1083;701;1784;542372;176777;719149
2022.06_18-07-2022;Республика Бурятия;45_75_days;SputnikLite;537;181;718;542372;176777;719149
2022.06_18-07-2022;Республика Бурятия;45_75_days;SputnikV;4029;1799;5828;542372;176777;719149
2022.06_18-07-2022;Республика Бурятия;75_90_days;AllVaccines;5475;2005;7480;542372;176777;719149
2022.06_18-07-2022;Республика Бурятия;75_90_days;CoviVac;200;89;289;542372;176777;719149
2022.06_18-07-2022;Республика Бурятия;75_90_days;EpiVacCorona;573;281;854;542372;176777;719149
2022.06_18-07-2022;Республика Бурятия;75_90_days;SputnikLite;1287;374;1661;542372;176777;719149
2022.06_18-07-2022;Республика Бурятия;75_90_days;SputnikV;3415;1261;4676;542372;176777;719149
2022.06_18-07-2022;Республика Бурятия;90_105_days;AllVaccines;6839;2557;9396;542372;176777;719149
2022.06_18-07-2022;Республика Бурятия;90_105_days;CoviVac;91;18;109;542372;176777;719149
2022.06_18-07-2022;Республика Бурятия;90_105_days;EpiVacCorona;411;155;566;542372;176777;719149
2022.06_18-07-2022;Республика Бурятия;90_105_days;SputnikLite;2001;765;2766;542372;176777;719149
2022.06_18-07-2022;Республика Бурятия;90_105_days;SputnikV;4336;1619;5955;542372;176777;719149
2022.06_18-07-2022;Республика Дагестан;105_165_days;AllVaccines;251012;68884;319896;1856109;394621;2250730
2022.06_18-07-2022;Республика Дагестан;105_165_days;CoviVac;4272;835;5107;1856109;394621;2250730
2022.06_18-07-2022;Республика Дагестан;105_165_days;EpiVacCorona;23278;5052;28330;1856109;394621;2250730
2022.06_18-07-2022;Республика Дагестан;105_165_days;SputnikLite;33788;7943;41731;1856109;394621;2250730
2022.06_18-07-2022;Республика Дагестан;105_165_days;SputnikV;189674;55054;244728;1856109;394621;2250730
2022.06_18-07-2022;Республика Дагестан;165_195_days;AllVaccines;91499;15873;107372;1856109;394621;2250730
2022.06_18-07-2022;Республика Дагестан;165_195_days;CoviVac;1174;204;1378;1856109;394621;2250730
2022.06_18-07-2022;Республика Дагестан;165_195_days;EpiVacCorona;7137;1147;8284;1856109;394621;2250730
2022.06_18-07-2022;Республика Дагестан;165_195_days;SputnikLite;25101;4733;29834;1856109;394621;2250730
2022.06_18-07-2022;Республика Дагестан;165_195_days;SputnikV;58087;9789;67876;1856109;394621;2250730
2022.06_18-07-2022;Республика Дагестан;21_45_days;AllVaccines;62682;20885;83567;1856109;394621;2250730
2022.06_18-07-2022;Республика Дагестан;21_45_days;CoviVac;270;66;336;1856109;394621;2250730
2022.06_18-07-2022;Республика Дагестан;21_45_days;EpiVacCorona;835;195;1030;1856109;394621;2250730
2022.06_18-07-2022;Республика Дагестан;21_45_days;SputnikLite;518;94;612;1856109;394621;2250730
2022.06_18-07-2022;Республика Дагестан;21_45_days;SputnikV;61059;20530;81589;1856109;394621;2250730
2022.06_18-07-2022;Республика Дагестан;45_75_days;AllVaccines;57508;17625;75133;1856109;394621;2250730
2022.06_18-07-2022;Республика Дагестан;45_75_days;CoviVac;2652;792;3444;1856109;394621;2250730
2022.06_18-07-2022;Республика Дагестан;45_75_days;EpiVacCorona;4377;2510;6887;1856109;394621;2250730
2022.06_18-07-2022;Республика Дагестан;45_75_days;SputnikLite;326;33;359;1856109;394621;2250730
2022.06_18-07-2022;Республика Дагестан;45_75_days;SputnikV;50153;14290;64443;1856109;394621;2250730
2022.06_18-07-2022;Республика Дагестан;75_90_days;AllVaccines;51768;17641;69409;1856109;394621;2250730
2022.06_18-07-2022;Республика Дагестан;75_90_days;CoviVac;2312;1153;3465;1856109;394621;2250730
2022.06_18-07-2022;Республика Дагестан;75_90_days;EpiVacCorona;7789;3209;10998;1856109;394621;2250730
2022.06_18-07-2022;Республика Дагестан;75_90_days;SputnikLite;2776;760;3536;1856109;394621;2250730
2022.06_18-07-2022;Республика Дагестан;75_90_days;SputnikV;38891;12519;51410;1856109;394621;2250730
2022.06_18-07-2022;Республика Дагестан;90_105_days;AllVaccines;47795;9866;57661;1856109;394621;2250730
2022.06_18-07-2022;Республика Дагестан;90_105_days;CoviVac;1636;267;1903;1856109;394621;2250730
2022.06_18-07-2022;Республика Дагестан;90_105_days;EpiVacCorona;6062;984;7046;1856109;394621;2250730
2022.06_18-07-2022;Республика Дагестан;90_105_days;SputnikLite;1761;461;2222;1856109;394621;2250730
2022.06_18-07-2022;Республика Дагестан;90_105_days;SputnikV;38336;8154;46490;1856109;394621;2250730
2022.06_18-07-2022;Республика Ингушетия;105_165_days;AllVaccines;41567;7122;48689;295583;61477;357060
2022.06_18-07-2022;Республика Ингушетия;105_165_days;CoviVac;80;34;114;295583;61477;357060
2022.06_18-07-2022;Республика Ингушетия;105_165_days;EpiVacCorona;3007;577;3584;295583;61477;357060
2022.06_18-07-2022;Республика Ингушетия;105_165_days;SputnikLite;21204;3389;24593;295583;61477;357060
2022.06_18-07-2022;Республика Ингушетия;105_165_days;SputnikV;17276;3122;20398;295583;61477;357060
2022.06_18-07-2022;Республика Ингушетия;165_195_days;AllVaccines;44148;9850;53998;295583;61477;357060
2022.06_18-07-2022;Республика Ингушетия;165_195_days;CoviVac;340;159;499;295583;61477;357060
2022.06_18-07-2022;Республика Ингушетия;165_195_days;EpiVacCorona;588;148;736;295583;61477;357060
2022.06_18-07-2022;Республика Ингушетия;165_195_days;SputnikLite;22812;4787;27599;295583;61477;357060
2022.06_18-07-2022;Республика Ингушетия;165_195_days;SputnikV;20408;4756;25164;295583;61477;357060
2022.06_18-07-2022;Республика Ингушетия;21_45_days;AllVaccines;7669;1101;8770;295583;61477;357060
2022.06_18-07-2022;Республика Ингушетия;21_45_days;CoviVac;432;64;496;295583;61477;357060
2022.06_18-07-2022;Республика Ингушетия;21_45_days;EpiVacCorona;134;25;159;295583;61477;357060
2022.06_18-07-2022;Республика Ингушетия;21_45_days;SputnikLite;2;0;2;295583;61477;357060
2022.06_18-07-2022;Республика Ингушетия;21_45_days;SputnikV;7101;1012;8113;295583;61477;357060
2022.06_18-07-2022;Республика Ингушетия;45_75_days;AllVaccines;10758;1655;12413;295583;61477;357060
2022.06_18-07-2022;Республика Ингушетия;45_75_days;CoviVac;363;49;412;295583;61477;357060
2022.06_18-07-2022;Республика Ингушетия;45_75_days;EpiVacCorona;5274;870;6144;295583;61477;357060
2022.06_18-07-2022;Республика Ингушетия;45_75_days;SputnikLite;34;5;39;295583;61477;357060
2022.06_18-07-2022;Республика Ингушетия;45_75_days;SputnikV;5087;731;5818;295583;61477;357060
2022.06_18-07-2022;Республика Ингушетия;75_90_days;AllVaccines;4380;804;5184;295583;61477;357060
2022.06_18-07-2022;Республика Ингушетия;75_90_days;CoviVac;59;2;61;295583;61477;357060
2022.06_18-07-2022;Республика Ингушетия;75_90_days;EpiVacCorona;1771;368;2139;295583;61477;357060
2022.06_18-07-2022;Республика Ингушетия;75_90_days;SputnikLite;1136;179;1315;295583;61477;357060
2022.06_18-07-2022;Республика Ингушетия;75_90_days;SputnikV;1414;255;1669;295583;61477;357060
2022.06_18-07-2022;Республика Ингушетия;90_105_days;AllVaccines;3007;401;3408;295583;61477;357060
2022.06_18-07-2022;Республика Ингушетия;90_105_days;CoviVac;11;1;12;295583;61477;357060
2022.06_18-07-2022;Республика Ингушетия;90_105_days;EpiVacCorona;552;85;637;295583;61477;357060
2022.06_18-07-2022;Республика Ингушетия;90_105_days;SputnikLite;781;88;869;295583;61477;357060
2022.06_18-07-2022;Республика Ингушетия;90_105_days;SputnikV;1663;227;1890;295583;61477;357060
2022.06_18-07-2022;Республика Калмыкия;105_165_days;AllVaccines;10535;4428;14963;150440;54890;205330
2022.06_18-07-2022;Республика Калмыкия;105_165_days;CoviVac;114;41;155;150440;54890;205330
2022.06_18-07-2022;Республика Калмыкия;105_165_days;EpiVacCorona;392;169;561;150440;54890;205330
2022.06_18-07-2022;Республика Калмыкия;105_165_days;SputnikLite;8768;3659;12427;150440;54890;205330
2022.06_18-07-2022;Республика Калмыкия;105_165_days;SputnikV;1261;559;1820;150440;54890;205330
2022.06_18-07-2022;Республика Калмыкия;165_195_days;AllVaccines;10251;4255;14506;150440;54890;205330
2022.06_18-07-2022;Республика Калмыкия;165_195_days;CoviVac;293;68;361;150440;54890;205330
2022.06_18-07-2022;Республика Калмыкия;165_195_days;EpiVacCorona;129;87;216;150440;54890;205330
2022.06_18-07-2022;Республика Калмыкия;165_195_days;SputnikLite;7333;3189;10522;150440;54890;205330
2022.06_18-07-2022;Республика Калмыкия;165_195_days;SputnikV;2496;911;3407;150440;54890;205330
2022.06_18-07-2022;Республика Калмыкия;21_45_days;AllVaccines;1077;883;1960;150440;54890;205330
2022.06_18-07-2022;Республика Калмыкия;21_45_days;CoviVac;1;4;5;150440;54890;205330
2022.06_18-07-2022;Республика Калмыкия;21_45_days;EpiVacCorona;139;48;187;150440;54890;205330
2022.06_18-07-2022;Республика Калмыкия;21_45_days;SputnikLite;762;624;1386;150440;54890;205330
2022.06_18-07-2022;Республика Калмыкия;21_45_days;SputnikV;175;207;382;150440;54890;205330
2022.06_18-07-2022;Республика Калмыкия;45_75_days;AllVaccines;1576;1236;2812;150440;54890;205330
2022.06_18-07-2022;Республика Калмыкия;45_75_days;CoviVac;4;0;4;150440;54890;205330
2022.06_18-07-2022;Республика Калмыкия;45_75_days;EpiVacCorona;35;21;56;150440;54890;205330
2022.06_18-07-2022;Республика Калмыкия;45_75_days;SputnikLite;1253;1014;2267;150440;54890;205330
2022.06_18-07-2022;Республика Калмыкия;45_75_days;SputnikV;284;201;485;150440;54890;205330
2022.06_18-07-2022;Республика Калмыкия;75_90_days;AllVaccines;645;467;1112;150440;54890;205330
2022.06_18-07-2022;Республика Калмыкия;75_90_days;CoviVac;4;1;5;150440;54890;205330
2022.06_18-07-2022;Республика Калмыкия;75_90_days;EpiVacCorona;25;24;49;150440;54890;205330
2022.06_18-07-2022;Республика Калмыкия;75_90_days;SputnikLite;489;353;842;150440;54890;205330
2022.06_18-07-2022;Республика Калмыкия;75_90_days;SputnikV;127;89;216;150440;54890;205330
2022.06_18-07-2022;Республика Калмыкия;90_105_days;AllVaccines;763;441;1204;150440;54890;205330
2022.06_18-07-2022;Республика Калмыкия;90_105_days;CoviVac;1;0;1;150440;54890;205330
2022.06_18-07-2022;Республика Калмыкия;90_105_days;EpiVacCorona;31;9;40;150440;54890;205330
2022.06_18-07-2022;Республика Калмыкия;90_105_days;SputnikLite;553;342;895;150440;54890;205330
2022.06_18-07-2022;Республика Калмыкия;90_105_days;SputnikV;178;90;268;150440;54890;205330
2022.06_18-07-2022;Республика Карелия;105_165_days;AllVaccines;25127;13710;38837;334874;149526;484400
2022.06_18-07-2022;Республика Карелия;105_165_days;CoviVac;609;140;749;334874;149526;484400
2022.06_18-07-2022;Республика Карелия;105_165_days;EpiVacCorona;939;635;1574;334874;149526;484400
2022.06_18-07-2022;Республика Карелия;105_165_days;SputnikLite;14335;7500;21835;334874;149526;484400
2022.06_18-07-2022;Республика Карелия;105_165_days;SputnikV;9244;5435;14679;334874;149526;484400
2022.06_18-07-2022;Республика Карелия;165_195_days;AllVaccines;24228;14820;39048;334874;149526;484400
2022.06_18-07-2022;Республика Карелия;165_195_days;CoviVac;572;122;694;334874;149526;484400
2022.06_18-07-2022;Республика Карелия;165_195_days;EpiVacCorona;1006;539;1545;334874;149526;484400
2022.06_18-07-2022;Республика Карелия;165_195_days;SputnikLite;8335;6624;14959;334874;149526;484400
2022.06_18-07-2022;Республика Карелия;165_195_days;SputnikV;14315;7535;21850;334874;149526;484400
2022.06_18-07-2022;Республика Карелия;21_45_days;AllVaccines;1931;2717;4648;334874;149526;484400
2022.06_18-07-2022;Республика Карелия;21_45_days;CoviVac;2;0;2;334874;149526;484400
2022.06_18-07-2022;Республика Карелия;21_45_days;EpiVacCorona;69;145;214;334874;149526;484400
2022.06_18-07-2022;Республика Карелия;21_45_days;SputnikLite;837;983;1820;334874;149526;484400
2022.06_18-07-2022;Республика Карелия;21_45_days;SputnikV;1023;1589;2612;334874;149526;484400
2022.06_18-07-2022;Республика Карелия;45_75_days;AllVaccines;2815;2994;5809;334874;149526;484400
2022.06_18-07-2022;Республика Карелия;45_75_days;CoviVac;24;16;40;334874;149526;484400
2022.06_18-07-2022;Республика Карелия;45_75_days;EpiVacCorona;55;73;128;334874;149526;484400
2022.06_18-07-2022;Республика Карелия;45_75_days;SputnikLite;1451;1511;2962;334874;149526;484400
2022.06_18-07-2022;Республика Карелия;45_75_days;SputnikV;1285;1394;2679;334874;149526;484400
2022.06_18-07-2022;Республика Карелия;75_90_days;AllVaccines;2495;1945;4440;334874;149526;484400
2022.06_18-07-2022;Республика Карелия;75_90_days;CoviVac;37;6;43;334874;149526;484400
2022.06_18-07-2022;Республика Карелия;75_90_days;EpiVacCorona;72;47;119;334874;149526;484400
2022.06_18-07-2022;Республика Карелия;75_90_days;SputnikLite;1371;1191;2562;334874;149526;484400
2022.06_18-07-2022;Республика Карелия;75_90_days;SputnikV;1015;701;1716;334874;149526;484400
2022.06_18-07-2022;Республика Карелия;90_105_days;AllVaccines;3744;2274;6018;334874;149526;484400
2022.06_18-07-2022;Республика Карелия;90_105_days;CoviVac;41;12;53;334874;149526;484400
2022.06_18-07-2022;Республика Карелия;90_105_days;EpiVacCorona;105;69;174;334874;149526;484400
2022.06_18-07-2022;Республика Карелия;90_105_days;SputnikLite;2160;1375;3535;334874;149526;484400
2022.06_18-07-2022;Республика Карелия;90_105_days;SputnikV;1438;818;2256;334874;149526;484400
2022.06_18-07-2022;Республика Коми;105_165_days;AllVaccines;32649;14475;47124;465210;166370;631580
2022.06_18-07-2022;Республика Коми;105_165_days;CoviVac;520;120;640;465210;166370;631580
2022.06_18-07-2022;Республика Коми;105_165_days;EpiVacCorona;1017;506;1523;465210;166370;631580
2022.06_18-07-2022;Республика Коми;105_165_days;SputnikLite;20091;7955;28046;465210;166370;631580
2022.06_18-07-2022;Республика Коми;105_165_days;SputnikV;11021;5894;16915;465210;166370;631580
2022.06_18-07-2022;Республика Коми;165_195_days;AllVaccines;29363;14553;43916;465210;166370;631580
2022.06_18-07-2022;Республика Коми;165_195_days;CoviVac;399;99;498;465210;166370;631580
2022.06_18-07-2022;Республика Коми;165_195_days;EpiVacCorona;948;416;1364;465210;166370;631580
2022.06_18-07-2022;Республика Коми;165_195_days;SputnikLite;11301;6589;17890;465210;166370;631580
2022.06_18-07-2022;Республика Коми;165_195_days;SputnikV;16715;7449;24164;465210;166370;631580
2022.06_18-07-2022;Республика Коми;21_45_days;AllVaccines;2033;1479;3512;465210;166370;631580
2022.06_18-07-2022;Республика Коми;21_45_days;CoviVac;13;0;13;465210;166370;631580
2022.06_18-07-2022;Республика Коми;21_45_days;EpiVacCorona;123;76;199;465210;166370;631580
2022.06_18-07-2022;Республика Коми;21_45_days;SputnikLite;262;127;389;465210;166370;631580
2022.06_18-07-2022;Республика Коми;21_45_days;SputnikV;1635;1276;2911;465210;166370;631580
2022.06_18-07-2022;Республика Коми;45_75_days;AllVaccines;3515;1651;5166;465210;166370;631580
2022.06_18-07-2022;Республика Коми;45_75_days;CoviVac;255;60;315;465210;166370;631580
2022.06_18-07-2022;Республика Коми;45_75_days;EpiVacCorona;135;82;217;465210;166370;631580
2022.06_18-07-2022;Республика Коми;45_75_days;SputnikLite;1140;454;1594;465210;166370;631580
2022.06_18-07-2022;Республика Коми;45_75_days;SputnikV;1985;1055;3040;465210;166370;631580
2022.06_18-07-2022;Республика Коми;75_90_days;AllVaccines;3417;1354;4771;465210;166370;631580
2022.06_18-07-2022;Республика Коми;75_90_days;CoviVac;69;41;110;465210;166370;631580
2022.06_18-07-2022;Республика Коми;75_90_days;EpiVacCorona;84;27;111;465210;166370;631580
2022.06_18-07-2022;Республика Коми;75_90_days;SputnikLite;1651;654;2305;465210;166370;631580
2022.06_18-07-2022;Республика Коми;75_90_days;SputnikV;1613;632;2245;465210;166370;631580
2022.06_18-07-2022;Республика Коми;90_105_days;AllVaccines;5045;1905;6950;465210;166370;631580
2022.06_18-07-2022;Республика Коми;90_105_days;CoviVac;64;17;81;465210;166370;631580
2022.06_18-07-2022;Республика Коми;90_105_days;EpiVacCorona;128;32;160;465210;166370;631580
2022.06_18-07-2022;Республика Коми;90_105_days;SputnikLite;2340;821;3161;465210;166370;631580
2022.06_18-07-2022;Республика Коми;90_105_days;SputnikV;2513;1035;3548;465210;166370;631580
2022.06_18-07-2022;Республика Крым;105_165_days;AllVaccines;83255;43909;127164;1036087;480146;1516233
2022.06_18-07-2022;Республика Крым;105_165_days;CoviVac;759;254;1013;1036087;480146;1516233
2022.06_18-07-2022;Республика Крым;105_165_days;EpiVacCorona;4393;2511;6904;1036087;480146;1516233
2022.06_18-07-2022;Республика Крым;105_165_days;SputnikLite;47541;30156;77697;1036087;480146;1516233
2022.06_18-07-2022;Республика Крым;105_165_days;SputnikV;30562;10988;41550;1036087;480146;1516233
2022.06_18-07-2022;Республика Крым;165_195_days;AllVaccines;126425;62219;188644;1036087;480146;1516233
2022.06_18-07-2022;Республика Крым;165_195_days;CoviVac;1010;346;1356;1036087;480146;1516233
2022.06_18-07-2022;Республика Крым;165_195_days;EpiVacCorona;2667;1325;3992;1036087;480146;1516233
2022.06_18-07-2022;Республика Крым;165_195_days;SputnikLite;32315;32701;65016;1036087;480146;1516233
2022.06_18-07-2022;Республика Крым;165_195_days;SputnikV;90433;27847;118280;1036087;480146;1516233
2022.06_18-07-2022;Республика Крым;21_45_days;AllVaccines;5094;3079;8173;1036087;480146;1516233
2022.06_18-07-2022;Республика Крым;21_45_days;CoviVac;434;102;536;1036087;480146;1516233
2022.06_18-07-2022;Республика Крым;21_45_days;EpiVacCorona;371;242;613;1036087;480146;1516233
2022.06_18-07-2022;Республика Крым;21_45_days;SputnikLite;247;59;306;1036087;480146;1516233
2022.06_18-07-2022;Республика Крым;21_45_days;SputnikV;4042;2676;6718;1036087;480146;1516233
2022.06_18-07-2022;Республика Крым;45_75_days;AllVaccines;9745;5913;15658;1036087;480146;1516233
2022.06_18-07-2022;Республика Крым;45_75_days;CoviVac;643;241;884;1036087;480146;1516233
2022.06_18-07-2022;Республика Крым;45_75_days;EpiVacCorona;681;511;1192;1036087;480146;1516233
2022.06_18-07-2022;Республика Крым;45_75_days;SputnikLite;506;86;592;1036087;480146;1516233
2022.06_18-07-2022;Республика Крым;45_75_days;SputnikV;7915;5075;12990;1036087;480146;1516233
2022.06_18-07-2022;Республика Крым;75_90_days;AllVaccines;5124;2747;7871;1036087;480146;1516233
2022.06_18-07-2022;Республика Крым;75_90_days;CoviVac;224;63;287;1036087;480146;1516233
2022.06_18-07-2022;Республика Крым;75_90_days;EpiVacCorona;452;323;775;1036087;480146;1516233
2022.06_18-07-2022;Республика Крым;75_90_days;SputnikLite;227;63;290;1036087;480146;1516233
2022.06_18-07-2022;Республика Крым;75_90_days;SputnikV;4221;2298;6519;1036087;480146;1516233
2022.06_18-07-2022;Республика Крым;90_105_days;AllVaccines;5920;2754;8674;1036087;480146;1516233
2022.06_18-07-2022;Республика Крым;90_105_days;CoviVac;138;51;189;1036087;480146;1516233
2022.06_18-07-2022;Республика Крым;90_105_days;EpiVacCorona;860;443;1303;1036087;480146;1516233
2022.06_18-07-2022;Республика Крым;90_105_days;SputnikLite;294;159;453;1036087;480146;1516233
2022.06_18-07-2022;Республика Крым;90_105_days;SputnikV;4628;2101;6729;1036087;480146;1516233
2022.06_18-07-2022;Республика Марий Эл;105_165_days;AllVaccines;24463;16601;41064;370626;156749;527375
2022.06_18-07-2022;Республика Марий Эл;105_165_days;CoviVac;316;171;487;370626;156749;527375
2022.06_18-07-2022;Республика Марий Эл;105_165_days;EpiVacCorona;1057;930;1987;370626;156749;527375
2022.06_18-07-2022;Республика Марий Эл;105_165_days;SputnikLite;16231;11209;27440;370626;156749;527375
2022.06_18-07-2022;Республика Марий Эл;105_165_days;SputnikV;6859;4291;11150;370626;156749;527375
2022.06_18-07-2022;Республика Марий Эл;165_195_days;AllVaccines;41121;15682;56803;370626;156749;527375
2022.06_18-07-2022;Республика Марий Эл;165_195_days;CoviVac;471;139;610;370626;156749;527375
2022.06_18-07-2022;Республика Марий Эл;165_195_days;EpiVacCorona;1652;681;2333;370626;156749;527375
2022.06_18-07-2022;Республика Марий Эл;165_195_days;SputnikLite;14585;6046;20631;370626;156749;527375
2022.06_18-07-2022;Республика Марий Эл;165_195_days;SputnikV;24413;8816;33229;370626;156749;527375
2022.06_18-07-2022;Республика Марий Эл;21_45_days;AllVaccines;1515;580;2095;370626;156749;527375
2022.06_18-07-2022;Республика Марий Эл;21_45_days;EpiVacCorona;80;15;95;370626;156749;527375
2022.06_18-07-2022;Республика Марий Эл;21_45_days;SputnikLite;434;15;449;370626;156749;527375
2022.06_18-07-2022;Республика Марий Эл;21_45_days;SputnikV;1001;550;1551;370626;156749;527375
2022.06_18-07-2022;Республика Марий Эл;45_75_days;AllVaccines;2459;1117;3576;370626;156749;527375
2022.06_18-07-2022;Республика Марий Эл;45_75_days;CoviVac;14;4;18;370626;156749;527375
2022.06_18-07-2022;Республика Марий Эл;45_75_days;EpiVacCorona;131;47;178;370626;156749;527375
2022.06_18-07-2022;Республика Марий Эл;45_75_days;SputnikLite;887;78;965;370626;156749;527375
2022.06_18-07-2022;Республика Марий Эл;45_75_days;SputnikV;1427;988;2415;370626;156749;527375
2022.06_18-07-2022;Республика Марий Эл;75_90_days;AllVaccines;1043;880;1923;370626;156749;527375
2022.06_18-07-2022;Республика Марий Эл;75_90_days;CoviVac;116;15;131;370626;156749;527375
2022.06_18-07-2022;Республика Марий Эл;75_90_days;EpiVacCorona;80;52;132;370626;156749;527375
2022.06_18-07-2022;Республика Марий Эл;75_90_days;SputnikLite;112;12;124;370626;156749;527375
2022.06_18-07-2022;Республика Марий Эл;75_90_days;SputnikV;735;801;1536;370626;156749;527375
2022.06_18-07-2022;Республика Марий Эл;90_105_days;AllVaccines;1524;1576;3100;370626;156749;527375
2022.06_18-07-2022;Республика Марий Эл;90_105_days;CoviVac;137;123;260;370626;156749;527375
2022.06_18-07-2022;Республика Марий Эл;90_105_days;EpiVacCorona;82;178;260;370626;156749;527375
2022.06_18-07-2022;Республика Марий Эл;90_105_days;SputnikLite;408;239;647;370626;156749;527375
2022.06_18-07-2022;Республика Марий Эл;90_105_days;SputnikV;897;1036;1933;370626;156749;527375
2022.06_18-07-2022;Республика Мордовия;105_165_days;AllVaccines;56718;26331;83049;448319;198808;647127
2022.06_18-07-2022;Республика Мордовия;105_165_days;CoviVac;571;144;715;448319;198808;647127
2022.06_18-07-2022;Республика Мордовия;105_165_days;EpiVacCorona;4128;2437;6565;448319;198808;647127
2022.06_18-07-2022;Республика Мордовия;105_165_days;SputnikLite;36732;15006;51738;448319;198808;647127
2022.06_18-07-2022;Республика Мордовия;105_165_days;SputnikV;15287;8744;24031;448319;198808;647127
2022.06_18-07-2022;Республика Мордовия;165_195_days;AllVaccines;39638;20800;60438;448319;198808;647127
2022.06_18-07-2022;Республика Мордовия;165_195_days;CoviVac;739;219;958;448319;198808;647127
2022.06_18-07-2022;Республика Мордовия;165_195_days;EpiVacCorona;1380;597;1977;448319;198808;647127
2022.06_18-07-2022;Республика Мордовия;165_195_days;SputnikLite;14569;9057;23626;448319;198808;647127
2022.06_18-07-2022;Республика Мордовия;165_195_days;SputnikV;22950;10927;33877;448319;198808;647127
2022.06_18-07-2022;Республика Мордовия;21_45_days;AllVaccines;7199;7241;14440;448319;198808;647127
2022.06_18-07-2022;Республика Мордовия;21_45_days;CoviVac;10;27;37;448319;198808;647127
2022.06_18-07-2022;Республика Мордовия;21_45_days;EpiVacCorona;617;662;1279;448319;198808;647127
2022.06_18-07-2022;Республика Мордовия;21_45_days;SputnikLite;929;815;1744;448319;198808;647127
2022.06_18-07-2022;Республика Мордовия;21_45_days;SputnikV;5643;5737;11380;448319;198808;647127
2022.06_18-07-2022;Республика Мордовия;45_75_days;AllVaccines;14528;10321;24849;448319;198808;647127
2022.06_18-07-2022;Республика Мордовия;45_75_days;CoviVac;289;92;381;448319;198808;647127
2022.06_18-07-2022;Республика Мордовия;45_75_days;EpiVacCorona;966;1001;1967;448319;198808;647127
2022.06_18-07-2022;Республика Мордовия;45_75_days;SputnikLite;3143;2330;5473;448319;198808;647127
2022.06_18-07-2022;Республика Мордовия;45_75_days;SputnikV;10130;6898;17028;448319;198808;647127
2022.06_18-07-2022;Республика Мордовия;75_90_days;AllVaccines;7129;4578;11707;448319;198808;647127
2022.06_18-07-2022;Республика Мордовия;75_90_days;CoviVac;273;126;399;448319;198808;647127
2022.06_18-07-2022;Республика Мордовия;75_90_days;EpiVacCorona;400;276;676;448319;198808;647127
2022.06_18-07-2022;Республика Мордовия;75_90_days;SputnikLite;2606;1299;3905;448319;198808;647127
2022.06_18-07-2022;Республика Мордовия;75_90_days;SputnikV;3850;2877;6727;448319;198808;647127
2022.06_18-07-2022;Республика Мордовия;90_105_days;AllVaccines;5660;3066;8726;448319;198808;647127
2022.06_18-07-2022;Республика Мордовия;90_105_days;CoviVac;111;52;163;448319;198808;647127
2022.06_18-07-2022;Республика Мордовия;90_105_days;EpiVacCorona;528;383;911;448319;198808;647127
2022.06_18-07-2022;Республика Мордовия;90_105_days;SputnikLite;2695;1472;4167;448319;198808;647127
2022.06_18-07-2022;Республика Мордовия;90_105_days;SputnikV;2326;1159;3485;448319;198808;647127
2022.06_18-07-2022;Республика Саха (Якутия);105_165_days;AllVaccines;49879;12549;62428;568643;148395;717038
2022.06_18-07-2022;Республика Саха (Якутия);105_165_days;CoviVac;478;62;540;568643;148395;717038
2022.06_18-07-2022;Республика Саха (Якутия);105_165_days;EpiVacCorona;1185;454;1639;568643;148395;717038
2022.06_18-07-2022;Республика Саха (Якутия);105_165_days;SputnikLite;25718;5691;31409;568643;148395;717038
2022.06_18-07-2022;Республика Саха (Якутия);105_165_days;SputnikV;22498;6342;28840;568643;148395;717038
2022.06_18-07-2022;Республика Саха (Якутия);165_195_days;AllVaccines;42265;12387;54652;568643;148395;717038
2022.06_18-07-2022;Республика Саха (Якутия);165_195_days;CoviVac;889;116;1005;568643;148395;717038
2022.06_18-07-2022;Республика Саха (Якутия);165_195_days;EpiVacCorona;389;172;561;568643;148395;717038
2022.06_18-07-2022;Республика Саха (Якутия);165_195_days;SputnikLite;18102;5815;23917;568643;148395;717038
2022.06_18-07-2022;Республика Саха (Якутия);165_195_days;SputnikV;22885;6284;29169;568643;148395;717038
2022.06_18-07-2022;Республика Саха (Якутия);21_45_days;AllVaccines;2825;769;3594;568643;148395;717038
2022.06_18-07-2022;Республика Саха (Якутия);21_45_days;CoviVac;129;34;163;568643;148395;717038
2022.06_18-07-2022;Республика Саха (Якутия);21_45_days;EpiVacCorona;262;70;332;568643;148395;717038
2022.06_18-07-2022;Республика Саха (Якутия);21_45_days;SputnikLite;144;39;183;568643;148395;717038
2022.06_18-07-2022;Республика Саха (Якутия);21_45_days;SputnikV;2290;626;2916;568643;148395;717038
2022.06_18-07-2022;Республика Саха (Якутия);45_75_days;AllVaccines;5168;1321;6489;568643;148395;717038
2022.06_18-07-2022;Республика Саха (Якутия);45_75_days;CoviVac;137;23;160;568643;148395;717038
2022.06_18-07-2022;Республика Саха (Якутия);45_75_days;EpiVacCorona;537;101;638;568643;148395;717038
2022.06_18-07-2022;Республика Саха (Якутия);45_75_days;SputnikLite;757;259;1016;568643;148395;717038
2022.06_18-07-2022;Республика Саха (Якутия);45_75_days;SputnikV;3737;938;4675;568643;148395;717038
2022.06_18-07-2022;Республика Саха (Якутия);75_90_days;AllVaccines;4200;828;5028;568643;148395;717038
2022.06_18-07-2022;Республика Саха (Якутия);75_90_days;CoviVac;67;8;75;568643;148395;717038
2022.06_18-07-2022;Республика Саха (Якутия);75_90_days;EpiVacCorona;272;63;335;568643;148395;717038
2022.06_18-07-2022;Республика Саха (Якутия);75_90_days;SputnikLite;1109;253;1362;568643;148395;717038
2022.06_18-07-2022;Республика Саха (Якутия);75_90_days;SputnikV;2752;504;3256;568643;148395;717038
2022.06_18-07-2022;Республика Саха (Якутия);90_105_days;AllVaccines;5652;1175;6827;568643;148395;717038
2022.06_18-07-2022;Республика Саха (Якутия);90_105_days;CoviVac;85;11;96;568643;148395;717038
2022.06_18-07-2022;Республика Саха (Якутия);90_105_days;EpiVacCorona;229;86;315;568643;148395;717038
2022.06_18-07-2022;Республика Саха (Якутия);90_105_days;SputnikLite;1454;293;1747;568643;148395;717038
2022.06_18-07-2022;Республика Саха (Якутия);90_105_days;SputnikV;3884;785;4669;568643;148395;717038
2022.06_18-07-2022;Республика Северная Осетия - Алания;105_165_days;AllVaccines;17739;5853;23592;385443;144230;529673
2022.06_18-07-2022;Республика Северная Осетия - Алания;105_165_days;CoviVac;135;60;195;385443;144230;529673
2022.06_18-07-2022;Республика Северная Осетия - Алания;105_165_days;EpiVacCorona;2010;742;2752;385443;144230;529673
2022.06_18-07-2022;Республика Северная Осетия - Алания;105_165_days;SputnikLite;7957;2717;10674;385443;144230;529673
2022.06_18-07-2022;Республика Северная Осетия - Алания;105_165_days;SputnikV;7637;2334;9971;385443;144230;529673
2022.06_18-07-2022;Республика Северная Осетия - Алания;165_195_days;AllVaccines;24163;4785;28948;385443;144230;529673
2022.06_18-07-2022;Республика Северная Осетия - Алания;165_195_days;CoviVac;223;79;302;385443;144230;529673
2022.06_18-07-2022;Республика Северная Осетия - Алания;165_195_days;EpiVacCorona;798;153;951;385443;144230;529673
2022.06_18-07-2022;Республика Северная Осетия - Алания;165_195_days;SputnikLite;9150;2047;11197;385443;144230;529673
2022.06_18-07-2022;Республика Северная Осетия - Алания;165_195_days;SputnikV;13992;2506;16498;385443;144230;529673
2022.06_18-07-2022;Республика Северная Осетия - Алания;21_45_days;AllVaccines;2122;1403;3525;385443;144230;529673
2022.06_18-07-2022;Республика Северная Осетия - Алания;21_45_days;CoviVac;152;77;229;385443;144230;529673
2022.06_18-07-2022;Республика Северная Осетия - Алания;21_45_days;EpiVacCorona;83;18;101;385443;144230;529673
2022.06_18-07-2022;Республика Северная Осетия - Алания;21_45_days;SputnikLite;111;44;155;385443;144230;529673
2022.06_18-07-2022;Республика Северная Осетия - Алания;21_45_days;SputnikV;1776;1264;3040;385443;144230;529673
2022.06_18-07-2022;Республика Северная Осетия - Алания;45_75_days;AllVaccines;2673;1609;4282;385443;144230;529673
2022.06_18-07-2022;Республика Северная Осетия - Алания;45_75_days;CoviVac;292;242;534;385443;144230;529673
2022.06_18-07-2022;Республика Северная Осетия - Алания;45_75_days;EpiVacCorona;29;13;42;385443;144230;529673
2022.06_18-07-2022;Республика Северная Осетия - Алания;45_75_days;SputnikLite;294;95;389;385443;144230;529673
2022.06_18-07-2022;Республика Северная Осетия - Алания;45_75_days;SputnikV;2058;1259;3317;385443;144230;529673
2022.06_18-07-2022;Республика Северная Осетия - Алания;75_90_days;AllVaccines;1947;881;2828;385443;144230;529673
2022.06_18-07-2022;Республика Северная Осетия - Алания;75_90_days;CoviVac;79;134;213;385443;144230;529673
2022.06_18-07-2022;Республика Северная Осетия - Алания;75_90_days;EpiVacCorona;246;223;469;385443;144230;529673
2022.06_18-07-2022;Республика Северная Осетия - Алания;75_90_days;SputnikLite;362;158;520;385443;144230;529673
2022.06_18-07-2022;Республика Северная Осетия - Алания;75_90_days;SputnikV;1260;366;1626;385443;144230;529673
2022.06_18-07-2022;Республика Северная Осетия - Алания;90_105_days;AllVaccines;2125;950;3075;385443;144230;529673
2022.06_18-07-2022;Республика Северная Осетия - Алания;90_105_days;CoviVac;15;122;137;385443;144230;529673
2022.06_18-07-2022;Республика Северная Осетия - Алания;90_105_days;EpiVacCorona;49;252;301;385443;144230;529673
2022.06_18-07-2022;Республика Северная Осетия - Алания;90_105_days;SputnikLite;589;153;742;385443;144230;529673
2022.06_18-07-2022;Республика Северная Осетия - Алания;90_105_days;SputnikV;1472;423;1895;385443;144230;529673
2022.06_18-07-2022;Республика Татарстан;105_165_days;AllVaccines;131136;66548;197684;2180132;866477;3046609
2022.06_18-07-2022;Республика Татарстан;105_165_days;CoviVac;761;330;1091;2180132;866477;3046609
2022.06_18-07-2022;Республика Татарстан;105_165_days;EpiVacCorona;2031;1711;3742;2180132;866477;3046609
2022.06_18-07-2022;Республика Татарстан;105_165_days;SputnikLite;63290;33489;96779;2180132;866477;3046609
2022.06_18-07-2022;Республика Татарстан;105_165_days;SputnikV;65054;31018;96072;2180132;866477;3046609
2022.06_18-07-2022;Республика Татарстан;165_195_days;AllVaccines;214917;98192;313109;2180132;866477;3046609
2022.06_18-07-2022;Республика Татарстан;165_195_days;CoviVac;781;304;1085;2180132;866477;3046609
2022.06_18-07-2022;Республика Татарстан;165_195_days;EpiVacCorona;3891;2936;6827;2180132;866477;3046609
2022.06_18-07-2022;Республика Татарстан;165_195_days;SputnikLite;33519;26178;59697;2180132;866477;3046609
2022.06_18-07-2022;Республика Татарстан;165_195_days;SputnikV;176726;68774;245500;2180132;866477;3046609
2022.06_18-07-2022;Республика Татарстан;21_45_days;AllVaccines;10478;5976;16454;2180132;866477;3046609
2022.06_18-07-2022;Республика Татарстан;21_45_days;CoviVac;299;93;392;2180132;866477;3046609
2022.06_18-07-2022;Республика Татарстан;21_45_days;EpiVacCorona;293;105;398;2180132;866477;3046609
2022.06_18-07-2022;Республика Татарстан;21_45_days;SputnikLite;4128;3170;7298;2180132;866477;3046609
2022.06_18-07-2022;Республика Татарстан;21_45_days;SputnikV;5758;2608;8366;2180132;866477;3046609
2022.06_18-07-2022;Республика Татарстан;45_75_days;AllVaccines;16931;8405;25336;2180132;866477;3046609
2022.06_18-07-2022;Республика Татарстан;45_75_days;CoviVac;168;66;234;2180132;866477;3046609
2022.06_18-07-2022;Республика Татарстан;45_75_days;EpiVacCorona;1201;648;1849;2180132;866477;3046609
2022.06_18-07-2022;Республика Татарстан;45_75_days;SputnikLite;7426;4585;12011;2180132;866477;3046609
2022.06_18-07-2022;Республика Татарстан;45_75_days;SputnikV;8136;3106;11242;2180132;866477;3046609
2022.06_18-07-2022;Республика Татарстан;75_90_days;AllVaccines;16192;6647;22839;2180132;866477;3046609
2022.06_18-07-2022;Республика Татарстан;75_90_days;CoviVac;331;106;437;2180132;866477;3046609
2022.06_18-07-2022;Республика Татарстан;75_90_days;EpiVacCorona;698;570;1268;2180132;866477;3046609
2022.06_18-07-2022;Республика Татарстан;75_90_days;SputnikLite;5135;2343;7478;2180132;866477;3046609
2022.06_18-07-2022;Республика Татарстан;75_90_days;SputnikV;10028;3628;13656;2180132;866477;3046609
2022.06_18-07-2022;Республика Татарстан;90_105_days;AllVaccines;17550;6724;24274;2180132;866477;3046609
2022.06_18-07-2022;Республика Татарстан;90_105_days;CoviVac;211;119;330;2180132;866477;3046609
2022.06_18-07-2022;Республика Татарстан;90_105_days;EpiVacCorona;395;209;604;2180132;866477;3046609
2022.06_18-07-2022;Республика Татарстан;90_105_days;SputnikLite;6458;2922;9380;2180132;866477;3046609
2022.06_18-07-2022;Республика Татарстан;90_105_days;SputnikV;10486;3474;13960;2180132;866477;3046609
2022.06_18-07-2022;Республика Тыва;105_165_days;AllVaccines;22593;4266;26859;176122;31028;207150
2022.06_18-07-2022;Республика Тыва;105_165_days;CoviVac;40;3;43;176122;31028;207150
2022.06_18-07-2022;Республика Тыва;105_165_days;EpiVacCorona;227;29;256;176122;31028;207150
2022.06_18-07-2022;Республика Тыва;105_165_days;SputnikLite;14979;2956;17935;176122;31028;207150
2022.06_18-07-2022;Республика Тыва;105_165_days;SputnikV;7347;1278;8625;176122;31028;207150
2022.06_18-07-2022;Республика Тыва;165_195_days;AllVaccines;11268;2119;13387;176122;31028;207150
2022.06_18-07-2022;Республика Тыва;165_195_days;CoviVac;1;0;1;176122;31028;207150
2022.06_18-07-2022;Республика Тыва;165_195_days;EpiVacCorona;122;13;135;176122;31028;207150
2022.06_18-07-2022;Республика Тыва;165_195_days;SputnikLite;6014;1399;7413;176122;31028;207150
2022.06_18-07-2022;Республика Тыва;165_195_days;SputnikV;5131;707;5838;176122;31028;207150
2022.06_18-07-2022;Республика Тыва;21_45_days;AllVaccines;2885;744;3629;176122;31028;207150
2022.06_18-07-2022;Республика Тыва;21_45_days;CoviVac;82;14;96;176122;31028;207150
2022.06_18-07-2022;Республика Тыва;21_45_days;EpiVacCorona;627;169;796;176122;31028;207150
2022.06_18-07-2022;Республика Тыва;21_45_days;SputnikLite;519;58;577;176122;31028;207150
2022.06_18-07-2022;Республика Тыва;21_45_days;SputnikV;1657;503;2160;176122;31028;207150
2022.06_18-07-2022;Республика Тыва;45_75_days;AllVaccines;5899;1265;7164;176122;31028;207150
2022.06_18-07-2022;Республика Тыва;45_75_days;CoviVac;625;93;718;176122;31028;207150
2022.06_18-07-2022;Республика Тыва;45_75_days;EpiVacCorona;601;158;759;176122;31028;207150
2022.06_18-07-2022;Республика Тыва;45_75_days;SputnikLite;2062;358;2420;176122;31028;207150
2022.06_18-07-2022;Республика Тыва;45_75_days;SputnikV;2611;656;3267;176122;31028;207150
2022.06_18-07-2022;Республика Тыва;75_90_days;AllVaccines;3845;715;4560;176122;31028;207150
2022.06_18-07-2022;Республика Тыва;75_90_days;CoviVac;61;34;95;176122;31028;207150
2022.06_18-07-2022;Республика Тыва;75_90_days;EpiVacCorona;210;29;239;176122;31028;207150
2022.06_18-07-2022;Республика Тыва;75_90_days;SputnikLite;1643;340;1983;176122;31028;207150
2022.06_18-07-2022;Республика Тыва;75_90_days;SputnikV;1931;312;2243;176122;31028;207150
2022.06_18-07-2022;Республика Тыва;90_105_days;AllVaccines;3918;675;4593;176122;31028;207150
2022.06_18-07-2022;Республика Тыва;90_105_days;CoviVac;37;2;39;176122;31028;207150
2022.06_18-07-2022;Республика Тыва;90_105_days;EpiVacCorona;107;18;125;176122;31028;207150
2022.06_18-07-2022;Республика Тыва;90_105_days;SputnikLite;2315;441;2756;176122;31028;207150
2022.06_18-07-2022;Республика Тыва;90_105_days;SputnikV;1459;214;1673;176122;31028;207150
2022.06_18-07-2022;Республика Хакасия;105_165_days;AllVaccines;26538;10389;36927;291439;112190;403629
2022.06_18-07-2022;Республика Хакасия;105_165_days;CoviVac;466;139;605;291439;112190;403629
2022.06_18-07-2022;Республика Хакасия;105_165_days;EpiVacCorona;1056;387;1443;291439;112190;403629
2022.06_18-07-2022;Республика Хакасия;105_165_days;SputnikLite;17395;6474;23869;291439;112190;403629
2022.06_18-07-2022;Республика Хакасия;105_165_days;SputnikV;7621;3389;11010;291439;112190;403629
2022.06_18-07-2022;Республика Хакасия;165_195_days;AllVaccines;18347;8765;27112;291439;112190;403629
2022.06_18-07-2022;Республика Хакасия;165_195_days;CoviVac;285;74;359;291439;112190;403629
2022.06_18-07-2022;Республика Хакасия;165_195_days;EpiVacCorona;472;206;678;291439;112190;403629
2022.06_18-07-2022;Республика Хакасия;165_195_days;SputnikLite;6939;3888;10827;291439;112190;403629
2022.06_18-07-2022;Республика Хакасия;165_195_days;SputnikV;10651;4597;15248;291439;112190;403629
2022.06_18-07-2022;Республика Хакасия;21_45_days;AllVaccines;954;619;1573;291439;112190;403629
2022.06_18-07-2022;Республика Хакасия;21_45_days;CoviVac;30;5;35;291439;112190;403629
2022.06_18-07-2022;Республика Хакасия;21_45_days;EpiVacCorona;73;68;141;291439;112190;403629
2022.06_18-07-2022;Республика Хакасия;21_45_days;SputnikLite;76;57;133;291439;112190;403629
2022.06_18-07-2022;Республика Хакасия;21_45_days;SputnikV;775;489;1264;291439;112190;403629
2022.06_18-07-2022;Республика Хакасия;45_75_days;AllVaccines;1710;859;2569;291439;112190;403629
2022.06_18-07-2022;Республика Хакасия;45_75_days;CoviVac;162;50;212;291439;112190;403629
2022.06_18-07-2022;Республика Хакасия;45_75_days;EpiVacCorona;112;63;175;291439;112190;403629
2022.06_18-07-2022;Республика Хакасия;45_75_days;SputnikLite;162;115;277;291439;112190;403629
2022.06_18-07-2022;Республика Хакасия;45_75_days;SputnikV;1274;631;1905;291439;112190;403629
2022.06_18-07-2022;Республика Хакасия;75_90_days;AllVaccines;1265;595;1860;291439;112190;403629
2022.06_18-07-2022;Республика Хакасия;75_90_days;CoviVac;37;7;44;291439;112190;403629
2022.06_18-07-2022;Республика Хакасия;75_90_days;EpiVacCorona;48;21;69;291439;112190;403629
2022.06_18-07-2022;Республика Хакасия;75_90_days;SputnikLite;113;58;171;291439;112190;403629
2022.06_18-07-2022;Республика Хакасия;75_90_days;SputnikV;1067;509;1576;291439;112190;403629
2022.06_18-07-2022;Республика Хакасия;90_105_days;AllVaccines;2061;860;2921;291439;112190;403629
2022.06_18-07-2022;Республика Хакасия;90_105_days;CoviVac;51;11;62;291439;112190;403629
2022.06_18-07-2022;Республика Хакасия;90_105_days;EpiVacCorona;101;25;126;291439;112190;403629
2022.06_18-07-2022;Республика Хакасия;90_105_days;SputnikLite;495;205;700;291439;112190;403629
2022.06_18-07-2022;Республика Хакасия;90_105_days;SputnikV;1414;619;2033;291439;112190;403629
2022.06_18-07-2022;Ростовская область;105_165_days;AllVaccines;206460;96099;302559;2367942;1020468;3388410
2022.06_18-07-2022;Ростовская область;105_165_days;CoviVac;1945;609;2554;2367942;1020468;3388410
2022.06_18-07-2022;Ростовская область;105_165_days;EpiVacCorona;5855;3713;9568;2367942;1020468;3388410
2022.06_18-07-2022;Ростовская область;105_165_days;SputnikLite;94768;34127;128895;2367942;1020468;3388410
2022.06_18-07-2022;Ростовская область;105_165_days;SputnikV;103892;57650;161542;2367942;1020468;3388410
2022.06_18-07-2022;Ростовская область;165_195_days;AllVaccines;149681;88609;238290;2367942;1020468;3388410
2022.06_18-07-2022;Ростовская область;165_195_days;CoviVac;951;418;1369;2367942;1020468;3388410
2022.06_18-07-2022;Ростовская область;165_195_days;EpiVacCorona;1011;798;1809;2367942;1020468;3388410
2022.06_18-07-2022;Ростовская область;165_195_days;SputnikLite;35173;24546;59719;2367942;1020468;3388410
2022.06_18-07-2022;Ростовская область;165_195_days;SputnikV;112546;62847;175393;2367942;1020468;3388410
2022.06_18-07-2022;Ростовская область;21_45_days;AllVaccines;23463;15333;38796;2367942;1020468;3388410
2022.06_18-07-2022;Ростовская область;21_45_days;CoviVac;1411;403;1814;2367942;1020468;3388410
2022.06_18-07-2022;Ростовская область;21_45_days;EpiVacCorona;1360;1154;2514;2367942;1020468;3388410
2022.06_18-07-2022;Ростовская область;21_45_days;SputnikLite;1764;933;2697;2367942;1020468;3388410
2022.06_18-07-2022;Ростовская область;21_45_days;SputnikV;18928;12843;31771;2367942;1020468;3388410
2022.06_18-07-2022;Ростовская область;45_75_days;AllVaccines;32016;22283;54299;2367942;1020468;3388410
2022.06_18-07-2022;Ростовская область;45_75_days;CoviVac;1052;411;1463;2367942;1020468;3388410
2022.06_18-07-2022;Ростовская область;45_75_days;EpiVacCorona;3283;2518;5801;2367942;1020468;3388410
2022.06_18-07-2022;Ростовская область;45_75_days;SputnikLite;2547;1118;3665;2367942;1020468;3388410
2022.06_18-07-2022;Ростовская область;45_75_days;SputnikV;25134;18236;43370;2367942;1020468;3388410
2022.06_18-07-2022;Ростовская область;75_90_days;AllVaccines;21098;11620;32718;2367942;1020468;3388410
2022.06_18-07-2022;Ростовская область;75_90_days;CoviVac;497;106;603;2367942;1020468;3388410
2022.06_18-07-2022;Ростовская область;75_90_days;EpiVacCorona;1619;1052;2671;2367942;1020468;3388410
2022.06_18-07-2022;Ростовская область;75_90_days;SputnikLite;3500;1217;4717;2367942;1020468;3388410
2022.06_18-07-2022;Ростовская область;75_90_days;SputnikV;15482;9245;24727;2367942;1020468;3388410
2022.06_18-07-2022;Ростовская область;90_105_days;AllVaccines;23708;13170;36878;2367942;1020468;3388410
2022.06_18-07-2022;Ростовская область;90_105_days;CoviVac;319;87;406;2367942;1020468;3388410
2022.06_18-07-2022;Ростовская область;90_105_days;EpiVacCorona;1623;796;2419;2367942;1020468;3388410
2022.06_18-07-2022;Ростовская область;90_105_days;SputnikLite;4536;1586;6122;2367942;1020468;3388410
2022.06_18-07-2022;Ростовская область;90_105_days;SputnikV;17230;10701;27931;2367942;1020468;3388410
2022.06_18-07-2022;Рязанская область;105_165_days;AllVaccines;45504;22141;67645;600731;301318;902049
2022.06_18-07-2022;Рязанская область;105_165_days;CoviVac;630;168;798;600731;301318;902049
2022.06_18-07-2022;Рязанская область;105_165_days;EpiVacCorona;1196;459;1655;600731;301318;902049
2022.06_18-07-2022;Рязанская область;105_165_days;SputnikLite;24546;14696;39242;600731;301318;902049
2022.06_18-07-2022;Рязанская область;105_165_days;SputnikV;19132;6818;25950;600731;301318;902049
2022.06_18-07-2022;Рязанская область;165_195_days;AllVaccines;59960;33810;93770;600731;301318;902049
2022.06_18-07-2022;Рязанская область;165_195_days;CoviVac;992;319;1311;600731;301318;902049
2022.06_18-07-2022;Рязанская область;165_195_days;EpiVacCorona;1288;601;1889;600731;301318;902049
2022.06_18-07-2022;Рязанская область;165_195_days;SputnikLite;13003;13775;26778;600731;301318;902049
2022.06_18-07-2022;Рязанская область;165_195_days;SputnikV;44677;19115;63792;600731;301318;902049
2022.06_18-07-2022;Рязанская область;21_45_days;AllVaccines;1233;1058;2291;600731;301318;902049
2022.06_18-07-2022;Рязанская область;21_45_days;CoviVac;54;33;87;600731;301318;902049
2022.06_18-07-2022;Рязанская область;21_45_days;EpiVacCorona;38;16;54;600731;301318;902049
2022.06_18-07-2022;Рязанская область;21_45_days;SputnikLite;209;185;394;600731;301318;902049
2022.06_18-07-2022;Рязанская область;21_45_days;SputnikV;932;824;1756;600731;301318;902049
2022.06_18-07-2022;Рязанская область;45_75_days;AllVaccines;3551;2982;6533;600731;301318;902049
2022.06_18-07-2022;Рязанская область;45_75_days;CoviVac;159;44;203;600731;301318;902049
2022.06_18-07-2022;Рязанская область;45_75_days;EpiVacCorona;93;28;121;600731;301318;902049
2022.06_18-07-2022;Рязанская область;45_75_days;SputnikLite;1209;1295;2504;600731;301318;902049
2022.06_18-07-2022;Рязанская область;45_75_days;SputnikV;2090;1615;3705;600731;301318;902049
2022.06_18-07-2022;Рязанская область;75_90_days;AllVaccines;2351;1381;3732;600731;301318;902049
2022.06_18-07-2022;Рязанская область;75_90_days;CoviVac;144;36;180;600731;301318;902049
2022.06_18-07-2022;Рязанская область;75_90_days;EpiVacCorona;45;25;70;600731;301318;902049
2022.06_18-07-2022;Рязанская область;75_90_days;SputnikLite;441;292;733;600731;301318;902049
2022.06_18-07-2022;Рязанская область;75_90_days;SputnikV;1721;1028;2749;600731;301318;902049
2022.06_18-07-2022;Рязанская область;90_105_days;AllVaccines;2635;1230;3865;600731;301318;902049
2022.06_18-07-2022;Рязанская область;90_105_days;CoviVac;57;20;77;600731;301318;902049
2022.06_18-07-2022;Рязанская область;90_105_days;EpiVacCorona;78;36;114;600731;301318;902049
2022.06_18-07-2022;Рязанская область;90_105_days;SputnikLite;796;548;1344;600731;301318;902049
2022.06_18-07-2022;Рязанская область;90_105_days;SputnikV;1704;626;2330;600731;301318;902049
2022.06_18-07-2022;Самарская область;105_165_days;AllVaccines;115248;63716;178964;1769846;769791;2539637
2022.06_18-07-2022;Самарская область;105_165_days;CoviVac;1200;433;1633;1769846;769791;2539637
2022.06_18-07-2022;Самарская область;105_165_days;EpiVacCorona;2454;2794;5248;1769846;769791;2539637
2022.06_18-07-2022;Самарская область;105_165_days;SputnikLite;59902;31616;91518;1769846;769791;2539637
2022.06_18-07-2022;Самарская область;105_165_days;SputnikV;51692;28873;80565;1769846;769791;2539637
2022.06_18-07-2022;Самарская область;165_195_days;AllVaccines;155284;86907;242191;1769846;769791;2539637
2022.06_18-07-2022;Самарская область;165_195_days;CoviVac;1223;431;1654;1769846;769791;2539637
2022.06_18-07-2022;Самарская область;165_195_days;EpiVacCorona;2694;2032;4726;1769846;769791;2539637
2022.06_18-07-2022;Самарская область;165_195_days;SputnikLite;36326;29826;66152;1769846;769791;2539637
2022.06_18-07-2022;Самарская область;165_195_days;SputnikV;115041;54618;169659;1769846;769791;2539637
2022.06_18-07-2022;Самарская область;21_45_days;AllVaccines;11247;9924;21171;1769846;769791;2539637
2022.06_18-07-2022;Самарская область;21_45_days;CoviVac;276;156;432;1769846;769791;2539637
2022.06_18-07-2022;Самарская область;21_45_days;EpiVacCorona;525;798;1323;1769846;769791;2539637
2022.06_18-07-2022;Самарская область;21_45_days;SputnikLite;3974;2045;6019;1769846;769791;2539637
2022.06_18-07-2022;Самарская область;21_45_days;SputnikV;6472;6925;13397;1769846;769791;2539637
2022.06_18-07-2022;Самарская область;45_75_days;AllVaccines;20896;20047;40943;1769846;769791;2539637
2022.06_18-07-2022;Самарская область;45_75_days;CoviVac;563;284;847;1769846;769791;2539637
2022.06_18-07-2022;Самарская область;45_75_days;EpiVacCorona;1604;2515;4119;1769846;769791;2539637
2022.06_18-07-2022;Самарская область;45_75_days;SputnikLite;7167;2954;10121;1769846;769791;2539637
2022.06_18-07-2022;Самарская область;45_75_days;SputnikV;11562;14294;25856;1769846;769791;2539637
2022.06_18-07-2022;Самарская область;75_90_days;AllVaccines;13147;11666;24813;1769846;769791;2539637
2022.06_18-07-2022;Самарская область;75_90_days;CoviVac;185;84;269;1769846;769791;2539637
2022.06_18-07-2022;Самарская область;75_90_days;EpiVacCorona;1226;1500;2726;1769846;769791;2539637
2022.06_18-07-2022;Самарская область;75_90_days;SputnikLite;4408;2201;6609;1769846;769791;2539637
2022.06_18-07-2022;Самарская область;75_90_days;SputnikV;7328;7881;15209;1769846;769791;2539637
2022.06_18-07-2022;Самарская область;90_105_days;AllVaccines;13624;7278;20902;1769846;769791;2539637
2022.06_18-07-2022;Самарская область;90_105_days;CoviVac;213;144;357;1769846;769791;2539637
2022.06_18-07-2022;Самарская область;90_105_days;EpiVacCorona;466;572;1038;1769846;769791;2539637
2022.06_18-07-2022;Самарская область;90_105_days;SputnikLite;5090;2130;7220;1769846;769791;2539637
2022.06_18-07-2022;Самарская область;90_105_days;SputnikV;7855;4432;12287;1769846;769791;2539637
2022.06_18-07-2022;Саратовская область;105_165_days;AllVaccines;92201;48854;141055;1348454;599954;1948408
2022.06_18-07-2022;Саратовская область;105_165_days;CoviVac;1406;410;1816;1348454;599954;1948408
2022.06_18-07-2022;Саратовская область;105_165_days;EpiVacCorona;5152;3472;8624;1348454;599954;1948408
2022.06_18-07-2022;Саратовская область;105_165_days;SputnikLite;53099;26850;79949;1348454;599954;1948408
2022.06_18-07-2022;Саратовская область;105_165_days;SputnikV;32544;18122;50666;1348454;599954;1948408
2022.06_18-07-2022;Саратовская область;165_195_days;AllVaccines;128466;57339;185805;1348454;599954;1948408
2022.06_18-07-2022;Саратовская область;165_195_days;CoviVac;1089;265;1354;1348454;599954;1948408
2022.06_18-07-2022;Саратовская область;165_195_days;EpiVacCorona;6163;2666;8829;1348454;599954;1948408
2022.06_18-07-2022;Саратовская область;165_195_days;SputnikLite;27538;18908;46446;1348454;599954;1948408
2022.06_18-07-2022;Саратовская область;165_195_days;SputnikV;93676;35500;129176;1348454;599954;1948408
2022.06_18-07-2022;Саратовская область;21_45_days;AllVaccines;8994;6766;15760;1348454;599954;1948408
2022.06_18-07-2022;Саратовская область;21_45_days;CoviVac;809;280;1089;1348454;599954;1948408
2022.06_18-07-2022;Саратовская область;21_45_days;EpiVacCorona;977;1444;2421;1348454;599954;1948408
2022.06_18-07-2022;Саратовская область;21_45_days;SputnikLite;1920;965;2885;1348454;599954;1948408
2022.06_18-07-2022;Саратовская область;21_45_days;SputnikV;5288;4077;9365;1348454;599954;1948408
2022.06_18-07-2022;Саратовская область;45_75_days;AllVaccines;13967;9625;23592;1348454;599954;1948408
2022.06_18-07-2022;Саратовская область;45_75_days;CoviVac;805;291;1096;1348454;599954;1948408
2022.06_18-07-2022;Саратовская область;45_75_days;EpiVacCorona;1758;1097;2855;1348454;599954;1948408
2022.06_18-07-2022;Саратовская область;45_75_days;SputnikLite;2709;1747;4456;1348454;599954;1948408
2022.06_18-07-2022;Саратовская область;45_75_days;SputnikV;8695;6490;15185;1348454;599954;1948408
2022.06_18-07-2022;Саратовская область;75_90_days;AllVaccines;7777;5488;13265;1348454;599954;1948408
2022.06_18-07-2022;Саратовская область;75_90_days;CoviVac;358;119;477;1348454;599954;1948408
2022.06_18-07-2022;Саратовская область;75_90_days;EpiVacCorona;762;680;1442;1348454;599954;1948408
2022.06_18-07-2022;Саратовская область;75_90_days;SputnikLite;2117;1170;3287;1348454;599954;1948408
2022.06_18-07-2022;Саратовская область;75_90_days;SputnikV;4540;3519;8059;1348454;599954;1948408
2022.06_18-07-2022;Саратовская область;90_105_days;AllVaccines;7846;4524;12370;1348454;599954;1948408
2022.06_18-07-2022;Саратовская область;90_105_days;CoviVac;189;130;319;1348454;599954;1948408
2022.06_18-07-2022;Саратовская область;90_105_days;EpiVacCorona;1043;765;1808;1348454;599954;1948408
2022.06_18-07-2022;Саратовская область;90_105_days;SputnikLite;2616;1415;4031;1348454;599954;1948408
2022.06_18-07-2022;Саратовская область;90_105_days;SputnikV;3998;2214;6212;1348454;599954;1948408
2022.06_18-07-2022;Сахалинская область;105_165_days;AllVaccines;27400;9635;37035;276677;101794;378471
2022.06_18-07-2022;Сахалинская область;105_165_days;CoviVac;401;95;496;276677;101794;378471
2022.06_18-07-2022;Сахалинская область;105_165_days;EpiVacCorona;924;188;1112;276677;101794;378471
2022.06_18-07-2022;Сахалинская область;105_165_days;SputnikLite;20083;7641;27724;276677;101794;378471
2022.06_18-07-2022;Сахалинская область;105_165_days;SputnikV;5992;1711;7703;276677;101794;378471
2022.06_18-07-2022;Сахалинская область;165_195_days;AllVaccines;20652;7565;28217;276677;101794;378471
2022.06_18-07-2022;Сахалинская область;165_195_days;CoviVac;450;75;525;276677;101794;378471
2022.06_18-07-2022;Сахалинская область;165_195_days;EpiVacCorona;1888;396;2284;276677;101794;378471
2022.06_18-07-2022;Сахалинская область;165_195_days;SputnikLite;7358;4482;11840;276677;101794;378471
2022.06_18-07-2022;Сахалинская область;165_195_days;SputnikV;10956;2612;13568;276677;101794;378471
2022.06_18-07-2022;Сахалинская область;21_45_days;AllVaccines;1819;936;2755;276677;101794;378471
2022.06_18-07-2022;Сахалинская область;21_45_days;EpiVacCorona;62;12;74;276677;101794;378471
2022.06_18-07-2022;Сахалинская область;21_45_days;SputnikLite;1035;646;1681;276677;101794;378471
2022.06_18-07-2022;Сахалинская область;21_45_days;SputnikV;722;278;1000;276677;101794;378471
2022.06_18-07-2022;Сахалинская область;45_75_days;AllVaccines;3869;1421;5290;276677;101794;378471
2022.06_18-07-2022;Сахалинская область;45_75_days;CoviVac;87;7;94;276677;101794;378471
2022.06_18-07-2022;Сахалинская область;45_75_days;EpiVacCorona;261;24;285;276677;101794;378471
2022.06_18-07-2022;Сахалинская область;45_75_days;SputnikLite;2201;1068;3269;276677;101794;378471
2022.06_18-07-2022;Сахалинская область;45_75_days;SputnikV;1320;322;1642;276677;101794;378471
2022.06_18-07-2022;Сахалинская область;75_90_days;AllVaccines;3578;1084;4662;276677;101794;378471
2022.06_18-07-2022;Сахалинская область;75_90_days;CoviVac;264;14;278;276677;101794;378471
2022.06_18-07-2022;Сахалинская область;75_90_days;EpiVacCorona;165;34;199;276677;101794;378471
2022.06_18-07-2022;Сахалинская область;75_90_days;SputnikLite;1591;613;2204;276677;101794;378471
2022.06_18-07-2022;Сахалинская область;75_90_days;SputnikV;1558;423;1981;276677;101794;378471
2022.06_18-07-2022;Сахалинская область;90_105_days;AllVaccines;3151;864;4015;276677;101794;378471
2022.06_18-07-2022;Сахалинская область;90_105_days;CoviVac;44;17;61;276677;101794;378471
2022.06_18-07-2022;Сахалинская область;90_105_days;EpiVacCorona;148;34;182;276677;101794;378471
2022.06_18-07-2022;Сахалинская область;90_105_days;SputnikLite;1701;498;2199;276677;101794;378471
2022.06_18-07-2022;Сахалинская область;90_105_days;SputnikV;1258;315;1573;276677;101794;378471
2022.06_18-07-2022;Свердловская область;105_165_days;AllVaccines;184180;93308;277488;2364046;987486;3351532
2022.06_18-07-2022;Свердловская область;105_165_days;CoviVac;1101;298;1399;2364046;987486;3351532
2022.06_18-07-2022;Свердловская область;105_165_days;EpiVacCorona;9701;5370;15071;2364046;987486;3351532
2022.06_18-07-2022;Свердловская область;105_165_days;SputnikLite;96272;49087;145359;2364046;987486;3351532
2022.06_18-07-2022;Свердловская область;105_165_days;SputnikV;77106;38553;115659;2364046;987486;3351532
2022.06_18-07-2022;Свердловская область;165_195_days;AllVaccines;264735;119580;384315;2364046;987486;3351532
2022.06_18-07-2022;Свердловская область;165_195_days;CoviVac;797;213;1010;2364046;987486;3351532
2022.06_18-07-2022;Свердловская область;165_195_days;EpiVacCorona;5210;2810;8020;2364046;987486;3351532
2022.06_18-07-2022;Свердловская область;165_195_days;SputnikLite;61487;40510;101997;2364046;987486;3351532
2022.06_18-07-2022;Свердловская область;165_195_days;SputnikV;197241;76047;273288;2364046;987486;3351532
2022.06_18-07-2022;Свердловская область;21_45_days;AllVaccines;16697;12504;29201;2364046;987486;3351532
2022.06_18-07-2022;Свердловская область;21_45_days;CoviVac;391;155;546;2364046;987486;3351532
2022.06_18-07-2022;Свердловская область;21_45_days;EpiVacCorona;1168;632;1800;2364046;987486;3351532
2022.06_18-07-2022;Свердловская область;21_45_days;SputnikLite;2138;1232;3370;2364046;987486;3351532
2022.06_18-07-2022;Свердловская область;21_45_days;SputnikV;13000;10485;23485;2364046;987486;3351532
2022.06_18-07-2022;Свердловская область;45_75_days;AllVaccines;26903;18130;45033;2364046;987486;3351532
2022.06_18-07-2022;Свердловская область;45_75_days;CoviVac;353;103;456;2364046;987486;3351532
2022.06_18-07-2022;Свердловская область;45_75_days;EpiVacCorona;1603;851;2454;2364046;987486;3351532
2022.06_18-07-2022;Свердловская область;45_75_days;SputnikLite;4197;2403;6600;2364046;987486;3351532
2022.06_18-07-2022;Свердловская область;45_75_days;SputnikV;20750;14773;35523;2364046;987486;3351532
2022.06_18-07-2022;Свердловская область;75_90_days;AllVaccines;17264;8725;25989;2364046;987486;3351532
2022.06_18-07-2022;Свердловская область;75_90_days;CoviVac;100;23;123;2364046;987486;3351532
2022.06_18-07-2022;Свердловская область;75_90_days;EpiVacCorona;962;429;1391;2364046;987486;3351532
2022.06_18-07-2022;Свердловская область;75_90_days;SputnikLite;2761;1233;3994;2364046;987486;3351532
2022.06_18-07-2022;Свердловская область;75_90_days;SputnikV;13441;7040;20481;2364046;987486;3351532
2022.06_18-07-2022;Свердловская область;90_105_days;AllVaccines;19046;8856;27902;2364046;987486;3351532
2022.06_18-07-2022;Свердловская область;90_105_days;CoviVac;109;26;135;2364046;987486;3351532
2022.06_18-07-2022;Свердловская область;90_105_days;EpiVacCorona;966;524;1490;2364046;987486;3351532
2022.06_18-07-2022;Свердловская область;90_105_days;SputnikLite;5056;2272;7328;2364046;987486;3351532
2022.06_18-07-2022;Свердловская область;90_105_days;SputnikV;12915;6034;18949;2364046;987486;3351532
2022.06_18-07-2022;Смоленская область;105_165_days;AllVaccines;31719;18209;49928;521379;238479;759858
2022.06_18-07-2022;Смоленская область;105_165_days;CoviVac;459;137;596;521379;238479;759858
2022.06_18-07-2022;Смоленская область;105_165_days;EpiVacCorona;2149;1343;3492;521379;238479;759858
2022.06_18-07-2022;Смоленская область;105_165_days;SputnikLite;16064;9673;25737;521379;238479;759858
2022.06_18-07-2022;Смоленская область;105_165_days;SputnikV;13047;7056;20103;521379;238479;759858
2022.06_18-07-2022;Смоленская область;165_195_days;AllVaccines;31826;21042;52868;521379;238479;759858
2022.06_18-07-2022;Смоленская область;165_195_days;CoviVac;317;86;403;521379;238479;759858
2022.06_18-07-2022;Смоленская область;165_195_days;EpiVacCorona;1471;786;2257;521379;238479;759858
2022.06_18-07-2022;Смоленская область;165_195_days;SputnikLite;9940;9133;19073;521379;238479;759858
2022.06_18-07-2022;Смоленская область;165_195_days;SputnikV;20098;11037;31135;521379;238479;759858
2022.06_18-07-2022;Смоленская область;21_45_days;AllVaccines;2400;1963;4363;521379;238479;759858
2022.06_18-07-2022;Смоленская область;21_45_days;CoviVac;95;243;338;521379;238479;759858
2022.06_18-07-2022;Смоленская область;21_45_days;EpiVacCorona;306;235;541;521379;238479;759858
2022.06_18-07-2022;Смоленская область;21_45_days;SputnikLite;534;325;859;521379;238479;759858
2022.06_18-07-2022;Смоленская область;21_45_days;SputnikV;1465;1160;2625;521379;238479;759858
2022.06_18-07-2022;Смоленская область;45_75_days;AllVaccines;4563;2907;7470;521379;238479;759858
2022.06_18-07-2022;Смоленская область;45_75_days;CoviVac;245;77;322;521379;238479;759858
2022.06_18-07-2022;Смоленская область;45_75_days;EpiVacCorona;227;148;375;521379;238479;759858
2022.06_18-07-2022;Смоленская область;45_75_days;SputnikLite;1912;1191;3103;521379;238479;759858
2022.06_18-07-2022;Смоленская область;45_75_days;SputnikV;2179;1491;3670;521379;238479;759858
2022.06_18-07-2022;Смоленская область;75_90_days;AllVaccines;3150;1653;4803;521379;238479;759858
2022.06_18-07-2022;Смоленская область;75_90_days;CoviVac;272;61;333;521379;238479;759858
2022.06_18-07-2022;Смоленская область;75_90_days;EpiVacCorona;236;103;339;521379;238479;759858
2022.06_18-07-2022;Смоленская область;75_90_days;SputnikLite;568;338;906;521379;238479;759858
2022.06_18-07-2022;Смоленская область;75_90_days;SputnikV;2074;1151;3225;521379;238479;759858
2022.06_18-07-2022;Смоленская область;90_105_days;AllVaccines;3604;1851;5455;521379;238479;759858
2022.06_18-07-2022;Смоленская область;90_105_days;CoviVac;62;38;100;521379;238479;759858
2022.06_18-07-2022;Смоленская область;90_105_days;EpiVacCorona;301;164;465;521379;238479;759858
2022.06_18-07-2022;Смоленская область;90_105_days;SputnikLite;593;336;929;521379;238479;759858
2022.06_18-07-2022;Смоленская область;90_105_days;SputnikV;2648;1313;3961;521379;238479;759858
2022.06_18-07-2022;Ставропольский край;105_165_days;AllVaccines;90549;44453;135002;1590669;616030;2206699
2022.06_18-07-2022;Ставропольский край;105_165_days;CoviVac;989;651;1640;1590669;616030;2206699
2022.06_18-07-2022;Ставропольский край;105_165_days;EpiVacCorona;8618;5214;13832;1590669;616030;2206699
2022.06_18-07-2022;Ставропольский край;105_165_days;SputnikLite;46282;24189;70471;1590669;616030;2206699
2022.06_18-07-2022;Ставропольский край;105_165_days;SputnikV;34660;14399;49059;1590669;616030;2206699
2022.06_18-07-2022;Ставропольский край;165_195_days;AllVaccines;142397;50422;192819;1590669;616030;2206699
2022.06_18-07-2022;Ставропольский край;165_195_days;CoviVac;835;272;1107;1590669;616030;2206699
2022.06_18-07-2022;Ставропольский край;165_195_days;EpiVacCorona;3745;1608;5353;1590669;616030;2206699
2022.06_18-07-2022;Ставропольский край;165_195_days;SputnikLite;36962;18137;55099;1590669;616030;2206699
2022.06_18-07-2022;Ставропольский край;165_195_days;SputnikV;100855;30405;131260;1590669;616030;2206699
2022.06_18-07-2022;Ставропольский край;21_45_days;AllVaccines;6810;4381;11191;1590669;616030;2206699
2022.06_18-07-2022;Ставропольский край;21_45_days;CoviVac;323;155;478;1590669;616030;2206699
2022.06_18-07-2022;Ставропольский край;21_45_days;EpiVacCorona;441;228;669;1590669;616030;2206699
2022.06_18-07-2022;Ставропольский край;21_45_days;SputnikLite;946;501;1447;1590669;616030;2206699
2022.06_18-07-2022;Ставропольский край;21_45_days;SputnikV;5100;3497;8597;1590669;616030;2206699
2022.06_18-07-2022;Ставропольский край;45_75_days;AllVaccines;12006;6598;18604;1590669;616030;2206699
2022.06_18-07-2022;Ставропольский край;45_75_days;CoviVac;549;228;777;1590669;616030;2206699
2022.06_18-07-2022;Ставропольский край;45_75_days;EpiVacCorona;1307;771;2078;1590669;616030;2206699
2022.06_18-07-2022;Ставропольский край;45_75_days;SputnikLite;1197;820;2017;1590669;616030;2206699
2022.06_18-07-2022;Ставропольский край;45_75_days;SputnikV;8953;4779;13732;1590669;616030;2206699
2022.06_18-07-2022;Ставропольский край;75_90_days;AllVaccines;8991;6861;15852;1590669;616030;2206699
2022.06_18-07-2022;Ставропольский край;75_90_days;CoviVac;426;136;562;1590669;616030;2206699
2022.06_18-07-2022;Ставропольский край;75_90_days;EpiVacCorona;862;226;1088;1590669;616030;2206699
2022.06_18-07-2022;Ставропольский край;75_90_days;SputnikLite;758;444;1202;1590669;616030;2206699
2022.06_18-07-2022;Ставропольский край;75_90_days;SputnikV;6945;6055;13000;1590669;616030;2206699
2022.06_18-07-2022;Ставропольский край;90_105_days;AllVaccines;7370;5650;13020;1590669;616030;2206699
2022.06_18-07-2022;Ставропольский край;90_105_days;CoviVac;286;347;633;1590669;616030;2206699
2022.06_18-07-2022;Ставропольский край;90_105_days;EpiVacCorona;480;446;926;1590669;616030;2206699
2022.06_18-07-2022;Ставропольский край;90_105_days;SputnikLite;1315;775;2090;1590669;616030;2206699
2022.06_18-07-2022;Ставропольский край;90_105_days;SputnikV;5289;4082;9371;1590669;616030;2206699
2022.06_18-07-2022;Тамбовская область;105_165_days;AllVaccines;50878;29184;80062;545785;279936;825721
2022.06_18-07-2022;Тамбовская область;105_165_days;CoviVac;911;138;1049;545785;279936;825721
2022.06_18-07-2022;Тамбовская область;105_165_days;EpiVacCorona;5365;3997;9362;545785;279936;825721
2022.06_18-07-2022;Тамбовская область;105_165_days;SputnikLite;27942;9930;37872;545785;279936;825721
2022.06_18-07-2022;Тамбовская область;105_165_days;SputnikV;16660;15119;31779;545785;279936;825721
2022.06_18-07-2022;Тамбовская область;165_195_days;AllVaccines;32828;22577;55405;545785;279936;825721
2022.06_18-07-2022;Тамбовская область;165_195_days;CoviVac;881;165;1046;545785;279936;825721
2022.06_18-07-2022;Тамбовская область;165_195_days;EpiVacCorona;965;748;1713;545785;279936;825721
2022.06_18-07-2022;Тамбовская область;165_195_days;SputnikLite;16834;9553;26387;545785;279936;825721
2022.06_18-07-2022;Тамбовская область;165_195_days;SputnikV;14148;12111;26259;545785;279936;825721
2022.06_18-07-2022;Тамбовская область;21_45_days;AllVaccines;6979;8870;15849;545785;279936;825721
2022.06_18-07-2022;Тамбовская область;21_45_days;CoviVac;827;222;1049;545785;279936;825721
2022.06_18-07-2022;Тамбовская область;21_45_days;EpiVacCorona;734;1205;1939;545785;279936;825721
2022.06_18-07-2022;Тамбовская область;21_45_days;SputnikLite;112;29;141;545785;279936;825721
2022.06_18-07-2022;Тамбовская область;21_45_days;SputnikV;5306;7414;12720;545785;279936;825721
2022.06_18-07-2022;Тамбовская область;45_75_days;AllVaccines;7964;8389;16353;545785;279936;825721
2022.06_18-07-2022;Тамбовская область;45_75_days;CoviVac;1313;344;1657;545785;279936;825721
2022.06_18-07-2022;Тамбовская область;45_75_days;EpiVacCorona;1123;1282;2405;545785;279936;825721
2022.06_18-07-2022;Тамбовская область;45_75_days;SputnikLite;124;76;200;545785;279936;825721
2022.06_18-07-2022;Тамбовская область;45_75_days;SputnikV;5404;6687;12091;545785;279936;825721
2022.06_18-07-2022;Тамбовская область;75_90_days;AllVaccines;8813;5637;14450;545785;279936;825721
2022.06_18-07-2022;Тамбовская область;75_90_days;CoviVac;403;45;448;545785;279936;825721
2022.06_18-07-2022;Тамбовская область;75_90_days;EpiVacCorona;596;556;1152;545785;279936;825721
2022.06_18-07-2022;Тамбовская область;75_90_days;SputnikLite;241;212;453;545785;279936;825721
2022.06_18-07-2022;Тамбовская область;75_90_days;SputnikV;7573;4824;12397;545785;279936;825721
2022.06_18-07-2022;Тамбовская область;90_105_days;AllVaccines;4380;2784;7164;545785;279936;825721
2022.06_18-07-2022;Тамбовская область;90_105_days;CoviVac;171;15;186;545785;279936;825721
2022.06_18-07-2022;Тамбовская область;90_105_days;EpiVacCorona;451;328;779;545785;279936;825721
2022.06_18-07-2022;Тамбовская область;90_105_days;SputnikLite;820;527;1347;545785;279936;825721
2022.06_18-07-2022;Тамбовская область;90_105_days;SputnikV;2938;1914;4852;545785;279936;825721
2022.06_18-07-2022;Тверская область;105_165_days;AllVaccines;44337;25000;69337;681519;330234;1011753
2022.06_18-07-2022;Тверская область;105_165_days;CoviVac;1047;243;1290;681519;330234;1011753
2022.06_18-07-2022;Тверская область;105_165_days;EpiVacCorona;1905;1335;3240;681519;330234;1011753
2022.06_18-07-2022;Тверская область;105_165_days;SputnikLite;28890;16377;45267;681519;330234;1011753
2022.06_18-07-2022;Тверская область;105_165_days;SputnikV;12495;7045;19540;681519;330234;1011753
2022.06_18-07-2022;Тверская область;165_195_days;AllVaccines;37829;25498;63327;681519;330234;1011753
2022.06_18-07-2022;Тверская область;165_195_days;CoviVac;1075;303;1378;681519;330234;1011753
2022.06_18-07-2022;Тверская область;165_195_days;EpiVacCorona;2833;1952;4785;681519;330234;1011753
2022.06_18-07-2022;Тверская область;165_195_days;SputnikLite;10894;10067;20961;681519;330234;1011753
2022.06_18-07-2022;Тверская область;165_195_days;SputnikV;23027;13176;36203;681519;330234;1011753
2022.06_18-07-2022;Тверская область;21_45_days;AllVaccines;2372;2776;5148;681519;330234;1011753
2022.06_18-07-2022;Тверская область;21_45_days;CoviVac;122;25;147;681519;330234;1011753
2022.06_18-07-2022;Тверская область;21_45_days;EpiVacCorona;242;260;502;681519;330234;1011753
2022.06_18-07-2022;Тверская область;21_45_days;SputnikLite;491;677;1168;681519;330234;1011753
2022.06_18-07-2022;Тверская область;21_45_days;SputnikV;1517;1814;3331;681519;330234;1011753
2022.06_18-07-2022;Тверская область;45_75_days;AllVaccines;4156;4444;8600;681519;330234;1011753
2022.06_18-07-2022;Тверская область;45_75_days;CoviVac;259;56;315;681519;330234;1011753
2022.06_18-07-2022;Тверская область;45_75_days;EpiVacCorona;192;206;398;681519;330234;1011753
2022.06_18-07-2022;Тверская область;45_75_days;SputnikLite;1244;1756;3000;681519;330234;1011753
2022.06_18-07-2022;Тверская область;45_75_days;SputnikV;2461;2426;4887;681519;330234;1011753
2022.06_18-07-2022;Тверская область;75_90_days;AllVaccines;2658;2279;4937;681519;330234;1011753
2022.06_18-07-2022;Тверская область;75_90_days;CoviVac;169;48;217;681519;330234;1011753
2022.06_18-07-2022;Тверская область;75_90_days;EpiVacCorona;129;85;214;681519;330234;1011753
2022.06_18-07-2022;Тверская область;75_90_days;SputnikLite;1129;1049;2178;681519;330234;1011753
2022.06_18-07-2022;Тверская область;75_90_days;SputnikV;1231;1097;2328;681519;330234;1011753
2022.06_18-07-2022;Тверская область;90_105_days;AllVaccines;4478;3163;7641;681519;330234;1011753
2022.06_18-07-2022;Тверская область;90_105_days;CoviVac;83;23;106;681519;330234;1011753
2022.06_18-07-2022;Тверская область;90_105_days;EpiVacCorona;152;109;261;681519;330234;1011753
2022.06_18-07-2022;Тверская область;90_105_days;SputnikLite;2253;1919;4172;681519;330234;1011753
2022.06_18-07-2022;Тверская область;90_105_days;SputnikV;1990;1112;3102;681519;330234;1011753
2022.06_18-07-2022;Томская область;105_165_days;AllVaccines;50580;22972;73552;621613;222482;844095
2022.06_18-07-2022;Томская область;105_165_days;CoviVac;630;92;722;621613;222482;844095
2022.06_18-07-2022;Томская область;105_165_days;EpiVacCorona;2620;1061;3681;621613;222482;844095
2022.06_18-07-2022;Томская область;105_165_days;SputnikLite;29594;14647;44241;621613;222482;844095
2022.06_18-07-2022;Томская область;105_165_days;SputnikV;17736;7172;24908;621613;222482;844095
2022.06_18-07-2022;Томская область;165_195_days;AllVaccines;66748;23540;90288;621613;222482;844095
2022.06_18-07-2022;Томская область;165_195_days;CoviVac;1342;192;1534;621613;222482;844095
2022.06_18-07-2022;Томская область;165_195_days;EpiVacCorona;1045;416;1461;621613;222482;844095
2022.06_18-07-2022;Томская область;165_195_days;SputnikLite;15512;10908;26420;621613;222482;844095
2022.06_18-07-2022;Томская область;165_195_days;SputnikV;48849;12024;60873;621613;222482;844095
2022.06_18-07-2022;Томская область;21_45_days;AllVaccines;2588;1959;4547;621613;222482;844095
2022.06_18-07-2022;Томская область;21_45_days;CoviVac;167;76;243;621613;222482;844095
2022.06_18-07-2022;Томская область;21_45_days;EpiVacCorona;176;219;395;621613;222482;844095
2022.06_18-07-2022;Томская область;21_45_days;SputnikLite;824;605;1429;621613;222482;844095
2022.06_18-07-2022;Томская область;21_45_days;SputnikV;1421;1059;2480;621613;222482;844095
2022.06_18-07-2022;Томская область;45_75_days;AllVaccines;4095;2885;6980;621613;222482;844095
2022.06_18-07-2022;Томская область;45_75_days;CoviVac;175;26;201;621613;222482;844095
2022.06_18-07-2022;Томская область;45_75_days;EpiVacCorona;287;138;425;621613;222482;844095
2022.06_18-07-2022;Томская область;45_75_days;SputnikLite;1015;788;1803;621613;222482;844095
2022.06_18-07-2022;Томская область;45_75_days;SputnikV;2618;1933;4551;621613;222482;844095
2022.06_18-07-2022;Томская область;75_90_days;AllVaccines;2984;1373;4357;621613;222482;844095
2022.06_18-07-2022;Томская область;75_90_days;CoviVac;174;11;185;621613;222482;844095
2022.06_18-07-2022;Томская область;75_90_days;EpiVacCorona;228;68;296;621613;222482;844095
2022.06_18-07-2022;Томская область;75_90_days;SputnikLite;902;458;1360;621613;222482;844095
2022.06_18-07-2022;Томская область;75_90_days;SputnikV;1680;836;2516;621613;222482;844095
2022.06_18-07-2022;Томская область;90_105_days;AllVaccines;4737;2370;7107;621613;222482;844095
2022.06_18-07-2022;Томская область;90_105_days;CoviVac;48;5;53;621613;222482;844095
2022.06_18-07-2022;Томская область;90_105_days;EpiVacCorona;190;88;278;621613;222482;844095
2022.06_18-07-2022;Томская область;90_105_days;SputnikLite;2011;1095;3106;621613;222482;844095
2022.06_18-07-2022;Томская область;90_105_days;SputnikV;2488;1182;3670;621613;222482;844095
2022.06_18-07-2022;Тульская область;105_165_days;AllVaccines;66936;31482;98418;804510;401385;1205895
2022.06_18-07-2022;Тульская область;105_165_days;CoviVac;724;250;974;804510;401385;1205895
2022.06_18-07-2022;Тульская область;105_165_days;EpiVacCorona;2763;2019;4782;804510;401385;1205895
2022.06_18-07-2022;Тульская область;105_165_days;SputnikLite;42664;17973;60637;804510;401385;1205895
2022.06_18-07-2022;Тульская область;105_165_days;SputnikV;20785;11240;32025;804510;401385;1205895
2022.06_18-07-2022;Тульская область;165_195_days;AllVaccines;56049;32675;88724;804510;401385;1205895
2022.06_18-07-2022;Тульская область;165_195_days;CoviVac;541;217;758;804510;401385;1205895
2022.06_18-07-2022;Тульская область;165_195_days;EpiVacCorona;2317;1577;3894;804510;401385;1205895
2022.06_18-07-2022;Тульская область;165_195_days;SputnikLite;14178;11587;25765;804510;401385;1205895
2022.06_18-07-2022;Тульская область;165_195_days;SputnikV;39013;19294;58307;804510;401385;1205895
2022.06_18-07-2022;Тульская область;21_45_days;AllVaccines;3620;2773;6393;804510;401385;1205895
2022.06_18-07-2022;Тульская область;21_45_days;CoviVac;164;60;224;804510;401385;1205895
2022.06_18-07-2022;Тульская область;21_45_days;EpiVacCorona;230;175;405;804510;401385;1205895
2022.06_18-07-2022;Тульская область;21_45_days;SputnikLite;53;9;62;804510;401385;1205895
2022.06_18-07-2022;Тульская область;21_45_days;SputnikV;3173;2529;5702;804510;401385;1205895
2022.06_18-07-2022;Тульская область;45_75_days;AllVaccines;6897;4196;11093;804510;401385;1205895
2022.06_18-07-2022;Тульская область;45_75_days;CoviVac;156;68;224;804510;401385;1205895
2022.06_18-07-2022;Тульская область;45_75_days;EpiVacCorona;705;402;1107;804510;401385;1205895
2022.06_18-07-2022;Тульская область;45_75_days;SputnikLite;173;100;273;804510;401385;1205895
2022.06_18-07-2022;Тульская область;45_75_days;SputnikV;5863;3626;9489;804510;401385;1205895
2022.06_18-07-2022;Тульская область;75_90_days;AllVaccines;6100;2834;8934;804510;401385;1205895
2022.06_18-07-2022;Тульская область;75_90_days;CoviVac;91;18;109;804510;401385;1205895
2022.06_18-07-2022;Тульская область;75_90_days;EpiVacCorona;455;254;709;804510;401385;1205895
2022.06_18-07-2022;Тульская область;75_90_days;SputnikLite;299;173;472;804510;401385;1205895
2022.06_18-07-2022;Тульская область;75_90_days;SputnikV;5255;2389;7644;804510;401385;1205895
2022.06_18-07-2022;Тульская область;90_105_days;AllVaccines;8316;3375;11691;804510;401385;1205895
2022.06_18-07-2022;Тульская область;90_105_days;CoviVac;123;13;136;804510;401385;1205895
2022.06_18-07-2022;Тульская область;90_105_days;EpiVacCorona;720;296;1016;804510;401385;1205895
2022.06_18-07-2022;Тульская область;90_105_days;SputnikLite;967;368;1335;804510;401385;1205895
2022.06_18-07-2022;Тульская область;90_105_days;SputnikV;6506;2698;9204;804510;401385;1205895
2022.06_18-07-2022;Тюменская область;105_165_days;AllVaccines;90961;37561;128522;870789;301209;1171998
2022.06_18-07-2022;Тюменская область;105_165_days;CoviVac;444;113;557;870789;301209;1171998
2022.06_18-07-2022;Тюменская область;105_165_days;EpiVacCorona;939;491;1430;870789;301209;1171998
2022.06_18-07-2022;Тюменская область;105_165_days;SputnikLite;64521;27659;92180;870789;301209;1171998
2022.06_18-07-2022;Тюменская область;105_165_days;SputnikV;25057;9298;34355;870789;301209;1171998
2022.06_18-07-2022;Тюменская область;165_195_days;AllVaccines;106089;42452;148541;870789;301209;1171998
2022.06_18-07-2022;Тюменская область;165_195_days;CoviVac;404;89;493;870789;301209;1171998
2022.06_18-07-2022;Тюменская область;165_195_days;EpiVacCorona;449;174;623;870789;301209;1171998
2022.06_18-07-2022;Тюменская область;165_195_days;SputnikLite;30500;20929;51429;870789;301209;1171998
2022.06_18-07-2022;Тюменская область;165_195_days;SputnikV;74736;21260;95996;870789;301209;1171998
2022.06_18-07-2022;Тюменская область;21_45_days;AllVaccines;3839;2359;6198;870789;301209;1171998
2022.06_18-07-2022;Тюменская область;21_45_days;CoviVac;103;41;144;870789;301209;1171998
2022.06_18-07-2022;Тюменская область;21_45_days;EpiVacCorona;146;55;201;870789;301209;1171998
2022.06_18-07-2022;Тюменская область;21_45_days;SputnikLite;284;97;381;870789;301209;1171998
2022.06_18-07-2022;Тюменская область;21_45_days;SputnikV;3306;2166;5472;870789;301209;1171998
2022.06_18-07-2022;Тюменская область;45_75_days;AllVaccines;7006;3421;10427;870789;301209;1171998
2022.06_18-07-2022;Тюменская область;45_75_days;CoviVac;398;115;513;870789;301209;1171998
2022.06_18-07-2022;Тюменская область;45_75_days;EpiVacCorona;596;195;791;870789;301209;1171998
2022.06_18-07-2022;Тюменская область;45_75_days;SputnikLite;1230;369;1599;870789;301209;1171998
2022.06_18-07-2022;Тюменская область;45_75_days;SputnikV;4782;2742;7524;870789;301209;1171998
2022.06_18-07-2022;Тюменская область;75_90_days;AllVaccines;5325;2309;7634;870789;301209;1171998
2022.06_18-07-2022;Тюменская область;75_90_days;CoviVac;84;34;118;870789;301209;1171998
2022.06_18-07-2022;Тюменская область;75_90_days;EpiVacCorona;198;88;286;870789;301209;1171998
2022.06_18-07-2022;Тюменская область;75_90_days;SputnikLite;1628;412;2040;870789;301209;1171998
2022.06_18-07-2022;Тюменская область;75_90_days;SputnikV;3415;1775;5190;870789;301209;1171998
2022.06_18-07-2022;Тюменская область;90_105_days;AllVaccines;6255;2458;8713;870789;301209;1171998
2022.06_18-07-2022;Тюменская область;90_105_days;CoviVac;48;11;59;870789;301209;1171998
2022.06_18-07-2022;Тюменская область;90_105_days;EpiVacCorona;244;99;343;870789;301209;1171998
2022.06_18-07-2022;Тюменская область;90_105_days;SputnikLite;2096;677;2773;870789;301209;1171998
2022.06_18-07-2022;Тюменская область;90_105_days;SputnikV;3867;1671;5538;870789;301209;1171998
2022.06_18-07-2022;Удмуртская Республика;105_165_days;AllVaccines;53131;32200;85331;818861;336450;1155311
2022.06_18-07-2022;Удмуртская Республика;105_165_days;CoviVac;783;164;947;818861;336450;1155311
2022.06_18-07-2022;Удмуртская Республика;105_165_days;EpiVacCorona;2422;2047;4469;818861;336450;1155311
2022.06_18-07-2022;Удмуртская Республика;105_165_days;SputnikLite;28294;18874;47168;818861;336450;1155311
2022.06_18-07-2022;Удмуртская Республика;105_165_days;SputnikV;21632;11115;32747;818861;336450;1155311
2022.06_18-07-2022;Удмуртская Республика;165_195_days;AllVaccines;63975;31149;95124;818861;336450;1155311
2022.06_18-07-2022;Удмуртская Республика;165_195_days;CoviVac;1930;297;2227;818861;336450;1155311
2022.06_18-07-2022;Удмуртская Республика;165_195_days;EpiVacCorona;2697;1515;4212;818861;336450;1155311
2022.06_18-07-2022;Удмуртская Республика;165_195_days;SputnikLite;11265;11861;23126;818861;336450;1155311
2022.06_18-07-2022;Удмуртская Республика;165_195_days;SputnikV;48083;17476;65559;818861;336450;1155311
2022.06_18-07-2022;Удмуртская Республика;21_45_days;AllVaccines;3401;2785;6186;818861;336450;1155311
2022.06_18-07-2022;Удмуртская Республика;21_45_days;CoviVac;306;122;428;818861;336450;1155311
2022.06_18-07-2022;Удмуртская Республика;21_45_days;EpiVacCorona;508;349;857;818861;336450;1155311
2022.06_18-07-2022;Удмуртская Республика;21_45_days;SputnikLite;188;134;322;818861;336450;1155311
2022.06_18-07-2022;Удмуртская Республика;21_45_days;SputnikV;2399;2180;4579;818861;336450;1155311
2022.06_18-07-2022;Удмуртская Республика;45_75_days;AllVaccines;6102;4341;10443;818861;336450;1155311
2022.06_18-07-2022;Удмуртская Республика;45_75_days;CoviVac;1046;306;1352;818861;336450;1155311
2022.06_18-07-2022;Удмуртская Республика;45_75_days;EpiVacCorona;593;577;1170;818861;336450;1155311
2022.06_18-07-2022;Удмуртская Республика;45_75_days;SputnikLite;593;375;968;818861;336450;1155311
2022.06_18-07-2022;Удмуртская Республика;45_75_days;SputnikV;3870;3083;6953;818861;336450;1155311
2022.06_18-07-2022;Удмуртская Республика;75_90_days;AllVaccines;4596;2882;7478;818861;336450;1155311
2022.06_18-07-2022;Удмуртская Республика;75_90_days;CoviVac;202;32;234;818861;336450;1155311
2022.06_18-07-2022;Удмуртская Республика;75_90_days;EpiVacCorona;348;261;609;818861;336450;1155311
2022.06_18-07-2022;Удмуртская Республика;75_90_days;SputnikLite;518;285;803;818861;336450;1155311
2022.06_18-07-2022;Удмуртская Республика;75_90_days;SputnikV;3528;2304;5832;818861;336450;1155311
2022.06_18-07-2022;Удмуртская Республика;90_105_days;AllVaccines;5885;3005;8890;818861;336450;1155311
2022.06_18-07-2022;Удмуртская Республика;90_105_days;CoviVac;158;30;188;818861;336450;1155311
2022.06_18-07-2022;Удмуртская Республика;90_105_days;EpiVacCorona;419;258;677;818861;336450;1155311
2022.06_18-07-2022;Удмуртская Республика;90_105_days;SputnikLite;1580;947;2527;818861;336450;1155311
2022.06_18-07-2022;Удмуртская Республика;90_105_days;SputnikV;3728;1770;5498;818861;336450;1155311
2022.06_18-07-2022;Ульяновская область;105_165_days;AllVaccines;41820;22203;64023;672149;320065;992214
2022.06_18-07-2022;Ульяновская область;105_165_days;CoviVac;413;114;527;672149;320065;992214
2022.06_18-07-2022;Ульяновская область;105_165_days;EpiVacCorona;1768;1100;2868;672149;320065;992214
2022.06_18-07-2022;Ульяновская область;105_165_days;SputnikLite;25049;13760;38809;672149;320065;992214
2022.06_18-07-2022;Ульяновская область;105_165_days;SputnikV;14590;7229;21819;672149;320065;992214
2022.06_18-07-2022;Ульяновская область;165_195_days;AllVaccines;58207;31581;89788;672149;320065;992214
2022.06_18-07-2022;Ульяновская область;165_195_days;CoviVac;762;174;936;672149;320065;992214
2022.06_18-07-2022;Ульяновская область;165_195_days;EpiVacCorona;1963;989;2952;672149;320065;992214
2022.06_18-07-2022;Ульяновская область;165_195_days;SputnikLite;12572;12035;24607;672149;320065;992214
2022.06_18-07-2022;Ульяновская область;165_195_days;SputnikV;42910;18383;61293;672149;320065;992214
2022.06_18-07-2022;Ульяновская область;21_45_days;AllVaccines;2664;2477;5141;672149;320065;992214
2022.06_18-07-2022;Ульяновская область;21_45_days;CoviVac;163;146;309;672149;320065;992214
2022.06_18-07-2022;Ульяновская область;21_45_days;EpiVacCorona;271;185;456;672149;320065;992214
2022.06_18-07-2022;Ульяновская область;21_45_days;SputnikLite;194;99;293;672149;320065;992214
2022.06_18-07-2022;Ульяновская область;21_45_days;SputnikV;2036;2047;4083;672149;320065;992214
2022.06_18-07-2022;Ульяновская область;45_75_days;AllVaccines;4431;2943;7374;672149;320065;992214
2022.06_18-07-2022;Ульяновская область;45_75_days;CoviVac;143;40;183;672149;320065;992214
2022.06_18-07-2022;Ульяновская область;45_75_days;EpiVacCorona;212;134;346;672149;320065;992214
2022.06_18-07-2022;Ульяновская область;45_75_days;SputnikLite;405;273;678;672149;320065;992214
2022.06_18-07-2022;Ульяновская область;45_75_days;SputnikV;3671;2496;6167;672149;320065;992214
2022.06_18-07-2022;Ульяновская область;75_90_days;AllVaccines;2992;1623;4615;672149;320065;992214
2022.06_18-07-2022;Ульяновская область;75_90_days;CoviVac;60;13;73;672149;320065;992214
2022.06_18-07-2022;Ульяновская область;75_90_days;EpiVacCorona;186;88;274;672149;320065;992214
2022.06_18-07-2022;Ульяновская область;75_90_days;SputnikLite;265;163;428;672149;320065;992214
2022.06_18-07-2022;Ульяновская область;75_90_days;SputnikV;2481;1359;3840;672149;320065;992214
2022.06_18-07-2022;Ульяновская область;90_105_days;AllVaccines;3356;1693;5049;672149;320065;992214
2022.06_18-07-2022;Ульяновская область;90_105_days;CoviVac;34;22;56;672149;320065;992214
2022.06_18-07-2022;Ульяновская область;90_105_days;EpiVacCorona;250;133;383;672149;320065;992214
2022.06_18-07-2022;Ульяновская область;90_105_days;SputnikLite;900;415;1315;672149;320065;992214
2022.06_18-07-2022;Ульяновская область;90_105_days;SputnikV;2172;1123;3295;672149;320065;992214
2022.06_18-07-2022;Хабаровский край;105_165_days;AllVaccines;58573;26795;85368;757169;265178;1022347
2022.06_18-07-2022;Хабаровский край;105_165_days;CoviVac;841;163;1004;757169;265178;1022347
2022.06_18-07-2022;Хабаровский край;105_165_days;EpiVacCorona;3862;1585;5447;757169;265178;1022347
2022.06_18-07-2022;Хабаровский край;105_165_days;SputnikLite;27981;13383;41364;757169;265178;1022347
2022.06_18-07-2022;Хабаровский край;105_165_days;SputnikV;25889;11664;37553;757169;265178;1022347
2022.06_18-07-2022;Хабаровский край;165_195_days;AllVaccines;67831;24165;91996;757169;265178;1022347
2022.06_18-07-2022;Хабаровский край;165_195_days;CoviVac;1270;262;1532;757169;265178;1022347
2022.06_18-07-2022;Хабаровский край;165_195_days;EpiVacCorona;4192;1386;5578;757169;265178;1022347
2022.06_18-07-2022;Хабаровский край;165_195_days;SputnikLite;19097;9081;28178;757169;265178;1022347
2022.06_18-07-2022;Хабаровский край;165_195_days;SputnikV;43272;13436;56708;757169;265178;1022347
2022.06_18-07-2022;Хабаровский край;21_45_days;AllVaccines;3389;2182;5571;757169;265178;1022347
2022.06_18-07-2022;Хабаровский край;21_45_days;CoviVac;209;122;331;757169;265178;1022347
2022.06_18-07-2022;Хабаровский край;21_45_days;EpiVacCorona;750;504;1254;757169;265178;1022347
2022.06_18-07-2022;Хабаровский край;21_45_days;SputnikLite;451;244;695;757169;265178;1022347
2022.06_18-07-2022;Хабаровский край;21_45_days;SputnikV;1979;1312;3291;757169;265178;1022347
2022.06_18-07-2022;Хабаровский край;45_75_days;AllVaccines;4779;3188;7967;757169;265178;1022347
2022.06_18-07-2022;Хабаровский край;45_75_days;CoviVac;108;44;152;757169;265178;1022347
2022.06_18-07-2022;Хабаровский край;45_75_days;EpiVacCorona;482;393;875;757169;265178;1022347
2022.06_18-07-2022;Хабаровский край;45_75_days;SputnikLite;1026;402;1428;757169;265178;1022347
2022.06_18-07-2022;Хабаровский край;45_75_days;SputnikV;3163;2349;5512;757169;265178;1022347
2022.06_18-07-2022;Хабаровский край;75_90_days;AllVaccines;3083;1637;4720;757169;265178;1022347
2022.06_18-07-2022;Хабаровский край;75_90_days;CoviVac;119;67;186;757169;265178;1022347
2022.06_18-07-2022;Хабаровский край;75_90_days;EpiVacCorona;227;147;374;757169;265178;1022347
2022.06_18-07-2022;Хабаровский край;75_90_days;SputnikLite;564;217;781;757169;265178;1022347
2022.06_18-07-2022;Хабаровский край;75_90_days;SputnikV;2173;1206;3379;757169;265178;1022347
2022.06_18-07-2022;Хабаровский край;90_105_days;AllVaccines;4162;1757;5919;757169;265178;1022347
2022.06_18-07-2022;Хабаровский край;90_105_days;CoviVac;79;17;96;757169;265178;1022347
2022.06_18-07-2022;Хабаровский край;90_105_days;EpiVacCorona;279;111;390;757169;265178;1022347
2022.06_18-07-2022;Хабаровский край;90_105_days;SputnikLite;1054;454;1508;757169;265178;1022347
2022.06_18-07-2022;Хабаровский край;90_105_days;SputnikV;2750;1175;3925;757169;265178;1022347
2022.06_18-07-2022;Ханты-Мансийский автономный округ - Югра;105_165_days;AllVaccines;99113;21994;121107;1019471;240107;1259578
2022.06_18-07-2022;Ханты-Мансийский автономный округ - Югра;105_165_days;CoviVac;507;109;616;1019471;240107;1259578
2022.06_18-07-2022;Ханты-Мансийский автономный округ - Югра;105_165_days;EpiVacCorona;1158;349;1507;1019471;240107;1259578
2022.06_18-07-2022;Ханты-Мансийский автономный округ - Югра;105_165_days;SputnikLite;66983;14683;81666;1019471;240107;1259578
2022.06_18-07-2022;Ханты-Мансийский автономный округ - Югра;105_165_days;SputnikV;30465;6853;37318;1019471;240107;1259578
2022.06_18-07-2022;Ханты-Мансийский автономный округ - Югра;165_195_days;AllVaccines;90286;23243;113529;1019471;240107;1259578
2022.06_18-07-2022;Ханты-Мансийский автономный округ - Югра;165_195_days;CoviVac;402;69;471;1019471;240107;1259578
2022.06_18-07-2022;Ханты-Мансийский автономный округ - Югра;165_195_days;EpiVacCorona;1268;501;1769;1019471;240107;1259578
2022.06_18-07-2022;Ханты-Мансийский автономный округ - Югра;165_195_days;SputnikLite;33800;10236;44036;1019471;240107;1259578
2022.06_18-07-2022;Ханты-Мансийский автономный округ - Югра;165_195_days;SputnikV;54816;12437;67253;1019471;240107;1259578
2022.06_18-07-2022;Ханты-Мансийский автономный округ - Югра;21_45_days;AllVaccines;6446;1402;7848;1019471;240107;1259578
2022.06_18-07-2022;Ханты-Мансийский автономный округ - Югра;21_45_days;CoviVac;107;17;124;1019471;240107;1259578
2022.06_18-07-2022;Ханты-Мансийский автономный округ - Югра;21_45_days;EpiVacCorona;472;100;572;1019471;240107;1259578
2022.06_18-07-2022;Ханты-Мансийский автономный округ - Югра;21_45_days;SputnikLite;409;108;517;1019471;240107;1259578
2022.06_18-07-2022;Ханты-Мансийский автономный округ - Югра;21_45_days;SputnikV;5458;1177;6635;1019471;240107;1259578
2022.06_18-07-2022;Ханты-Мансийский автономный округ - Югра;45_75_days;AllVaccines;10273;2170;12443;1019471;240107;1259578
2022.06_18-07-2022;Ханты-Мансийский автономный округ - Югра;45_75_days;CoviVac;359;41;400;1019471;240107;1259578
2022.06_18-07-2022;Ханты-Мансийский автономный округ - Югра;45_75_days;EpiVacCorona;577;156;733;1019471;240107;1259578
2022.06_18-07-2022;Ханты-Мансийский автономный округ - Югра;45_75_days;SputnikLite;1282;258;1540;1019471;240107;1259578
2022.06_18-07-2022;Ханты-Мансийский автономный округ - Югра;45_75_days;SputnikV;8055;1715;9770;1019471;240107;1259578
2022.06_18-07-2022;Ханты-Мансийский автономный округ - Югра;75_90_days;AllVaccines;6742;1362;8104;1019471;240107;1259578
2022.06_18-07-2022;Ханты-Мансийский автономный округ - Югра;75_90_days;CoviVac;144;23;167;1019471;240107;1259578
2022.06_18-07-2022;Ханты-Мансийский автономный округ - Югра;75_90_days;EpiVacCorona;192;40;232;1019471;240107;1259578
2022.06_18-07-2022;Ханты-Мансийский автономный округ - Югра;75_90_days;SputnikLite;1403;399;1802;1019471;240107;1259578
2022.06_18-07-2022;Ханты-Мансийский автономный округ - Югра;75_90_days;SputnikV;5003;900;5903;1019471;240107;1259578
2022.06_18-07-2022;Ханты-Мансийский автономный округ - Югра;90_105_days;AllVaccines;10540;1939;12479;1019471;240107;1259578
2022.06_18-07-2022;Ханты-Мансийский автономный округ - Югра;90_105_days;CoviVac;105;15;120;1019471;240107;1259578
2022.06_18-07-2022;Ханты-Мансийский автономный округ - Югра;90_105_days;EpiVacCorona;123;29;152;1019471;240107;1259578
2022.06_18-07-2022;Ханты-Мансийский автономный округ - Югра;90_105_days;SputnikLite;4342;776;5118;1019471;240107;1259578
2022.06_18-07-2022;Ханты-Мансийский автономный округ - Югра;90_105_days;SputnikV;5970;1119;7089;1019471;240107;1259578
2022.06_18-07-2022;Челябинская область;105_165_days;AllVaccines;132627;69973;202600;1901705;795956;2697661
2022.06_18-07-2022;Челябинская область;105_165_days;CoviVac;867;258;1125;1901705;795956;2697661
2022.06_18-07-2022;Челябинская область;105_165_days;EpiVacCorona;5706;4437;10143;1901705;795956;2697661
2022.06_18-07-2022;Челябинская область;105_165_days;SputnikLite;83151;41540;124691;1901705;795956;2697661
2022.06_18-07-2022;Челябинская область;105_165_days;SputnikV;42903;23738;66641;1901705;795956;2697661
2022.06_18-07-2022;Челябинская область;165_195_days;AllVaccines;181291;84539;265830;1901705;795956;2697661
2022.06_18-07-2022;Челябинская область;165_195_days;CoviVac;1197;349;1546;1901705;795956;2697661
2022.06_18-07-2022;Челябинская область;165_195_days;EpiVacCorona;5286;2739;8025;1901705;795956;2697661
2022.06_18-07-2022;Челябинская область;165_195_days;SputnikLite;47727;27815;75542;1901705;795956;2697661
2022.06_18-07-2022;Челябинская область;165_195_days;SputnikV;127081;53636;180717;1901705;795956;2697661
2022.06_18-07-2022;Челябинская область;21_45_days;AllVaccines;12493;9842;22335;1901705;795956;2697661
2022.06_18-07-2022;Челябинская область;21_45_days;CoviVac;533;296;829;1901705;795956;2697661
2022.06_18-07-2022;Челябинская область;21_45_days;EpiVacCorona;970;592;1562;1901705;795956;2697661
2022.06_18-07-2022;Челябинская область;21_45_days;SputnikLite;3863;2078;5941;1901705;795956;2697661
2022.06_18-07-2022;Челябинская область;21_45_days;SputnikV;7127;6876;14003;1901705;795956;2697661
2022.06_18-07-2022;Челябинская область;45_75_days;AllVaccines;19625;13268;32893;1901705;795956;2697661
2022.06_18-07-2022;Челябинская область;45_75_days;CoviVac;950;287;1237;1901705;795956;2697661
2022.06_18-07-2022;Челябинская область;45_75_days;EpiVacCorona;1449;999;2448;1901705;795956;2697661
2022.06_18-07-2022;Челябинская область;45_75_days;SputnikLite;7791;4621;12412;1901705;795956;2697661
2022.06_18-07-2022;Челябинская область;45_75_days;SputnikV;9435;7361;16796;1901705;795956;2697661
2022.06_18-07-2022;Челябинская область;75_90_days;AllVaccines;12068;6987;19055;1901705;795956;2697661
2022.06_18-07-2022;Челябинская область;75_90_days;CoviVac;172;36;208;1901705;795956;2697661
2022.06_18-07-2022;Челябинская область;75_90_days;EpiVacCorona;577;526;1103;1901705;795956;2697661
2022.06_18-07-2022;Челябинская область;75_90_days;SputnikLite;5175;2779;7954;1901705;795956;2697661
2022.06_18-07-2022;Челябинская область;75_90_days;SputnikV;6144;3646;9790;1901705;795956;2697661
2022.06_18-07-2022;Челябинская область;90_105_days;AllVaccines;14990;7429;22419;1901705;795956;2697661
2022.06_18-07-2022;Челябинская область;90_105_days;CoviVac;96;21;117;1901705;795956;2697661
2022.06_18-07-2022;Челябинская область;90_105_days;EpiVacCorona;640;941;1581;1901705;795956;2697661
2022.06_18-07-2022;Челябинская область;90_105_days;SputnikLite;6594;3310;9904;1901705;795956;2697661
2022.06_18-07-2022;Челябинская область;90_105_days;SputnikV;7660;3157;10817;1901705;795956;2697661
2022.06_18-07-2022;Чеченская Республика;105_165_days;AllVaccines;42099;5545;47644;809759;137234;946993
2022.06_18-07-2022;Чеченская Республика;105_165_days;CoviVac;294;39;333;809759;137234;946993
2022.06_18-07-2022;Чеченская Республика;105_165_days;EpiVacCorona;1250;216;1466;809759;137234;946993
2022.06_18-07-2022;Чеченская Республика;105_165_days;SputnikLite;33752;4314;38066;809759;137234;946993
2022.06_18-07-2022;Чеченская Республика;105_165_days;SputnikV;6803;976;7779;809759;137234;946993
2022.06_18-07-2022;Чеченская Республика;165_195_days;AllVaccines;23780;2879;26659;809759;137234;946993
2022.06_18-07-2022;Чеченская Республика;165_195_days;CoviVac;157;28;185;809759;137234;946993
2022.06_18-07-2022;Чеченская Республика;165_195_days;EpiVacCorona;2114;333;2447;809759;137234;946993
2022.06_18-07-2022;Чеченская Республика;165_195_days;SputnikLite;14104;1359;15463;809759;137234;946993
2022.06_18-07-2022;Чеченская Республика;165_195_days;SputnikV;7405;1159;8564;809759;137234;946993
2022.06_18-07-2022;Чеченская Республика;21_45_days;AllVaccines;5073;1026;6099;809759;137234;946993
2022.06_18-07-2022;Чеченская Республика;21_45_days;CoviVac;157;35;192;809759;137234;946993
2022.06_18-07-2022;Чеченская Республика;21_45_days;EpiVacCorona;1;0;1;809759;137234;946993
2022.06_18-07-2022;Чеченская Республика;21_45_days;SputnikLite;450;44;494;809759;137234;946993
2022.06_18-07-2022;Чеченская Республика;21_45_days;SputnikV;4465;947;5412;809759;137234;946993
2022.06_18-07-2022;Чеченская Республика;45_75_days;AllVaccines;12177;1979;14156;809759;137234;946993
2022.06_18-07-2022;Чеченская Республика;45_75_days;CoviVac;778;147;925;809759;137234;946993
2022.06_18-07-2022;Чеченская Республика;45_75_days;EpiVacCorona;39;2;41;809759;137234;946993
2022.06_18-07-2022;Чеченская Республика;45_75_days;SputnikLite;7979;1199;9178;809759;137234;946993
2022.06_18-07-2022;Чеченская Республика;45_75_days;SputnikV;3381;631;4012;809759;137234;946993
2022.06_18-07-2022;Чеченская Республика;75_90_days;AllVaccines;5486;1190;6676;809759;137234;946993
2022.06_18-07-2022;Чеченская Республика;75_90_days;CoviVac;925;135;1060;809759;137234;946993
2022.06_18-07-2022;Чеченская Республика;75_90_days;EpiVacCorona;72;1;73;809759;137234;946993
2022.06_18-07-2022;Чеченская Республика;75_90_days;SputnikLite;1535;459;1994;809759;137234;946993
2022.06_18-07-2022;Чеченская Республика;75_90_days;SputnikV;2954;595;3549;809759;137234;946993
2022.06_18-07-2022;Чеченская Республика;90_105_days;AllVaccines;8858;1712;10570;809759;137234;946993
2022.06_18-07-2022;Чеченская Республика;90_105_days;CoviVac;2443;506;2949;809759;137234;946993
2022.06_18-07-2022;Чеченская Республика;90_105_days;EpiVacCorona;105;12;117;809759;137234;946993
2022.06_18-07-2022;Чеченская Республика;90_105_days;SputnikLite;1415;303;1718;809759;137234;946993
2022.06_18-07-2022;Чеченская Республика;90_105_days;SputnikV;4895;891;5786;809759;137234;946993
2022.06_18-07-2022;Чувашская Республика;105_165_days;AllVaccines;55424;26109;81533;674689;275580;950269
2022.06_18-07-2022;Чувашская Республика;105_165_days;CoviVac;905;167;1072;674689;275580;950269
2022.06_18-07-2022;Чувашская Республика;105_165_days;EpiVacCorona;2387;1204;3591;674689;275580;950269
2022.06_18-07-2022;Чувашская Республика;105_165_days;SputnikLite;29974;14578;44552;674689;275580;950269
2022.06_18-07-2022;Чувашская Республика;105_165_days;SputnikV;22158;10160;32318;674689;275580;950269
2022.06_18-07-2022;Чувашская Республика;165_195_days;AllVaccines;61554;30991;92545;674689;275580;950269
2022.06_18-07-2022;Чувашская Республика;165_195_days;CoviVac;822;102;924;674689;275580;950269
2022.06_18-07-2022;Чувашская Республика;165_195_days;EpiVacCorona;1645;604;2249;674689;275580;950269
2022.06_18-07-2022;Чувашская Республика;165_195_days;SputnikLite;12279;12344;24623;674689;275580;950269
2022.06_18-07-2022;Чувашская Республика;165_195_days;SputnikV;46808;17941;64749;674689;275580;950269
2022.06_18-07-2022;Чувашская Республика;21_45_days;AllVaccines;3749;3108;6857;674689;275580;950269
2022.06_18-07-2022;Чувашская Республика;21_45_days;CoviVac;104;55;159;674689;275580;950269
2022.06_18-07-2022;Чувашская Республика;21_45_days;EpiVacCorona;663;362;1025;674689;275580;950269
2022.06_18-07-2022;Чувашская Республика;21_45_days;SputnikLite;1378;970;2348;674689;275580;950269
2022.06_18-07-2022;Чувашская Республика;21_45_days;SputnikV;1604;1721;3325;674689;275580;950269
2022.06_18-07-2022;Чувашская Республика;45_75_days;AllVaccines;6967;4538;11505;674689;275580;950269
2022.06_18-07-2022;Чувашская Республика;45_75_days;CoviVac;876;288;1164;674689;275580;950269
2022.06_18-07-2022;Чувашская Республика;45_75_days;EpiVacCorona;381;289;670;674689;275580;950269
2022.06_18-07-2022;Чувашская Республика;45_75_days;SputnikLite;1275;1042;2317;674689;275580;950269
2022.06_18-07-2022;Чувашская Республика;45_75_days;SputnikV;4435;2919;7354;674689;275580;950269
2022.06_18-07-2022;Чувашская Республика;75_90_days;AllVaccines;4896;3062;7958;674689;275580;950269
2022.06_18-07-2022;Чувашская Республика;75_90_days;CoviVac;56;5;61;674689;275580;950269
2022.06_18-07-2022;Чувашская Республика;75_90_days;EpiVacCorona;349;298;647;674689;275580;950269
2022.06_18-07-2022;Чувашская Республика;75_90_days;SputnikLite;744;416;1160;674689;275580;950269
2022.06_18-07-2022;Чувашская Республика;75_90_days;SputnikV;3747;2343;6090;674689;275580;950269
2022.06_18-07-2022;Чувашская Республика;90_105_days;AllVaccines;4423;2190;6613;674689;275580;950269
2022.06_18-07-2022;Чувашская Республика;90_105_days;CoviVac;107;15;122;674689;275580;950269
2022.06_18-07-2022;Чувашская Республика;90_105_days;EpiVacCorona;364;209;573;674689;275580;950269
2022.06_18-07-2022;Чувашская Республика;90_105_days;SputnikLite;1706;751;2457;674689;275580;950269
2022.06_18-07-2022;Чувашская Республика;90_105_days;SputnikV;2246;1215;3461;674689;275580;950269
2022.06_18-07-2022;Чукотский автономный округ;105_165_days;AllVaccines;3227;459;3686;30806;6299;37105
2022.06_18-07-2022;Чукотский автономный округ;105_165_days;CoviVac;121;14;135;30806;6299;37105
2022.06_18-07-2022;Чукотский автономный округ;105_165_days;EpiVacCorona;179;30;209;30806;6299;37105
2022.06_18-07-2022;Чукотский автономный округ;105_165_days;SputnikLite;2396;317;2713;30806;6299;37105
2022.06_18-07-2022;Чукотский автономный округ;105_165_days;SputnikV;531;98;629;30806;6299;37105
2022.06_18-07-2022;Чукотский автономный округ;165_195_days;AllVaccines;2480;446;2926;30806;6299;37105
2022.06_18-07-2022;Чукотский автономный округ;165_195_days;CoviVac;64;11;75;30806;6299;37105
2022.06_18-07-2022;Чукотский автономный округ;165_195_days;EpiVacCorona;293;44;337;30806;6299;37105
2022.06_18-07-2022;Чукотский автономный округ;165_195_days;SputnikLite;1636;329;1965;30806;6299;37105
2022.06_18-07-2022;Чукотский автономный округ;165_195_days;SputnikV;487;62;549;30806;6299;37105
2022.06_18-07-2022;Чукотский автономный округ;21_45_days;AllVaccines;379;59;438;30806;6299;37105
2022.06_18-07-2022;Чукотский автономный округ;21_45_days;CoviVac;19;2;21;30806;6299;37105
2022.06_18-07-2022;Чукотский автономный округ;21_45_days;EpiVacCorona;65;10;75;30806;6299;37105
2022.06_18-07-2022;Чукотский автономный округ;21_45_days;SputnikLite;223;39;262;30806;6299;37105
2022.06_18-07-2022;Чукотский автономный округ;21_45_days;SputnikV;72;8;80;30806;6299;37105
2022.06_18-07-2022;Чукотский автономный округ;45_75_days;AllVaccines;541;123;664;30806;6299;37105
2022.06_18-07-2022;Чукотский автономный округ;45_75_days;CoviVac;23;4;27;30806;6299;37105
2022.06_18-07-2022;Чукотский автономный округ;45_75_days;EpiVacCorona;26;7;33;30806;6299;37105
2022.06_18-07-2022;Чукотский автономный округ;45_75_days;SputnikLite;310;76;386;30806;6299;37105
2022.06_18-07-2022;Чукотский автономный округ;45_75_days;SputnikV;182;36;218;30806;6299;37105
2022.06_18-07-2022;Чукотский автономный округ;75_90_days;AllVaccines;370;65;435;30806;6299;37105
2022.06_18-07-2022;Чукотский автономный округ;75_90_days;CoviVac;5;0;5;30806;6299;37105
2022.06_18-07-2022;Чукотский автономный округ;75_90_days;EpiVacCorona;10;1;11;30806;6299;37105
2022.06_18-07-2022;Чукотский автономный округ;75_90_days;SputnikLite;247;40;287;30806;6299;37105
2022.06_18-07-2022;Чукотский автономный округ;75_90_days;SputnikV;108;24;132;30806;6299;37105
2022.06_18-07-2022;Чукотский автономный округ;90_105_days;AllVaccines;492;85;577;30806;6299;37105
2022.06_18-07-2022;Чукотский автономный округ;90_105_days;CoviVac;10;1;11;30806;6299;37105
2022.06_18-07-2022;Чукотский автономный округ;90_105_days;EpiVacCorona;21;1;22;30806;6299;37105
2022.06_18-07-2022;Чукотский автономный округ;90_105_days;SputnikLite;319;58;377;30806;6299;37105
2022.06_18-07-2022;Чукотский автономный округ;90_105_days;SputnikV;142;25;167;30806;6299;37105
2022.06_18-07-2022;Ямало-Ненецкий автономный округ;105_165_days;AllVaccines;32104;4066;36170;346064;56429;402493
2022.06_18-07-2022;Ямало-Ненецкий автономный округ;105_165_days;CoviVac;250;36;286;346064;56429;402493
2022.06_18-07-2022;Ямало-Ненецкий автономный округ;105_165_days;EpiVacCorona;383;46;429;346064;56429;402493
2022.06_18-07-2022;Ямало-Ненецкий автономный округ;105_165_days;SputnikLite;23270;2903;26173;346064;56429;402493
2022.06_18-07-2022;Ямало-Ненецкий автономный округ;105_165_days;SputnikV;8201;1081;9282;346064;56429;402493
2022.06_18-07-2022;Ямало-Ненецкий автономный округ;165_195_days;AllVaccines;25222;3370;28592;346064;56429;402493
2022.06_18-07-2022;Ямало-Ненецкий автономный округ;165_195_days;CoviVac;311;54;365;346064;56429;402493
2022.06_18-07-2022;Ямало-Ненецкий автономный округ;165_195_days;EpiVacCorona;118;23;141;346064;56429;402493
2022.06_18-07-2022;Ямало-Ненецкий автономный округ;165_195_days;SputnikLite;10884;1848;12732;346064;56429;402493
2022.06_18-07-2022;Ямало-Ненецкий автономный округ;165_195_days;SputnikV;13909;1445;15354;346064;56429;402493
2022.06_18-07-2022;Ямало-Ненецкий автономный округ;21_45_days;AllVaccines;3348;551;3899;346064;56429;402493
2022.06_18-07-2022;Ямало-Ненецкий автономный округ;21_45_days;CoviVac;65;9;74;346064;56429;402493
2022.06_18-07-2022;Ямало-Ненецкий автономный округ;21_45_days;EpiVacCorona;63;13;76;346064;56429;402493
2022.06_18-07-2022;Ямало-Ненецкий автономный округ;21_45_days;SputnikLite;2481;425;2906;346064;56429;402493
2022.06_18-07-2022;Ямало-Ненецкий автономный округ;21_45_days;SputnikV;739;104;843;346064;56429;402493
2022.06_18-07-2022;Ямало-Ненецкий автономный округ;45_75_days;AllVaccines;5027;685;5712;346064;56429;402493
2022.06_18-07-2022;Ямало-Ненецкий автономный округ;45_75_days;CoviVac;64;9;73;346064;56429;402493
2022.06_18-07-2022;Ямало-Ненецкий автономный округ;45_75_days;EpiVacCorona;90;12;102;346064;56429;402493
2022.06_18-07-2022;Ямало-Ненецкий автономный округ;45_75_days;SputnikLite;3659;500;4159;346064;56429;402493
2022.06_18-07-2022;Ямало-Ненецкий автономный округ;45_75_days;SputnikV;1214;164;1378;346064;56429;402493
2022.06_18-07-2022;Ямало-Ненецкий автономный округ;75_90_days;AllVaccines;2969;353;3322;346064;56429;402493
2022.06_18-07-2022;Ямало-Ненецкий автономный округ;75_90_days;CoviVac;19;3;22;346064;56429;402493
2022.06_18-07-2022;Ямало-Ненецкий автономный округ;75_90_days;EpiVacCorona;70;13;83;346064;56429;402493
2022.06_18-07-2022;Ямало-Ненецкий автономный округ;75_90_days;SputnikLite;1808;224;2032;346064;56429;402493
2022.06_18-07-2022;Ямало-Ненецкий автономный округ;75_90_days;SputnikV;1072;113;1185;346064;56429;402493
2022.06_18-07-2022;Ямало-Ненецкий автономный округ;90_105_days;AllVaccines;3563;417;3980;346064;56429;402493
2022.06_18-07-2022;Ямало-Ненецкий автономный округ;90_105_days;CoviVac;33;4;37;346064;56429;402493
2022.06_18-07-2022;Ямало-Ненецкий автономный округ;90_105_days;EpiVacCorona;87;12;99;346064;56429;402493
2022.06_18-07-2022;Ямало-Ненецкий автономный округ;90_105_days;SputnikLite;2208;264;2472;346064;56429;402493
2022.06_18-07-2022;Ямало-Ненецкий автономный округ;90_105_days;SputnikV;1235;137;1372;346064;56429;402493
2022.06_18-07-2022;Ярославская область;105_165_days;AllVaccines;41557;22169;63726;682586;317712;1000298
2022.06_18-07-2022;Ярославская область;105_165_days;CoviVac;911;224;1135;682586;317712;1000298
2022.06_18-07-2022;Ярославская область;105_165_days;EpiVacCorona;1248;561;1809;682586;317712;1000298
2022.06_18-07-2022;Ярославская область;105_165_days;SputnikLite;24230;13350;37580;682586;317712;1000298
2022.06_18-07-2022;Ярославская область;105_165_days;SputnikV;15168;8034;23202;682586;317712;1000298
2022.06_18-07-2022;Ярославская область;165_195_days;AllVaccines;45590;24976;70566;682586;317712;1000298
2022.06_18-07-2022;Ярославская область;165_195_days;CoviVac;873;176;1049;682586;317712;1000298
2022.06_18-07-2022;Ярославская область;165_195_days;EpiVacCorona;1203;595;1798;682586;317712;1000298
2022.06_18-07-2022;Ярославская область;165_195_days;SputnikLite;16786;11292;28078;682586;317712;1000298
2022.06_18-07-2022;Ярославская область;165_195_days;SputnikV;26728;12913;39641;682586;317712;1000298
2022.06_18-07-2022;Ярославская область;21_45_days;AllVaccines;2014;1577;3591;682586;317712;1000298
2022.06_18-07-2022;Ярославская область;21_45_days;CoviVac;168;98;266;682586;317712;1000298
2022.06_18-07-2022;Ярославская область;21_45_days;EpiVacCorona;75;66;141;682586;317712;1000298
2022.06_18-07-2022;Ярославская область;21_45_days;SputnikLite;246;100;346;682586;317712;1000298
2022.06_18-07-2022;Ярославская область;21_45_days;SputnikV;1525;1313;2838;682586;317712;1000298
2022.06_18-07-2022;Ярославская область;45_75_days;AllVaccines;3758;2789;6547;682586;317712;1000298
2022.06_18-07-2022;Ярославская область;45_75_days;CoviVac;201;89;290;682586;317712;1000298
2022.06_18-07-2022;Ярославская область;45_75_days;EpiVacCorona;151;89;240;682586;317712;1000298
2022.06_18-07-2022;Ярославская область;45_75_days;SputnikLite;994;483;1477;682586;317712;1000298
2022.06_18-07-2022;Ярославская область;45_75_days;SputnikV;2412;2128;4540;682586;317712;1000298
2022.06_18-07-2022;Ярославская область;75_90_days;AllVaccines;3022;1738;4760;682586;317712;1000298
2022.06_18-07-2022;Ярославская область;75_90_days;CoviVac;122;26;148;682586;317712;1000298
2022.06_18-07-2022;Ярославская область;75_90_days;EpiVacCorona;124;45;169;682586;317712;1000298
2022.06_18-07-2022;Ярославская область;75_90_days;SputnikLite;715;372;1087;682586;317712;1000298
2022.06_18-07-2022;Ярославская область;75_90_days;SputnikV;2061;1295;3356;682586;317712;1000298
2022.06_18-07-2022;Ярославская область;90_105_days;AllVaccines;3839;1724;5563;682586;317712;1000298
2022.06_18-07-2022;Ярославская область;90_105_days;CoviVac;146;44;190;682586;317712;1000298
2022.06_18-07-2022;Ярославская область;90_105_days;EpiVacCorona;171;71;242;682586;317712;1000298
2022.06_18-07-2022;Ярославская область;90_105_days;SputnikLite;1149;558;1707;682586;317712;1000298
2022.06_18-07-2022;Ярославская область;90_105_days;SputnikV;2373;1051;3424;682586;317712;1000298
2022.06_18-07-2022;г. Москва;105_165_days;AllVaccines;490713;192433;683146;7299088;3167729;10466817
2022.06_18-07-2022;г. Москва;105_165_days;CoviVac;7400;762;8162;7299088;3167729;10466817
2022.06_18-07-2022;г. Москва;105_165_days;EpiVacCorona;450;199;649;7299088;3167729;10466817
2022.06_18-07-2022;г. Москва;105_165_days;SputnikLite;310155;124592;434747;7299088;3167729;10466817
2022.06_18-07-2022;г. Москва;105_165_days;SputnikV;172708;66880;239588;7299088;3167729;10466817
2022.06_18-07-2022;г. Москва;165_195_days;AllVaccines;346992;201594;548586;7299088;3167729;10466817
2022.06_18-07-2022;г. Москва;165_195_days;CoviVac;17322;1808;19130;7299088;3167729;10466817
2022.06_18-07-2022;г. Москва;165_195_days;EpiVacCorona;1100;676;1776;7299088;3167729;10466817
2022.06_18-07-2022;г. Москва;165_195_days;SputnikLite;98864;82402;181266;7299088;3167729;10466817
2022.06_18-07-2022;г. Москва;165_195_days;SputnikV;229706;116708;346414;7299088;3167729;10466817
2022.06_18-07-2022;г. Москва;21_45_days;AllVaccines;11982;8300;20282;7299088;3167729;10466817
2022.06_18-07-2022;г. Москва;21_45_days;CoviVac;411;58;469;7299088;3167729;10466817
2022.06_18-07-2022;г. Москва;21_45_days;EpiVacCorona;21;12;33;7299088;3167729;10466817
2022.06_18-07-2022;г. Москва;21_45_days;SputnikLite;1686;661;2347;7299088;3167729;10466817
2022.06_18-07-2022;г. Москва;21_45_days;SputnikV;9864;7569;17433;7299088;3167729;10466817
2022.06_18-07-2022;г. Москва;45_75_days;AllVaccines;23674;14871;38545;7299088;3167729;10466817
2022.06_18-07-2022;г. Москва;45_75_days;CoviVac;846;90;936;7299088;3167729;10466817
2022.06_18-07-2022;г. Москва;45_75_days;EpiVacCorona;23;14;37;7299088;3167729;10466817
2022.06_18-07-2022;г. Москва;45_75_days;SputnikLite;5255;1469;6724;7299088;3167729;10466817
2022.06_18-07-2022;г. Москва;45_75_days;SputnikV;17550;13298;30848;7299088;3167729;10466817
2022.06_18-07-2022;г. Москва;75_90_days;AllVaccines;21966;12804;34770;7299088;3167729;10466817
2022.06_18-07-2022;г. Москва;75_90_days;CoviVac;524;65;589;7299088;3167729;10466817
2022.06_18-07-2022;г. Москва;75_90_days;EpiVacCorona;7;7;14;7299088;3167729;10466817
2022.06_18-07-2022;г. Москва;75_90_days;SputnikLite;4698;1908;6606;7299088;3167729;10466817
2022.06_18-07-2022;г. Москва;75_90_days;SputnikV;16737;10824;27561;7299088;3167729;10466817
2022.06_18-07-2022;г. Москва;90_105_days;AllVaccines;32671;12672;45343;7299088;3167729;10466817
2022.06_18-07-2022;г. Москва;90_105_days;CoviVac;757;60;817;7299088;3167729;10466817
2022.06_18-07-2022;г. Москва;90_105_days;EpiVacCorona;30;22;52;7299088;3167729;10466817
2022.06_18-07-2022;г. Москва;90_105_days;SputnikLite;7956;2705;10661;7299088;3167729;10466817
2022.06_18-07-2022;г. Москва;90_105_days;SputnikV;23928;9885;33813;7299088;3167729;10466817
2022.06_18-07-2022;г. Санкт-Петербург;105_165_days;AllVaccines;275398;101871;377269;3114778;1306302;4421080
2022.06_18-07-2022;г. Санкт-Петербург;105_165_days;CoviVac;2867;171;3038;3114778;1306302;4421080
2022.06_18-07-2022;г. Санкт-Петербург;105_165_days;EpiVacCorona;3639;1515;5154;3114778;1306302;4421080
2022.06_18-07-2022;г. Санкт-Петербург;105_165_days;SputnikLite;128836;57490;186326;3114778;1306302;4421080
2022.06_18-07-2022;г. Санкт-Петербург;105_165_days;SputnikV;140056;42695;182751;3114778;1306302;4421080
2022.06_18-07-2022;г. Санкт-Петербург;165_195_days;AllVaccines;371850;133798;505648;3114778;1306302;4421080
2022.06_18-07-2022;г. Санкт-Петербург;165_195_days;CoviVac;2495;194;2689;3114778;1306302;4421080
2022.06_18-07-2022;г. Санкт-Петербург;165_195_days;EpiVacCorona;4420;1986;6406;3114778;1306302;4421080
2022.06_18-07-2022;г. Санкт-Петербург;165_195_days;SputnikLite;112496;58491;170987;3114778;1306302;4421080
2022.06_18-07-2022;г. Санкт-Петербург;165_195_days;SputnikV;252439;73127;325566;3114778;1306302;4421080
2022.06_18-07-2022;г. Санкт-Петербург;21_45_days;AllVaccines;11305;6259;17564;3114778;1306302;4421080
2022.06_18-07-2022;г. Санкт-Петербург;21_45_days;CoviVac;560;45;605;3114778;1306302;4421080
2022.06_18-07-2022;г. Санкт-Петербург;21_45_days;EpiVacCorona;299;87;386;3114778;1306302;4421080
2022.06_18-07-2022;г. Санкт-Петербург;21_45_days;SputnikLite;2688;649;3337;3114778;1306302;4421080
2022.06_18-07-2022;г. Санкт-Петербург;21_45_days;SputnikV;7758;5478;13236;3114778;1306302;4421080
2022.06_18-07-2022;г. Санкт-Петербург;45_75_days;AllVaccines;16722;9488;26210;3114778;1306302;4421080
2022.06_18-07-2022;г. Санкт-Петербург;45_75_days;CoviVac;818;72;890;3114778;1306302;4421080
2022.06_18-07-2022;г. Санкт-Петербург;45_75_days;EpiVacCorona;383;201;584;3114778;1306302;4421080
2022.06_18-07-2022;г. Санкт-Петербург;45_75_days;SputnikLite;4626;1816;6442;3114778;1306302;4421080
2022.06_18-07-2022;г. Санкт-Петербург;45_75_days;SputnikV;10895;7399;18294;3114778;1306302;4421080
2022.06_18-07-2022;г. Санкт-Петербург;75_90_days;AllVaccines;13603;6858;20461;3114778;1306302;4421080
2022.06_18-07-2022;г. Санкт-Петербург;75_90_days;CoviVac;278;20;298;3114778;1306302;4421080
2022.06_18-07-2022;г. Санкт-Петербург;75_90_days;EpiVacCorona;259;191;450;3114778;1306302;4421080
2022.06_18-07-2022;г. Санкт-Петербург;75_90_days;SputnikLite;4197;2425;6622;3114778;1306302;4421080
2022.06_18-07-2022;г. Санкт-Петербург;75_90_days;SputnikV;8869;4222;13091;3114778;1306302;4421080
2022.06_18-07-2022;г. Санкт-Петербург;90_105_days;AllVaccines;21181;9122;30303;3114778;1306302;4421080
2022.06_18-07-2022;г. Санкт-Петербург;90_105_days;CoviVac;333;21;354;3114778;1306302;4421080
2022.06_18-07-2022;г. Санкт-Петербург;90_105_days;EpiVacCorona;102;80;182;3114778;1306302;4421080
2022.06_18-07-2022;г. Санкт-Петербург;90_105_days;SputnikLite;7223;4377;11600;3114778;1306302;4421080
2022.06_18-07-2022;г. Санкт-Петербург;90_105_days;SputnikV;13523;4644;18167;3114778;1306302;4421080
2022.06_18-07-2022;г. Севастополь;105_165_days;AllVaccines;19753;10299;30052;293051;116400;409451
2022.06_18-07-2022;г. Севастополь;105_165_days;CoviVac;190;98;288;293051;116400;409451
2022.06_18-07-2022;г. Севастополь;105_165_days;EpiVacCorona;223;217;440;293051;116400;409451
2022.06_18-07-2022;г. Севастополь;105_165_days;SputnikLite;12012;7486;19498;293051;116400;409451
2022.06_18-07-2022;г. Севастополь;105_165_days;SputnikV;7328;2498;9826;293051;116400;409451
2022.06_18-07-2022;г. Севастополь;165_195_days;AllVaccines;23516;10085;33601;293051;116400;409451
2022.06_18-07-2022;г. Севастополь;165_195_days;CoviVac;135;50;185;293051;116400;409451
2022.06_18-07-2022;г. Севастополь;165_195_days;EpiVacCorona;325;170;495;293051;116400;409451
2022.06_18-07-2022;г. Севастополь;165_195_days;SputnikLite;6166;5471;11637;293051;116400;409451
2022.06_18-07-2022;г. Севастополь;165_195_days;SputnikV;16890;4394;21284;293051;116400;409451
2022.06_18-07-2022;г. Севастополь;21_45_days;AllVaccines;2064;2274;4338;293051;116400;409451
2022.06_18-07-2022;г. Севастополь;21_45_days;CoviVac;1;0;1;293051;116400;409451
2022.06_18-07-2022;г. Севастополь;21_45_days;EpiVacCorona;15;15;30;293051;116400;409451
2022.06_18-07-2022;г. Севастополь;21_45_days;SputnikLite;1519;1057;2576;293051;116400;409451
2022.06_18-07-2022;г. Севастополь;21_45_days;SputnikV;529;1202;1731;293051;116400;409451
2022.06_18-07-2022;г. Севастополь;45_75_days;AllVaccines;3049;2252;5301;293051;116400;409451
2022.06_18-07-2022;г. Севастополь;45_75_days;CoviVac;22;13;35;293051;116400;409451
2022.06_18-07-2022;г. Севастополь;45_75_days;EpiVacCorona;16;26;42;293051;116400;409451
2022.06_18-07-2022;г. Севастополь;45_75_days;SputnikLite;2029;1566;3595;293051;116400;409451
2022.06_18-07-2022;г. Севастополь;45_75_days;SputnikV;982;647;1629;293051;116400;409451
2022.06_18-07-2022;г. Севастополь;75_90_days;AllVaccines;1225;784;2009;293051;116400;409451
2022.06_18-07-2022;г. Севастополь;75_90_days;CoviVac;9;3;12;293051;116400;409451
2022.06_18-07-2022;г. Севастополь;75_90_days;EpiVacCorona;12;21;33;293051;116400;409451
2022.06_18-07-2022;г. Севастополь;75_90_days;SputnikLite;774;473;1247;293051;116400;409451
2022.06_18-07-2022;г. Севастополь;75_90_days;SputnikV;430;287;717;293051;116400;409451
2022.06_18-07-2022;г. Севастополь;90_105_days;AllVaccines;1470;909;2379;293051;116400;409451
2022.06_18-07-2022;г. Севастополь;90_105_days;CoviVac;19;8;27;293051;116400;409451
2022.06_18-07-2022;г. Севастополь;90_105_days;EpiVacCorona;12;19;31;293051;116400;409451
2022.06_18-07-2022;г. Севастополь;90_105_days;SputnikLite;677;444;1121;293051;116400;409451
2022.06_18-07-2022;г. Севастополь;90_105_days;SputnikV;762;438;1200;293051;116400;409451
2022.07_16-08-2022;Алтайский край;105_165_days;AllVaccines;69186;38286;107472;1240936;570412;1811348
2022.07_16-08-2022;Алтайский край;105_165_days;CoviVac;1303;488;1791;1240936;570412;1811348
2022.07_16-08-2022;Алтайский край;105_165_days;EpiVacCorona;3599;2219;5818;1240936;570412;1811348
2022.07_16-08-2022;Алтайский край;105_165_days;SputnikLite;33574;14896;48470;1240936;570412;1811348
2022.07_16-08-2022;Алтайский край;105_165_days;SputnikV;30710;20683;51393;1240936;570412;1811348
2022.07_16-08-2022;Алтайский край;165_195_days;AllVaccines;52593;29279;81872;1240936;570412;1811348
2022.07_16-08-2022;Алтайский край;165_195_days;CoviVac;391;150;541;1240936;570412;1811348
2022.07_16-08-2022;Алтайский край;165_195_days;EpiVacCorona;1815;1030;2845;1240936;570412;1811348
2022.07_16-08-2022;Алтайский край;165_195_days;SputnikLite;35871;19336;55207;1240936;570412;1811348
2022.07_16-08-2022;Алтайский край;165_195_days;SputnikV;14516;8763;23279;1240936;570412;1811348
2022.07_16-08-2022;Алтайский край;21_45_days;AllVaccines;5056;6316;11372;1240936;570412;1811348
2022.07_16-08-2022;Алтайский край;21_45_days;CoviVac;157;144;301;1240936;570412;1811348
2022.07_16-08-2022;Алтайский край;21_45_days;EpiVacCorona;1138;1450;2588;1240936;570412;1811348
2022.07_16-08-2022;Алтайский край;21_45_days;SputnikLite;336;179;515;1240936;570412;1811348
2022.07_16-08-2022;Алтайский край;21_45_days;SputnikV;3425;4543;7968;1240936;570412;1811348
2022.07_16-08-2022;Алтайский край;45_75_days;AllVaccines;5403;5180;10583;1240936;570412;1811348
2022.07_16-08-2022;Алтайский край;45_75_days;CoviVac;169;141;310;1240936;570412;1811348
2022.07_16-08-2022;Алтайский край;45_75_days;EpiVacCorona;552;518;1070;1240936;570412;1811348
2022.07_16-08-2022;Алтайский край;45_75_days;SputnikLite;559;249;808;1240936;570412;1811348
2022.07_16-08-2022;Алтайский край;45_75_days;SputnikV;4123;4272;8395;1240936;570412;1811348
2022.07_16-08-2022;Алтайский край;75_90_days;AllVaccines;3724;3311;7035;1240936;570412;1811348
2022.07_16-08-2022;Алтайский край;75_90_days;CoviVac;207;101;308;1240936;570412;1811348
2022.07_16-08-2022;Алтайский край;75_90_days;EpiVacCorona;459;368;827;1240936;570412;1811348
2022.07_16-08-2022;Алтайский край;75_90_days;SputnikLite;479;252;731;1240936;570412;1811348
2022.07_16-08-2022;Алтайский край;75_90_days;SputnikV;2579;2590;5169;1240936;570412;1811348
2022.07_16-08-2022;Алтайский край;90_105_days;AllVaccines;4608;3495;8103;1240936;570412;1811348
2022.07_16-08-2022;Алтайский край;90_105_days;CoviVac;381;129;510;1240936;570412;1811348
2022.07_16-08-2022;Алтайский край;90_105_days;EpiVacCorona;536;406;942;1240936;570412;1811348
2022.07_16-08-2022;Алтайский край;90_105_days;SputnikLite;471;306;777;1240936;570412;1811348
2022.07_16-08-2022;Алтайский край;90_105_days;SputnikV;3220;2654;5874;1240936;570412;1811348
2022.07_16-08-2022;Амурская область;105_165_days;AllVaccines;33325;9841;43166;444961;159780;604741
2022.07_16-08-2022;Амурская область;105_165_days;CoviVac;422;78;500;444961;159780;604741
2022.07_16-08-2022;Амурская область;105_165_days;EpiVacCorona;1909;792;2701;444961;159780;604741
2022.07_16-08-2022;Амурская область;105_165_days;SputnikLite;18085;4937;23022;444961;159780;604741
2022.07_16-08-2022;Амурская область;105_165_days;SputnikV;12909;4034;16943;444961;159780;604741
2022.07_16-08-2022;Амурская область;165_195_days;AllVaccines;22230;7156;29386;444961;159780;604741
2022.07_16-08-2022;Амурская область;165_195_days;CoviVac;211;43;254;444961;159780;604741
2022.07_16-08-2022;Амурская область;165_195_days;EpiVacCorona;1355;409;1764;444961;159780;604741
2022.07_16-08-2022;Амурская область;165_195_days;SputnikLite;13130;5024;18154;444961;159780;604741
2022.07_16-08-2022;Амурская область;165_195_days;SputnikV;7534;1680;9214;444961;159780;604741
2022.07_16-08-2022;Амурская область;21_45_days;AllVaccines;2962;1605;4567;444961;159780;604741
2022.07_16-08-2022;Амурская область;21_45_days;CoviVac;12;16;28;444961;159780;604741
2022.07_16-08-2022;Амурская область;21_45_days;EpiVacCorona;441;143;584;444961;159780;604741
2022.07_16-08-2022;Амурская область;21_45_days;SputnikLite;818;277;1095;444961;159780;604741
2022.07_16-08-2022;Амурская область;21_45_days;SputnikV;1691;1169;2860;444961;159780;604741
2022.07_16-08-2022;Амурская область;45_75_days;AllVaccines;3280;1661;4941;444961;159780;604741
2022.07_16-08-2022;Амурская область;45_75_days;CoviVac;81;9;90;444961;159780;604741
2022.07_16-08-2022;Амурская область;45_75_days;EpiVacCorona;341;163;504;444961;159780;604741
2022.07_16-08-2022;Амурская область;45_75_days;SputnikLite;1406;484;1890;444961;159780;604741
2022.07_16-08-2022;Амурская область;45_75_days;SputnikV;1452;1005;2457;444961;159780;604741
2022.07_16-08-2022;Амурская область;75_90_days;AllVaccines;2116;835;2951;444961;159780;604741
2022.07_16-08-2022;Амурская область;75_90_days;CoviVac;42;5;47;444961;159780;604741
2022.07_16-08-2022;Амурская область;75_90_days;EpiVacCorona;205;98;303;444961;159780;604741
2022.07_16-08-2022;Амурская область;75_90_days;SputnikLite;941;291;1232;444961;159780;604741
2022.07_16-08-2022;Амурская область;75_90_days;SputnikV;928;441;1369;444961;159780;604741
2022.07_16-08-2022;Амурская область;90_105_days;AllVaccines;2346;950;3296;444961;159780;604741
2022.07_16-08-2022;Амурская область;90_105_days;CoviVac;38;4;42;444961;159780;604741
2022.07_16-08-2022;Амурская область;90_105_days;EpiVacCorona;249;96;345;444961;159780;604741
2022.07_16-08-2022;Амурская область;90_105_days;SputnikLite;977;343;1320;444961;159780;604741
2022.07_16-08-2022;Амурская область;90_105_days;SputnikV;1082;507;1589;444961;159780;604741
2022.07_16-08-2022;Архангельская область;105_165_days;AllVaccines;22703;13763;36466;595439;264499;859938
2022.07_16-08-2022;Архангельская область;105_165_days;CoviVac;422;81;503;595439;264499;859938
2022.07_16-08-2022;Архангельская область;105_165_days;EpiVacCorona;1146;1029;2175;595439;264499;859938
2022.07_16-08-2022;Архангельская область;105_165_days;SputnikLite;6378;3512;9890;595439;264499;859938
2022.07_16-08-2022;Архангельская область;105_165_days;SputnikV;14757;9141;23898;595439;264499;859938
2022.07_16-08-2022;Архангельская область;165_195_days;AllVaccines;17957;11652;29609;595439;264499;859938
2022.07_16-08-2022;Архангельская область;165_195_days;CoviVac;171;21;192;595439;264499;859938
2022.07_16-08-2022;Архангельская область;165_195_days;EpiVacCorona;508;275;783;595439;264499;859938
2022.07_16-08-2022;Архангельская область;165_195_days;SputnikLite;11366;8645;20011;595439;264499;859938
2022.07_16-08-2022;Архангельская область;165_195_days;SputnikV;5912;2711;8623;595439;264499;859938
2022.07_16-08-2022;Архангельская область;21_45_days;AllVaccines;3601;2523;6124;595439;264499;859938
2022.07_16-08-2022;Архангельская область;21_45_days;CoviVac;209;108;317;595439;264499;859938
2022.07_16-08-2022;Архангельская область;21_45_days;EpiVacCorona;207;191;398;595439;264499;859938
2022.07_16-08-2022;Архангельская область;21_45_days;SputnikLite;684;171;855;595439;264499;859938
2022.07_16-08-2022;Архангельская область;21_45_days;SputnikV;2501;2053;4554;595439;264499;859938
2022.07_16-08-2022;Архангельская область;45_75_days;AllVaccines;3567;2801;6368;595439;264499;859938
2022.07_16-08-2022;Архангельская область;45_75_days;CoviVac;248;173;421;595439;264499;859938
2022.07_16-08-2022;Архангельская область;45_75_days;EpiVacCorona;142;140;282;595439;264499;859938
2022.07_16-08-2022;Архангельская область;45_75_days;SputnikLite;752;237;989;595439;264499;859938
2022.07_16-08-2022;Архангельская область;45_75_days;SputnikV;2425;2251;4676;595439;264499;859938
2022.07_16-08-2022;Архангельская область;75_90_days;AllVaccines;2482;2134;4616;595439;264499;859938
2022.07_16-08-2022;Архангельская область;75_90_days;CoviVac;121;86;207;595439;264499;859938
2022.07_16-08-2022;Архангельская область;75_90_days;EpiVacCorona;106;128;234;595439;264499;859938
2022.07_16-08-2022;Архангельская область;75_90_days;SputnikLite;530;413;943;595439;264499;859938
2022.07_16-08-2022;Архангельская область;75_90_days;SputnikV;1725;1507;3232;595439;264499;859938
2022.07_16-08-2022;Архангельская область;90_105_days;AllVaccines;2983;2420;5403;595439;264499;859938
2022.07_16-08-2022;Архангельская область;90_105_days;CoviVac;102;52;154;595439;264499;859938
2022.07_16-08-2022;Архангельская область;90_105_days;EpiVacCorona;235;188;423;595439;264499;859938
2022.07_16-08-2022;Архангельская область;90_105_days;SputnikLite;470;375;845;595439;264499;859938
2022.07_16-08-2022;Архангельская область;90_105_days;SputnikV;2176;1805;3981;595439;264499;859938
2022.07_16-08-2022;Астраханская область;105_165_days;AllVaccines;31380;11993;43373;550968;219749;770717
2022.07_16-08-2022;Астраханская область;105_165_days;CoviVac;382;186;568;550968;219749;770717
2022.07_16-08-2022;Астраханская область;105_165_days;EpiVacCorona;707;261;968;550968;219749;770717
2022.07_16-08-2022;Астраханская область;105_165_days;SputnikLite;16037;5469;21506;550968;219749;770717
2022.07_16-08-2022;Астраханская область;105_165_days;SputnikV;14254;6077;20331;550968;219749;770717
2022.07_16-08-2022;Астраханская область;165_195_days;AllVaccines;20976;7726;28702;550968;219749;770717
2022.07_16-08-2022;Астраханская область;165_195_days;CoviVac;218;63;281;550968;219749;770717
2022.07_16-08-2022;Астраханская область;165_195_days;EpiVacCorona;351;99;450;550968;219749;770717
2022.07_16-08-2022;Астраханская область;165_195_days;SputnikLite;13137;5351;18488;550968;219749;770717
2022.07_16-08-2022;Астраханская область;165_195_days;SputnikV;7270;2213;9483;550968;219749;770717
2022.07_16-08-2022;Астраханская область;21_45_days;AllVaccines;5275;2549;7824;550968;219749;770717
2022.07_16-08-2022;Астраханская область;21_45_days;CoviVac;9;2;11;550968;219749;770717
2022.07_16-08-2022;Астраханская область;21_45_days;EpiVacCorona;627;327;954;550968;219749;770717
2022.07_16-08-2022;Астраханская область;21_45_days;SputnikLite;447;104;551;550968;219749;770717
2022.07_16-08-2022;Астраханская область;21_45_days;SputnikV;4192;2116;6308;550968;219749;770717
2022.07_16-08-2022;Астраханская область;45_75_days;AllVaccines;3269;2015;5284;550968;219749;770717
2022.07_16-08-2022;Астраханская область;45_75_days;CoviVac;76;7;83;550968;219749;770717
2022.07_16-08-2022;Астраханская область;45_75_days;EpiVacCorona;238;131;369;550968;219749;770717
2022.07_16-08-2022;Астраханская область;45_75_days;SputnikLite;646;440;1086;550968;219749;770717
2022.07_16-08-2022;Астраханская область;45_75_days;SputnikV;2309;1437;3746;550968;219749;770717
2022.07_16-08-2022;Астраханская область;75_90_days;AllVaccines;2970;1669;4639;550968;219749;770717
2022.07_16-08-2022;Астраханская область;75_90_days;CoviVac;33;2;35;550968;219749;770717
2022.07_16-08-2022;Астраханская область;75_90_days;EpiVacCorona;100;193;293;550968;219749;770717
2022.07_16-08-2022;Астраханская область;75_90_days;SputnikLite;1686;664;2350;550968;219749;770717
2022.07_16-08-2022;Астраханская область;75_90_days;SputnikV;1151;810;1961;550968;219749;770717
2022.07_16-08-2022;Астраханская область;90_105_days;AllVaccines;2485;1238;3723;550968;219749;770717
2022.07_16-08-2022;Астраханская область;90_105_days;CoviVac;36;14;50;550968;219749;770717
2022.07_16-08-2022;Астраханская область;90_105_days;EpiVacCorona;58;55;113;550968;219749;770717
2022.07_16-08-2022;Астраханская область;90_105_days;SputnikLite;1634;770;2404;550968;219749;770717
2022.07_16-08-2022;Астраханская область;90_105_days;SputnikV;757;399;1156;550968;219749;770717
2022.07_16-08-2022;Белгородская область;105_165_days;AllVaccines;46548;17851;64399;867731;383871;1251602
2022.07_16-08-2022;Белгородская область;105_165_days;CoviVac;537;162;699;867731;383871;1251602
2022.07_16-08-2022;Белгородская область;105_165_days;EpiVacCorona;828;388;1216;867731;383871;1251602
2022.07_16-08-2022;Белгородская область;105_165_days;SputnikLite;30050;11538;41588;867731;383871;1251602
2022.07_16-08-2022;Белгородская область;105_165_days;SputnikV;15133;5763;20896;867731;383871;1251602
2022.07_16-08-2022;Белгородская область;165_195_days;AllVaccines;53566;21929;75495;867731;383871;1251602
2022.07_16-08-2022;Белгородская область;165_195_days;CoviVac;259;108;367;867731;383871;1251602
2022.07_16-08-2022;Белгородская область;165_195_days;EpiVacCorona;409;224;633;867731;383871;1251602
2022.07_16-08-2022;Белгородская область;165_195_days;SputnikLite;42279;17870;60149;867731;383871;1251602
2022.07_16-08-2022;Белгородская область;165_195_days;SputnikV;10619;3727;14346;867731;383871;1251602
2022.07_16-08-2022;Белгородская область;21_45_days;AllVaccines;4889;3797;8686;867731;383871;1251602
2022.07_16-08-2022;Белгородская область;21_45_days;CoviVac;8;45;53;867731;383871;1251602
2022.07_16-08-2022;Белгородская область;21_45_days;EpiVacCorona;204;256;460;867731;383871;1251602
2022.07_16-08-2022;Белгородская область;21_45_days;SputnikLite;159;24;183;867731;383871;1251602
2022.07_16-08-2022;Белгородская область;21_45_days;SputnikV;4518;3472;7990;867731;383871;1251602
2022.07_16-08-2022;Белгородская область;45_75_days;AllVaccines;3859;3124;6983;867731;383871;1251602
2022.07_16-08-2022;Белгородская область;45_75_days;CoviVac;22;4;26;867731;383871;1251602
2022.07_16-08-2022;Белгородская область;45_75_days;EpiVacCorona;162;145;307;867731;383871;1251602
2022.07_16-08-2022;Белгородская область;45_75_days;SputnikLite;210;92;302;867731;383871;1251602
2022.07_16-08-2022;Белгородская область;45_75_days;SputnikV;3465;2883;6348;867731;383871;1251602
2022.07_16-08-2022;Белгородская область;75_90_days;AllVaccines;2250;1726;3976;867731;383871;1251602
2022.07_16-08-2022;Белгородская область;75_90_days;CoviVac;55;46;101;867731;383871;1251602
2022.07_16-08-2022;Белгородская область;75_90_days;EpiVacCorona;149;119;268;867731;383871;1251602
2022.07_16-08-2022;Белгородская область;75_90_days;SputnikLite;310;97;407;867731;383871;1251602
2022.07_16-08-2022;Белгородская область;75_90_days;SputnikV;1736;1464;3200;867731;383871;1251602
2022.07_16-08-2022;Белгородская область;90_105_days;AllVaccines;2973;2047;5020;867731;383871;1251602
2022.07_16-08-2022;Белгородская область;90_105_days;CoviVac;65;58;123;867731;383871;1251602
2022.07_16-08-2022;Белгородская область;90_105_days;EpiVacCorona;210;167;377;867731;383871;1251602
2022.07_16-08-2022;Белгородская область;90_105_days;SputnikLite;529;327;856;867731;383871;1251602
2022.07_16-08-2022;Белгородская область;90_105_days;SputnikV;2169;1495;3664;867731;383871;1251602
2022.07_16-08-2022;Брянская область;105_165_days;AllVaccines;23991;13619;37610;659625;298625;958250
2022.07_16-08-2022;Брянская область;105_165_days;CoviVac;481;138;619;659625;298625;958250
2022.07_16-08-2022;Брянская область;105_165_days;EpiVacCorona;692;364;1056;659625;298625;958250
2022.07_16-08-2022;Брянская область;105_165_days;SputnikLite;11092;6238;17330;659625;298625;958250
2022.07_16-08-2022;Брянская область;105_165_days;SputnikV;11726;6879;18605;659625;298625;958250
2022.07_16-08-2022;Брянская область;165_195_days;AllVaccines;25900;14986;40886;659625;298625;958250
2022.07_16-08-2022;Брянская область;165_195_days;CoviVac;312;100;412;659625;298625;958250
2022.07_16-08-2022;Брянская область;165_195_days;EpiVacCorona;723;366;1089;659625;298625;958250
2022.07_16-08-2022;Брянская область;165_195_days;SputnikLite;19169;11552;30721;659625;298625;958250
2022.07_16-08-2022;Брянская область;165_195_days;SputnikV;5696;2968;8664;659625;298625;958250
2022.07_16-08-2022;Брянская область;21_45_days;AllVaccines;2485;2849;5334;659625;298625;958250
2022.07_16-08-2022;Брянская область;21_45_days;CoviVac;136;24;160;659625;298625;958250
2022.07_16-08-2022;Брянская область;21_45_days;EpiVacCorona;169;153;322;659625;298625;958250
2022.07_16-08-2022;Брянская область;21_45_days;SputnikLite;771;740;1511;659625;298625;958250
2022.07_16-08-2022;Брянская область;21_45_days;SputnikV;1409;1932;3341;659625;298625;958250
2022.07_16-08-2022;Брянская область;45_75_days;AllVaccines;2354;2567;4921;659625;298625;958250
2022.07_16-08-2022;Брянская область;45_75_days;CoviVac;87;30;117;659625;298625;958250
2022.07_16-08-2022;Брянская область;45_75_days;EpiVacCorona;137;95;232;659625;298625;958250
2022.07_16-08-2022;Брянская область;45_75_days;SputnikLite;1098;1220;2318;659625;298625;958250
2022.07_16-08-2022;Брянская область;45_75_days;SputnikV;1032;1222;2254;659625;298625;958250
2022.07_16-08-2022;Брянская область;75_90_days;AllVaccines;1245;1100;2345;659625;298625;958250
2022.07_16-08-2022;Брянская область;75_90_days;CoviVac;141;77;218;659625;298625;958250
2022.07_16-08-2022;Брянская область;75_90_days;EpiVacCorona;56;21;77;659625;298625;958250
2022.07_16-08-2022;Брянская область;75_90_days;SputnikLite;439;417;856;659625;298625;958250
2022.07_16-08-2022;Брянская область;75_90_days;SputnikV;609;585;1194;659625;298625;958250
2022.07_16-08-2022;Брянская область;90_105_days;AllVaccines;1746;1309;3055;659625;298625;958250
2022.07_16-08-2022;Брянская область;90_105_days;CoviVac;50;45;95;659625;298625;958250
2022.07_16-08-2022;Брянская область;90_105_days;EpiVacCorona;75;31;106;659625;298625;958250
2022.07_16-08-2022;Брянская область;90_105_days;SputnikLite;615;555;1170;659625;298625;958250
2022.07_16-08-2022;Брянская область;90_105_days;SputnikV;1006;678;1684;659625;298625;958250
2022.07_16-08-2022;Владимирская область;105_165_days;AllVaccines;19034;11299;30333;739166;354521;1093687
2022.07_16-08-2022;Владимирская область;105_165_days;CoviVac;365;148;513;739166;354521;1093687
2022.07_16-08-2022;Владимирская область;105_165_days;EpiVacCorona;701;471;1172;739166;354521;1093687
2022.07_16-08-2022;Владимирская область;105_165_days;SputnikLite;7995;4648;12643;739166;354521;1093687
2022.07_16-08-2022;Владимирская область;105_165_days;SputnikV;9973;6032;16005;739166;354521;1093687
2022.07_16-08-2022;Владимирская область;165_195_days;AllVaccines;19375;12515;31890;739166;354521;1093687
2022.07_16-08-2022;Владимирская область;165_195_days;CoviVac;131;64;195;739166;354521;1093687
2022.07_16-08-2022;Владимирская область;165_195_days;EpiVacCorona;883;657;1540;739166;354521;1093687
2022.07_16-08-2022;Владимирская область;165_195_days;SputnikLite;12530;9203;21733;739166;354521;1093687
2022.07_16-08-2022;Владимирская область;165_195_days;SputnikV;5831;2591;8422;739166;354521;1093687
2022.07_16-08-2022;Владимирская область;21_45_days;AllVaccines;2068;1885;3953;739166;354521;1093687
2022.07_16-08-2022;Владимирская область;21_45_days;CoviVac;125;61;186;739166;354521;1093687
2022.07_16-08-2022;Владимирская область;21_45_days;EpiVacCorona;227;180;407;739166;354521;1093687
2022.07_16-08-2022;Владимирская область;21_45_days;SputnikLite;247;143;390;739166;354521;1093687
2022.07_16-08-2022;Владимирская область;21_45_days;SputnikV;1469;1501;2970;739166;354521;1093687
2022.07_16-08-2022;Владимирская область;45_75_days;AllVaccines;1667;1797;3464;739166;354521;1093687
2022.07_16-08-2022;Владимирская область;45_75_days;CoviVac;114;66;180;739166;354521;1093687
2022.07_16-08-2022;Владимирская область;45_75_days;EpiVacCorona;92;139;231;739166;354521;1093687
2022.07_16-08-2022;Владимирская область;45_75_days;SputnikLite;251;174;425;739166;354521;1093687
2022.07_16-08-2022;Владимирская область;45_75_days;SputnikV;1210;1418;2628;739166;354521;1093687
2022.07_16-08-2022;Владимирская область;75_90_days;AllVaccines;1149;1127;2276;739166;354521;1093687
2022.07_16-08-2022;Владимирская область;75_90_days;CoviVac;104;37;141;739166;354521;1093687
2022.07_16-08-2022;Владимирская область;75_90_days;EpiVacCorona;63;60;123;739166;354521;1093687
2022.07_16-08-2022;Владимирская область;75_90_days;SputnikLite;115;161;276;739166;354521;1093687
2022.07_16-08-2022;Владимирская область;75_90_days;SputnikV;867;869;1736;739166;354521;1093687
2022.07_16-08-2022;Владимирская область;90_105_days;AllVaccines;1395;1287;2682;739166;354521;1093687
2022.07_16-08-2022;Владимирская область;90_105_days;CoviVac;69;18;87;739166;354521;1093687
2022.07_16-08-2022;Владимирская область;90_105_days;EpiVacCorona;85;77;162;739166;354521;1093687
2022.07_16-08-2022;Владимирская область;90_105_days;SputnikLite;265;267;532;739166;354521;1093687
2022.07_16-08-2022;Владимирская область;90_105_days;SputnikV;976;925;1901;739166;354521;1093687
2022.07_16-08-2022;Волгоградская область;105_165_days;AllVaccines;69835;34396;104231;1387837;615020;2002857
2022.07_16-08-2022;Волгоградская область;105_165_days;CoviVac;1396;388;1784;1387837;615020;2002857
2022.07_16-08-2022;Волгоградская область;105_165_days;EpiVacCorona;3541;1628;5169;1387837;615020;2002857
2022.07_16-08-2022;Волгоградская область;105_165_days;SputnikLite;34324;14510;48834;1387837;615020;2002857
2022.07_16-08-2022;Волгоградская область;105_165_days;SputnikV;30574;17870;48444;1387837;615020;2002857
2022.07_16-08-2022;Волгоградская область;165_195_days;AllVaccines;59034;31923;90957;1387837;615020;2002857
2022.07_16-08-2022;Волгоградская область;165_195_days;CoviVac;432;156;588;1387837;615020;2002857
2022.07_16-08-2022;Волгоградская область;165_195_days;EpiVacCorona;1430;2292;3722;1387837;615020;2002857
2022.07_16-08-2022;Волгоградская область;165_195_days;SputnikLite;41518;20216;61734;1387837;615020;2002857
2022.07_16-08-2022;Волгоградская область;165_195_days;SputnikV;15654;9259;24913;1387837;615020;2002857
2022.07_16-08-2022;Волгоградская область;21_45_days;AllVaccines;8911;8023;16934;1387837;615020;2002857
2022.07_16-08-2022;Волгоградская область;21_45_days;CoviVac;78;24;102;1387837;615020;2002857
2022.07_16-08-2022;Волгоградская область;21_45_days;EpiVacCorona;1785;1957;3742;1387837;615020;2002857
2022.07_16-08-2022;Волгоградская область;21_45_days;SputnikLite;1280;725;2005;1387837;615020;2002857
2022.07_16-08-2022;Волгоградская область;21_45_days;SputnikV;5768;5317;11085;1387837;615020;2002857
2022.07_16-08-2022;Волгоградская область;45_75_days;AllVaccines;7629;6452;14081;1387837;615020;2002857
2022.07_16-08-2022;Волгоградская область;45_75_days;CoviVac;443;139;582;1387837;615020;2002857
2022.07_16-08-2022;Волгоградская область;45_75_days;EpiVacCorona;1152;710;1862;1387837;615020;2002857
2022.07_16-08-2022;Волгоградская область;45_75_days;SputnikLite;1376;947;2323;1387837;615020;2002857
2022.07_16-08-2022;Волгоградская область;45_75_days;SputnikV;4658;4656;9314;1387837;615020;2002857
2022.07_16-08-2022;Волгоградская область;75_90_days;AllVaccines;4981;3557;8538;1387837;615020;2002857
2022.07_16-08-2022;Волгоградская область;75_90_days;CoviVac;924;508;1432;1387837;615020;2002857
2022.07_16-08-2022;Волгоградская область;75_90_days;EpiVacCorona;391;228;619;1387837;615020;2002857
2022.07_16-08-2022;Волгоградская область;75_90_days;SputnikLite;813;610;1423;1387837;615020;2002857
2022.07_16-08-2022;Волгоградская область;75_90_days;SputnikV;2853;2211;5064;1387837;615020;2002857
2022.07_16-08-2022;Волгоградская область;90_105_days;AllVaccines;6736;5038;11774;1387837;615020;2002857
2022.07_16-08-2022;Волгоградская область;90_105_days;CoviVac;316;98;414;1387837;615020;2002857
2022.07_16-08-2022;Волгоградская область;90_105_days;EpiVacCorona;812;478;1290;1387837;615020;2002857
2022.07_16-08-2022;Волгоградская область;90_105_days;SputnikLite;1238;923;2161;1387837;615020;2002857
2022.07_16-08-2022;Волгоградская область;90_105_days;SputnikV;4370;3539;7909;1387837;615020;2002857
2022.07_16-08-2022;Вологодская область;105_165_days;AllVaccines;22223;11553;33776;628100;275171;903271
2022.07_16-08-2022;Вологодская область;105_165_days;CoviVac;503;134;637;628100;275171;903271
2022.07_16-08-2022;Вологодская область;105_165_days;EpiVacCorona;893;469;1362;628100;275171;903271
2022.07_16-08-2022;Вологодская область;105_165_days;SputnikLite;6147;2518;8665;628100;275171;903271
2022.07_16-08-2022;Вологодская область;105_165_days;SputnikV;14680;8432;23112;628100;275171;903271
2022.07_16-08-2022;Вологодская область;165_195_days;AllVaccines;23363;12146;35509;628100;275171;903271
2022.07_16-08-2022;Вологодская область;165_195_days;CoviVac;585;139;724;628100;275171;903271
2022.07_16-08-2022;Вологодская область;165_195_days;EpiVacCorona;916;481;1397;628100;275171;903271
2022.07_16-08-2022;Вологодская область;165_195_days;SputnikLite;11481;7591;19072;628100;275171;903271
2022.07_16-08-2022;Вологодская область;165_195_days;SputnikV;10381;3935;14316;628100;275171;903271
2022.07_16-08-2022;Вологодская область;21_45_days;AllVaccines;2228;1999;4227;628100;275171;903271
2022.07_16-08-2022;Вологодская область;21_45_days;CoviVac;39;11;50;628100;275171;903271
2022.07_16-08-2022;Вологодская область;21_45_days;EpiVacCorona;185;135;320;628100;275171;903271
2022.07_16-08-2022;Вологодская область;21_45_days;SputnikLite;62;18;80;628100;275171;903271
2022.07_16-08-2022;Вологодская область;21_45_days;SputnikV;1942;1835;3777;628100;275171;903271
2022.07_16-08-2022;Вологодская область;45_75_days;AllVaccines;2317;2025;4342;628100;275171;903271
2022.07_16-08-2022;Вологодская область;45_75_days;CoviVac;83;21;104;628100;275171;903271
2022.07_16-08-2022;Вологодская область;45_75_days;EpiVacCorona;111;27;138;628100;275171;903271
2022.07_16-08-2022;Вологодская область;45_75_days;SputnikLite;70;37;107;628100;275171;903271
2022.07_16-08-2022;Вологодская область;45_75_days;SputnikV;2053;1940;3993;628100;275171;903271
2022.07_16-08-2022;Вологодская область;75_90_days;AllVaccines;1559;1371;2930;628100;275171;903271
2022.07_16-08-2022;Вологодская область;75_90_days;CoviVac;99;17;116;628100;275171;903271
2022.07_16-08-2022;Вологодская область;75_90_days;EpiVacCorona;65;40;105;628100;275171;903271
2022.07_16-08-2022;Вологодская область;75_90_days;SputnikLite;153;138;291;628100;275171;903271
2022.07_16-08-2022;Вологодская область;75_90_days;SputnikV;1242;1176;2418;628100;275171;903271
2022.07_16-08-2022;Вологодская область;90_105_days;AllVaccines;2188;1603;3791;628100;275171;903271
2022.07_16-08-2022;Вологодская область;90_105_days;CoviVac;39;8;47;628100;275171;903271
2022.07_16-08-2022;Вологодская область;90_105_days;EpiVacCorona;87;66;153;628100;275171;903271
2022.07_16-08-2022;Вологодская область;90_105_days;SputnikLite;309;208;517;628100;275171;903271
2022.07_16-08-2022;Вологодская область;90_105_days;SputnikV;1753;1321;3074;628100;275171;903271
2022.07_16-08-2022;Воронежская область;105_165_days;AllVaccines;51046;30351;81397;1293123;602333;1895456
2022.07_16-08-2022;Воронежская область;105_165_days;CoviVac;864;377;1241;1293123;602333;1895456
2022.07_16-08-2022;Воронежская область;105_165_days;EpiVacCorona;2220;1561;3781;1293123;602333;1895456
2022.07_16-08-2022;Воронежская область;105_165_days;SputnikLite;23575;11594;35169;1293123;602333;1895456
2022.07_16-08-2022;Воронежская область;105_165_days;SputnikV;24387;16819;41206;1293123;602333;1895456
2022.07_16-08-2022;Воронежская область;165_195_days;AllVaccines;44977;24161;69138;1293123;602333;1895456
2022.07_16-08-2022;Воронежская область;165_195_days;CoviVac;492;184;676;1293123;602333;1895456
2022.07_16-08-2022;Воронежская область;165_195_days;EpiVacCorona;1359;785;2144;1293123;602333;1895456
2022.07_16-08-2022;Воронежская область;165_195_days;SputnikLite;31724;17826;49550;1293123;602333;1895456
2022.07_16-08-2022;Воронежская область;165_195_days;SputnikV;11402;5366;16768;1293123;602333;1895456
2022.07_16-08-2022;Воронежская область;21_45_days;AllVaccines;10391;7425;17816;1293123;602333;1895456
2022.07_16-08-2022;Воронежская область;21_45_days;CoviVac;413;216;629;1293123;602333;1895456
2022.07_16-08-2022;Воронежская область;21_45_days;EpiVacCorona;589;465;1054;1293123;602333;1895456
2022.07_16-08-2022;Воронежская область;21_45_days;SputnikLite;1453;885;2338;1293123;602333;1895456
2022.07_16-08-2022;Воронежская область;21_45_days;SputnikV;7936;5859;13795;1293123;602333;1895456
2022.07_16-08-2022;Воронежская область;45_75_days;AllVaccines;8388;6148;14536;1293123;602333;1895456
2022.07_16-08-2022;Воронежская область;45_75_days;CoviVac;143;62;205;1293123;602333;1895456
2022.07_16-08-2022;Воронежская область;45_75_days;EpiVacCorona;504;461;965;1293123;602333;1895456
2022.07_16-08-2022;Воронежская область;45_75_days;SputnikLite;1896;1532;3428;1293123;602333;1895456
2022.07_16-08-2022;Воронежская область;45_75_days;SputnikV;5845;4093;9938;1293123;602333;1895456
2022.07_16-08-2022;Воронежская область;75_90_days;AllVaccines;6406;4629;11035;1293123;602333;1895456
2022.07_16-08-2022;Воронежская область;75_90_days;CoviVac;427;150;577;1293123;602333;1895456
2022.07_16-08-2022;Воронежская область;75_90_days;EpiVacCorona;785;801;1586;1293123;602333;1895456
2022.07_16-08-2022;Воронежская область;75_90_days;SputnikLite;758;600;1358;1293123;602333;1895456
2022.07_16-08-2022;Воронежская область;75_90_days;SputnikV;4436;3078;7514;1293123;602333;1895456
2022.07_16-08-2022;Воронежская область;90_105_days;AllVaccines;4968;4249;9217;1293123;602333;1895456
2022.07_16-08-2022;Воронежская область;90_105_days;CoviVac;202;65;267;1293123;602333;1895456
2022.07_16-08-2022;Воронежская область;90_105_days;EpiVacCorona;677;882;1559;1293123;602333;1895456
2022.07_16-08-2022;Воронежская область;90_105_days;SputnikLite;1023;715;1738;1293123;602333;1895456
2022.07_16-08-2022;Воронежская область;90_105_days;SputnikV;3066;2587;5653;1293123;602333;1895456
2022.07_16-08-2022;Еврейская автономная область;105_165_days;AllVaccines;5819;2034;7853;88207;31969;120176
2022.07_16-08-2022;Еврейская автономная область;105_165_days;CoviVac;313;45;358;88207;31969;120176
2022.07_16-08-2022;Еврейская автономная область;105_165_days;EpiVacCorona;832;364;1196;88207;31969;120176
2022.07_16-08-2022;Еврейская автономная область;105_165_days;SputnikLite;2945;1080;4025;88207;31969;120176
2022.07_16-08-2022;Еврейская автономная область;105_165_days;SputnikV;1729;545;2274;88207;31969;120176
2022.07_16-08-2022;Еврейская автономная область;165_195_days;AllVaccines;4521;1641;6162;88207;31969;120176
2022.07_16-08-2022;Еврейская автономная область;165_195_days;CoviVac;370;73;443;88207;31969;120176
2022.07_16-08-2022;Еврейская автономная область;165_195_days;EpiVacCorona;878;237;1115;88207;31969;120176
2022.07_16-08-2022;Еврейская автономная область;165_195_days;SputnikLite;2115;1063;3178;88207;31969;120176
2022.07_16-08-2022;Еврейская автономная область;165_195_days;SputnikV;1158;268;1426;88207;31969;120176
2022.07_16-08-2022;Еврейская автономная область;21_45_days;AllVaccines;978;298;1276;88207;31969;120176
2022.07_16-08-2022;Еврейская автономная область;21_45_days;CoviVac;1;0;1;88207;31969;120176
2022.07_16-08-2022;Еврейская автономная область;21_45_days;EpiVacCorona;160;50;210;88207;31969;120176
2022.07_16-08-2022;Еврейская автономная область;21_45_days;SputnikV;817;248;1065;88207;31969;120176
2022.07_16-08-2022;Еврейская автономная область;45_75_days;AllVaccines;553;268;821;88207;31969;120176
2022.07_16-08-2022;Еврейская автономная область;45_75_days;CoviVac;23;2;25;88207;31969;120176
2022.07_16-08-2022;Еврейская автономная область;45_75_days;EpiVacCorona;136;40;176;88207;31969;120176
2022.07_16-08-2022;Еврейская автономная область;45_75_days;SputnikV;394;226;620;88207;31969;120176
2022.07_16-08-2022;Еврейская автономная область;75_90_days;AllVaccines;376;197;573;88207;31969;120176
2022.07_16-08-2022;Еврейская автономная область;75_90_days;CoviVac;97;77;174;88207;31969;120176
2022.07_16-08-2022;Еврейская автономная область;75_90_days;EpiVacCorona;57;17;74;88207;31969;120176
2022.07_16-08-2022;Еврейская автономная область;75_90_days;SputnikV;222;103;325;88207;31969;120176
2022.07_16-08-2022;Еврейская автономная область;90_105_days;AllVaccines;363;140;503;88207;31969;120176
2022.07_16-08-2022;Еврейская автономная область;90_105_days;CoviVac;82;9;91;88207;31969;120176
2022.07_16-08-2022;Еврейская автономная область;90_105_days;EpiVacCorona;82;34;116;88207;31969;120176
2022.07_16-08-2022;Еврейская автономная область;90_105_days;SputnikLite;1;0;1;88207;31969;120176
2022.07_16-08-2022;Еврейская автономная область;90_105_days;SputnikV;198;97;295;88207;31969;120176
2022.07_16-08-2022;Забайкальский край;105_165_days;AllVaccines;45223;13506;58729;596322;191826;788148
2022.07_16-08-2022;Забайкальский край;105_165_days;CoviVac;1565;225;1790;596322;191826;788148
2022.07_16-08-2022;Забайкальский край;105_165_days;EpiVacCorona;5533;1662;7195;596322;191826;788148
2022.07_16-08-2022;Забайкальский край;105_165_days;SputnikLite;10217;1750;11967;596322;191826;788148
2022.07_16-08-2022;Забайкальский край;105_165_days;SputnikV;27908;9869;37777;596322;191826;788148
2022.07_16-08-2022;Забайкальский край;165_195_days;AllVaccines;28772;9044;37816;596322;191826;788148
2022.07_16-08-2022;Забайкальский край;165_195_days;CoviVac;295;43;338;596322;191826;788148
2022.07_16-08-2022;Забайкальский край;165_195_days;EpiVacCorona;2533;816;3349;596322;191826;788148
2022.07_16-08-2022;Забайкальский край;165_195_days;SputnikLite;15845;5093;20938;596322;191826;788148
2022.07_16-08-2022;Забайкальский край;165_195_days;SputnikV;10099;3092;13191;596322;191826;788148
2022.07_16-08-2022;Забайкальский край;21_45_days;AllVaccines;6570;3439;10009;596322;191826;788148
2022.07_16-08-2022;Забайкальский край;21_45_days;CoviVac;1331;395;1726;596322;191826;788148
2022.07_16-08-2022;Забайкальский край;21_45_days;EpiVacCorona;958;575;1533;596322;191826;788148
2022.07_16-08-2022;Забайкальский край;21_45_days;SputnikLite;416;14;430;596322;191826;788148
2022.07_16-08-2022;Забайкальский край;21_45_days;SputnikV;3865;2455;6320;596322;191826;788148
2022.07_16-08-2022;Забайкальский край;45_75_days;AllVaccines;6852;3649;10501;596322;191826;788148
2022.07_16-08-2022;Забайкальский край;45_75_days;CoviVac;1653;514;2167;596322;191826;788148
2022.07_16-08-2022;Забайкальский край;45_75_days;EpiVacCorona;934;533;1467;596322;191826;788148
2022.07_16-08-2022;Забайкальский край;45_75_days;SputnikLite;390;117;507;596322;191826;788148
2022.07_16-08-2022;Забайкальский край;45_75_days;SputnikV;3875;2485;6360;596322;191826;788148
2022.07_16-08-2022;Забайкальский край;75_90_days;AllVaccines;3938;1962;5900;596322;191826;788148
2022.07_16-08-2022;Забайкальский край;75_90_days;CoviVac;579;112;691;596322;191826;788148
2022.07_16-08-2022;Забайкальский край;75_90_days;EpiVacCorona;577;266;843;596322;191826;788148
2022.07_16-08-2022;Забайкальский край;75_90_days;SputnikLite;323;145;468;596322;191826;788148
2022.07_16-08-2022;Забайкальский край;75_90_days;SputnikV;2459;1439;3898;596322;191826;788148
2022.07_16-08-2022;Забайкальский край;90_105_days;AllVaccines;5279;2069;7348;596322;191826;788148
2022.07_16-08-2022;Забайкальский край;90_105_days;CoviVac;474;91;565;596322;191826;788148
2022.07_16-08-2022;Забайкальский край;90_105_days;EpiVacCorona;616;224;840;596322;191826;788148
2022.07_16-08-2022;Забайкальский край;90_105_days;SputnikLite;497;149;646;596322;191826;788148
2022.07_16-08-2022;Забайкальский край;90_105_days;SputnikV;3692;1605;5297;596322;191826;788148
2022.07_16-08-2022;Ивановская область;105_165_days;AllVaccines;17058;9128;26186;549803;255947;805750
2022.07_16-08-2022;Ивановская область;105_165_days;CoviVac;375;55;430;549803;255947;805750
2022.07_16-08-2022;Ивановская область;105_165_days;EpiVacCorona;576;299;875;549803;255947;805750
2022.07_16-08-2022;Ивановская область;105_165_days;SputnikLite;8119;4027;12146;549803;255947;805750
2022.07_16-08-2022;Ивановская область;105_165_days;SputnikV;7988;4747;12735;549803;255947;805750
2022.07_16-08-2022;Ивановская область;165_195_days;AllVaccines;15123;8284;23407;549803;255947;805750
2022.07_16-08-2022;Ивановская область;165_195_days;CoviVac;129;19;148;549803;255947;805750
2022.07_16-08-2022;Ивановская область;165_195_days;EpiVacCorona;615;294;909;549803;255947;805750
2022.07_16-08-2022;Ивановская область;165_195_days;SputnikLite;11273;6098;17371;549803;255947;805750
2022.07_16-08-2022;Ивановская область;165_195_days;SputnikV;3106;1873;4979;549803;255947;805750
2022.07_16-08-2022;Ивановская область;21_45_days;AllVaccines;1792;1994;3786;549803;255947;805750
2022.07_16-08-2022;Ивановская область;21_45_days;CoviVac;50;35;85;549803;255947;805750
2022.07_16-08-2022;Ивановская область;21_45_days;EpiVacCorona;66;104;170;549803;255947;805750
2022.07_16-08-2022;Ивановская область;21_45_days;SputnikLite;581;554;1135;549803;255947;805750
2022.07_16-08-2022;Ивановская область;21_45_days;SputnikV;1095;1301;2396;549803;255947;805750
2022.07_16-08-2022;Ивановская область;45_75_days;AllVaccines;1753;2013;3766;549803;255947;805750
2022.07_16-08-2022;Ивановская область;45_75_days;CoviVac;45;11;56;549803;255947;805750
2022.07_16-08-2022;Ивановская область;45_75_days;EpiVacCorona;123;245;368;549803;255947;805750
2022.07_16-08-2022;Ивановская область;45_75_days;SputnikLite;498;698;1196;549803;255947;805750
2022.07_16-08-2022;Ивановская область;45_75_days;SputnikV;1087;1059;2146;549803;255947;805750
2022.07_16-08-2022;Ивановская область;75_90_days;AllVaccines;927;1127;2054;549803;255947;805750
2022.07_16-08-2022;Ивановская область;75_90_days;CoviVac;41;39;80;549803;255947;805750
2022.07_16-08-2022;Ивановская область;75_90_days;EpiVacCorona;71;150;221;549803;255947;805750
2022.07_16-08-2022;Ивановская область;75_90_days;SputnikLite;279;392;671;549803;255947;805750
2022.07_16-08-2022;Ивановская область;75_90_days;SputnikV;536;546;1082;549803;255947;805750
2022.07_16-08-2022;Ивановская область;90_105_days;AllVaccines;1085;1076;2161;549803;255947;805750
2022.07_16-08-2022;Ивановская область;90_105_days;CoviVac;49;6;55;549803;255947;805750
2022.07_16-08-2022;Ивановская область;90_105_days;EpiVacCorona;40;20;60;549803;255947;805750
2022.07_16-08-2022;Ивановская область;90_105_days;SputnikLite;365;402;767;549803;255947;805750
2022.07_16-08-2022;Ивановская область;90_105_days;SputnikV;631;648;1279;549803;255947;805750
2022.07_16-08-2022;Иркутская область;105_165_days;AllVaccines;55781;23614;79395;1316761;480655;1797416
2022.07_16-08-2022;Иркутская область;105_165_days;CoviVac;804;302;1106;1316761;480655;1797416
2022.07_16-08-2022;Иркутская область;105_165_days;EpiVacCorona;1935;1346;3281;1316761;480655;1797416
2022.07_16-08-2022;Иркутская область;105_165_days;SputnikLite;19470;8570;28040;1316761;480655;1797416
2022.07_16-08-2022;Иркутская область;105_165_days;SputnikV;33572;13396;46968;1316761;480655;1797416
2022.07_16-08-2022;Иркутская область;165_195_days;AllVaccines;57765;24949;82714;1316761;480655;1797416
2022.07_16-08-2022;Иркутская область;165_195_days;CoviVac;320;91;411;1316761;480655;1797416
2022.07_16-08-2022;Иркутская область;165_195_days;EpiVacCorona;1391;750;2141;1316761;480655;1797416
2022.07_16-08-2022;Иркутская область;165_195_days;SputnikLite;30848;18588;49436;1316761;480655;1797416
2022.07_16-08-2022;Иркутская область;165_195_days;SputnikV;25206;5520;30726;1316761;480655;1797416
2022.07_16-08-2022;Иркутская область;21_45_days;AllVaccines;6224;3947;10171;1316761;480655;1797416
2022.07_16-08-2022;Иркутская область;21_45_days;CoviVac;337;173;510;1316761;480655;1797416
2022.07_16-08-2022;Иркутская область;21_45_days;EpiVacCorona;679;326;1005;1316761;480655;1797416
2022.07_16-08-2022;Иркутская область;21_45_days;SputnikLite;221;67;288;1316761;480655;1797416
2022.07_16-08-2022;Иркутская область;21_45_days;SputnikV;4987;3381;8368;1316761;480655;1797416
2022.07_16-08-2022;Иркутская область;45_75_days;AllVaccines;6512;4057;10569;1316761;480655;1797416
2022.07_16-08-2022;Иркутская область;45_75_days;CoviVac;494;115;609;1316761;480655;1797416
2022.07_16-08-2022;Иркутская область;45_75_days;EpiVacCorona;761;317;1078;1316761;480655;1797416
2022.07_16-08-2022;Иркутская область;45_75_days;SputnikLite;422;130;552;1316761;480655;1797416
2022.07_16-08-2022;Иркутская область;45_75_days;SputnikV;4835;3495;8330;1316761;480655;1797416
2022.07_16-08-2022;Иркутская область;75_90_days;AllVaccines;4088;2118;6206;1316761;480655;1797416
2022.07_16-08-2022;Иркутская область;75_90_days;CoviVac;298;105;403;1316761;480655;1797416
2022.07_16-08-2022;Иркутская область;75_90_days;EpiVacCorona;581;127;708;1316761;480655;1797416
2022.07_16-08-2022;Иркутская область;75_90_days;SputnikLite;386;155;541;1316761;480655;1797416
2022.07_16-08-2022;Иркутская область;75_90_days;SputnikV;2823;1731;4554;1316761;480655;1797416
2022.07_16-08-2022;Иркутская область;90_105_days;AllVaccines;4065;2174;6239;1316761;480655;1797416
2022.07_16-08-2022;Иркутская область;90_105_days;CoviVac;134;27;161;1316761;480655;1797416
2022.07_16-08-2022;Иркутская область;90_105_days;EpiVacCorona;329;231;560;1316761;480655;1797416
2022.07_16-08-2022;Иркутская область;90_105_days;SputnikLite;522;253;775;1316761;480655;1797416
2022.07_16-08-2022;Иркутская область;90_105_days;SputnikV;3080;1663;4743;1316761;480655;1797416
2022.07_16-08-2022;Кабардино-Балкарская Республика;105_165_days;AllVaccines;14114;5838;19952;502388;159241;661629
2022.07_16-08-2022;Кабардино-Балкарская Республика;105_165_days;CoviVac;300;60;360;502388;159241;661629
2022.07_16-08-2022;Кабардино-Балкарская Республика;105_165_days;EpiVacCorona;958;305;1263;502388;159241;661629
2022.07_16-08-2022;Кабардино-Балкарская Республика;105_165_days;SputnikLite;6479;2127;8606;502388;159241;661629
2022.07_16-08-2022;Кабардино-Балкарская Республика;105_165_days;SputnikV;6377;3346;9723;502388;159241;661629
2022.07_16-08-2022;Кабардино-Балкарская Республика;165_195_days;AllVaccines;14564;5445;20009;502388;159241;661629
2022.07_16-08-2022;Кабардино-Балкарская Республика;165_195_days;CoviVac;102;46;148;502388;159241;661629
2022.07_16-08-2022;Кабардино-Балкарская Республика;165_195_days;EpiVacCorona;828;206;1034;502388;159241;661629
2022.07_16-08-2022;Кабардино-Балкарская Республика;165_195_days;SputnikLite;10407;3993;14400;502388;159241;661629
2022.07_16-08-2022;Кабардино-Балкарская Республика;165_195_days;SputnikV;3227;1200;4427;502388;159241;661629
2022.07_16-08-2022;Кабардино-Балкарская Республика;21_45_days;AllVaccines;2385;839;3224;502388;159241;661629
2022.07_16-08-2022;Кабардино-Балкарская Республика;21_45_days;CoviVac;375;133;508;502388;159241;661629
2022.07_16-08-2022;Кабардино-Балкарская Республика;21_45_days;EpiVacCorona;215;34;249;502388;159241;661629
2022.07_16-08-2022;Кабардино-Балкарская Республика;21_45_days;SputnikLite;204;7;211;502388;159241;661629
2022.07_16-08-2022;Кабардино-Балкарская Республика;21_45_days;SputnikV;1591;665;2256;502388;159241;661629
2022.07_16-08-2022;Кабардино-Балкарская Республика;45_75_days;AllVaccines;1989;767;2756;502388;159241;661629
2022.07_16-08-2022;Кабардино-Балкарская Республика;45_75_days;CoviVac;258;85;343;502388;159241;661629
2022.07_16-08-2022;Кабардино-Балкарская Республика;45_75_days;EpiVacCorona;193;33;226;502388;159241;661629
2022.07_16-08-2022;Кабардино-Балкарская Республика;45_75_days;SputnikLite;368;64;432;502388;159241;661629
2022.07_16-08-2022;Кабардино-Балкарская Республика;45_75_days;SputnikV;1170;585;1755;502388;159241;661629
2022.07_16-08-2022;Кабардино-Балкарская Республика;75_90_days;AllVaccines;1261;554;1815;502388;159241;661629
2022.07_16-08-2022;Кабардино-Балкарская Республика;75_90_days;CoviVac;72;22;94;502388;159241;661629
2022.07_16-08-2022;Кабардино-Балкарская Республика;75_90_days;EpiVacCorona;98;16;114;502388;159241;661629
2022.07_16-08-2022;Кабардино-Балкарская Республика;75_90_days;SputnikLite;338;111;449;502388;159241;661629
2022.07_16-08-2022;Кабардино-Балкарская Республика;75_90_days;SputnikV;753;405;1158;502388;159241;661629
2022.07_16-08-2022;Кабардино-Балкарская Республика;90_105_days;AllVaccines;1156;412;1568;502388;159241;661629
2022.07_16-08-2022;Кабардино-Балкарская Республика;90_105_days;CoviVac;38;20;58;502388;159241;661629
2022.07_16-08-2022;Кабардино-Балкарская Республика;90_105_days;EpiVacCorona;39;10;49;502388;159241;661629
2022.07_16-08-2022;Кабардино-Балкарская Республика;90_105_days;SputnikLite;355;81;436;502388;159241;661629
2022.07_16-08-2022;Кабардино-Балкарская Республика;90_105_days;SputnikV;724;301;1025;502388;159241;661629
2022.07_16-08-2022;Калининградская область;105_165_days;AllVaccines;21501;11113;32614;585700;231702;817402
2022.07_16-08-2022;Калининградская область;105_165_days;CoviVac;346;110;456;585700;231702;817402
2022.07_16-08-2022;Калининградская область;105_165_days;EpiVacCorona;655;334;989;585700;231702;817402
2022.07_16-08-2022;Калининградская область;105_165_days;SputnikLite;6933;3620;10553;585700;231702;817402
2022.07_16-08-2022;Калининградская область;105_165_days;SputnikV;13567;7049;20616;585700;231702;817402
2022.07_16-08-2022;Калининградская область;165_195_days;AllVaccines;24491;12980;37471;585700;231702;817402
2022.07_16-08-2022;Калининградская область;165_195_days;CoviVac;338;117;455;585700;231702;817402
2022.07_16-08-2022;Калининградская область;165_195_days;EpiVacCorona;799;360;1159;585700;231702;817402
2022.07_16-08-2022;Калининградская область;165_195_days;SputnikLite;14842;9063;23905;585700;231702;817402
2022.07_16-08-2022;Калининградская область;165_195_days;SputnikV;8512;3440;11952;585700;231702;817402
2022.07_16-08-2022;Калининградская область;21_45_days;AllVaccines;3253;2583;5836;585700;231702;817402
2022.07_16-08-2022;Калининградская область;21_45_days;CoviVac;132;64;196;585700;231702;817402
2022.07_16-08-2022;Калининградская область;21_45_days;EpiVacCorona;172;140;312;585700;231702;817402
2022.07_16-08-2022;Калининградская область;21_45_days;SputnikLite;998;425;1423;585700;231702;817402
2022.07_16-08-2022;Калининградская область;21_45_days;SputnikV;1951;1954;3905;585700;231702;817402
2022.07_16-08-2022;Калининградская область;45_75_days;AllVaccines;2889;2632;5521;585700;231702;817402
2022.07_16-08-2022;Калининградская область;45_75_days;CoviVac;83;67;150;585700;231702;817402
2022.07_16-08-2022;Калининградская область;45_75_days;EpiVacCorona;76;30;106;585700;231702;817402
2022.07_16-08-2022;Калининградская область;45_75_days;SputnikLite;1088;1022;2110;585700;231702;817402
2022.07_16-08-2022;Калининградская область;45_75_days;SputnikV;1642;1513;3155;585700;231702;817402
2022.07_16-08-2022;Калининградская область;75_90_days;AllVaccines;1716;1349;3065;585700;231702;817402
2022.07_16-08-2022;Калининградская область;75_90_days;CoviVac;55;24;79;585700;231702;817402
2022.07_16-08-2022;Калининградская область;75_90_days;EpiVacCorona;70;34;104;585700;231702;817402
2022.07_16-08-2022;Калининградская область;75_90_days;SputnikLite;584;513;1097;585700;231702;817402
2022.07_16-08-2022;Калининградская область;75_90_days;SputnikV;1007;778;1785;585700;231702;817402
2022.07_16-08-2022;Калининградская область;90_105_days;AllVaccines;1954;1842;3796;585700;231702;817402
2022.07_16-08-2022;Калининградская область;90_105_days;CoviVac;58;36;94;585700;231702;817402
2022.07_16-08-2022;Калининградская область;90_105_days;EpiVacCorona;50;29;79;585700;231702;817402
2022.07_16-08-2022;Калининградская область;90_105_days;SputnikLite;549;539;1088;585700;231702;817402
2022.07_16-08-2022;Калининградская область;90_105_days;SputnikV;1297;1238;2535;585700;231702;817402
2022.07_16-08-2022;Калужская область;105_165_days;AllVaccines;19077;9768;28845;559789;253023;812812
2022.07_16-08-2022;Калужская область;105_165_days;CoviVac;411;153;564;559789;253023;812812
2022.07_16-08-2022;Калужская область;105_165_days;EpiVacCorona;773;373;1146;559789;253023;812812
2022.07_16-08-2022;Калужская область;105_165_days;SputnikLite;6280;3912;10192;559789;253023;812812
2022.07_16-08-2022;Калужская область;105_165_days;SputnikV;11613;5330;16943;559789;253023;812812
2022.07_16-08-2022;Калужская область;165_195_days;AllVaccines;21415;12009;33424;559789;253023;812812
2022.07_16-08-2022;Калужская область;165_195_days;CoviVac;198;68;266;559789;253023;812812
2022.07_16-08-2022;Калужская область;165_195_days;EpiVacCorona;549;303;852;559789;253023;812812
2022.07_16-08-2022;Калужская область;165_195_days;SputnikLite;11760;8530;20290;559789;253023;812812
2022.07_16-08-2022;Калужская область;165_195_days;SputnikV;8908;3108;12016;559789;253023;812812
2022.07_16-08-2022;Калужская область;21_45_days;AllVaccines;2527;2371;4898;559789;253023;812812
2022.07_16-08-2022;Калужская область;21_45_days;CoviVac;170;128;298;559789;253023;812812
2022.07_16-08-2022;Калужская область;21_45_days;EpiVacCorona;169;142;311;559789;253023;812812
2022.07_16-08-2022;Калужская область;21_45_days;SputnikLite;215;200;415;559789;253023;812812
2022.07_16-08-2022;Калужская область;21_45_days;SputnikV;1973;1901;3874;559789;253023;812812
2022.07_16-08-2022;Калужская область;45_75_days;AllVaccines;3105;2641;5746;559789;253023;812812
2022.07_16-08-2022;Калужская область;45_75_days;CoviVac;219;171;390;559789;253023;812812
2022.07_16-08-2022;Калужская область;45_75_days;EpiVacCorona;277;142;419;559789;253023;812812
2022.07_16-08-2022;Калужская область;45_75_days;SputnikLite;22;10;32;559789;253023;812812
2022.07_16-08-2022;Калужская область;45_75_days;SputnikV;2587;2318;4905;559789;253023;812812
2022.07_16-08-2022;Калужская область;75_90_days;AllVaccines;1399;1087;2486;559789;253023;812812
2022.07_16-08-2022;Калужская область;75_90_days;CoviVac;35;35;70;559789;253023;812812
2022.07_16-08-2022;Калужская область;75_90_days;EpiVacCorona;54;34;88;559789;253023;812812
2022.07_16-08-2022;Калужская область;75_90_days;SputnikLite;166;109;275;559789;253023;812812
2022.07_16-08-2022;Калужская область;75_90_days;SputnikV;1144;909;2053;559789;253023;812812
2022.07_16-08-2022;Калужская область;90_105_days;AllVaccines;1711;1171;2882;559789;253023;812812
2022.07_16-08-2022;Калужская область;90_105_days;CoviVac;30;27;57;559789;253023;812812
2022.07_16-08-2022;Калужская область;90_105_days;EpiVacCorona;95;41;136;559789;253023;812812
2022.07_16-08-2022;Калужская область;90_105_days;SputnikLite;402;320;722;559789;253023;812812
2022.07_16-08-2022;Калужская область;90_105_days;SputnikV;1184;783;1967;559789;253023;812812
2022.07_16-08-2022;Камчатский край;105_165_days;AllVaccines;7662;2184;9846;189425;56856;246281
2022.07_16-08-2022;Камчатский край;105_165_days;CoviVac;108;17;125;189425;56856;246281
2022.07_16-08-2022;Камчатский край;105_165_days;EpiVacCorona;594;187;781;189425;56856;246281
2022.07_16-08-2022;Камчатский край;105_165_days;SputnikLite;2182;661;2843;189425;56856;246281
2022.07_16-08-2022;Камчатский край;105_165_days;SputnikV;4778;1319;6097;189425;56856;246281
2022.07_16-08-2022;Камчатский край;165_195_days;AllVaccines;5884;2017;7901;189425;56856;246281
2022.07_16-08-2022;Камчатский край;165_195_days;CoviVac;16;5;21;189425;56856;246281
2022.07_16-08-2022;Камчатский край;165_195_days;EpiVacCorona;136;62;198;189425;56856;246281
2022.07_16-08-2022;Камчатский край;165_195_days;SputnikLite;3920;1623;5543;189425;56856;246281
2022.07_16-08-2022;Камчатский край;165_195_days;SputnikV;1812;327;2139;189425;56856;246281
2022.07_16-08-2022;Камчатский край;21_45_days;AllVaccines;946;335;1281;189425;56856;246281
2022.07_16-08-2022;Камчатский край;21_45_days;CoviVac;2;0;2;189425;56856;246281
2022.07_16-08-2022;Камчатский край;21_45_days;EpiVacCorona;213;64;277;189425;56856;246281
2022.07_16-08-2022;Камчатский край;21_45_days;SputnikLite;173;38;211;189425;56856;246281
2022.07_16-08-2022;Камчатский край;21_45_days;SputnikV;558;233;791;189425;56856;246281
2022.07_16-08-2022;Камчатский край;45_75_days;AllVaccines;1648;423;2071;189425;56856;246281
2022.07_16-08-2022;Камчатский край;45_75_days;CoviVac;7;5;12;189425;56856;246281
2022.07_16-08-2022;Камчатский край;45_75_days;EpiVacCorona;149;30;179;189425;56856;246281
2022.07_16-08-2022;Камчатский край;45_75_days;SputnikLite;321;82;403;189425;56856;246281
2022.07_16-08-2022;Камчатский край;45_75_days;SputnikV;1171;306;1477;189425;56856;246281
2022.07_16-08-2022;Камчатский край;75_90_days;AllVaccines;991;263;1254;189425;56856;246281
2022.07_16-08-2022;Камчатский край;75_90_days;CoviVac;27;6;33;189425;56856;246281
2022.07_16-08-2022;Камчатский край;75_90_days;EpiVacCorona;47;10;57;189425;56856;246281
2022.07_16-08-2022;Камчатский край;75_90_days;SputnikLite;296;67;363;189425;56856;246281
2022.07_16-08-2022;Камчатский край;75_90_days;SputnikV;621;180;801;189425;56856;246281
2022.07_16-08-2022;Камчатский край;90_105_days;AllVaccines;1169;302;1471;189425;56856;246281
2022.07_16-08-2022;Камчатский край;90_105_days;CoviVac;9;4;13;189425;56856;246281
2022.07_16-08-2022;Камчатский край;90_105_days;EpiVacCorona;44;14;58;189425;56856;246281
2022.07_16-08-2022;Камчатский край;90_105_days;SputnikLite;324;52;376;189425;56856;246281
2022.07_16-08-2022;Камчатский край;90_105_days;SputnikV;792;232;1024;189425;56856;246281
2022.07_16-08-2022;Карачаево-Черкесская Республика;105_165_days;AllVaccines;13881;5333;19214;266261;94005;360266
2022.07_16-08-2022;Карачаево-Черкесская Республика;105_165_days;CoviVac;387;138;525;266261;94005;360266
2022.07_16-08-2022;Карачаево-Черкесская Республика;105_165_days;EpiVacCorona;1551;435;1986;266261;94005;360266
2022.07_16-08-2022;Карачаево-Черкесская Республика;105_165_days;SputnikLite;3497;1288;4785;266261;94005;360266
2022.07_16-08-2022;Карачаево-Черкесская Республика;105_165_days;SputnikV;8446;3472;11918;266261;94005;360266
2022.07_16-08-2022;Карачаево-Черкесская Республика;165_195_days;AllVaccines;10117;3368;13485;266261;94005;360266
2022.07_16-08-2022;Карачаево-Черкесская Республика;165_195_days;CoviVac;136;39;175;266261;94005;360266
2022.07_16-08-2022;Карачаево-Черкесская Республика;165_195_days;EpiVacCorona;502;132;634;266261;94005;360266
2022.07_16-08-2022;Карачаево-Черкесская Республика;165_195_days;SputnikLite;6303;2284;8587;266261;94005;360266
2022.07_16-08-2022;Карачаево-Черкесская Республика;165_195_days;SputnikV;3176;913;4089;266261;94005;360266
2022.07_16-08-2022;Карачаево-Черкесская Республика;21_45_days;AllVaccines;6556;2439;8995;266261;94005;360266
2022.07_16-08-2022;Карачаево-Черкесская Республика;21_45_days;CoviVac;436;141;577;266261;94005;360266
2022.07_16-08-2022;Карачаево-Черкесская Республика;21_45_days;EpiVacCorona;3408;1354;4762;266261;94005;360266
2022.07_16-08-2022;Карачаево-Черкесская Республика;21_45_days;SputnikLite;1032;353;1385;266261;94005;360266
2022.07_16-08-2022;Карачаево-Черкесская Республика;21_45_days;SputnikV;1680;591;2271;266261;94005;360266
2022.07_16-08-2022;Карачаево-Черкесская Республика;45_75_days;AllVaccines;6450;3431;9881;266261;94005;360266
2022.07_16-08-2022;Карачаево-Черкесская Республика;45_75_days;CoviVac;227;44;271;266261;94005;360266
2022.07_16-08-2022;Карачаево-Черкесская Республика;45_75_days;EpiVacCorona;1106;547;1653;266261;94005;360266
2022.07_16-08-2022;Карачаево-Черкесская Республика;45_75_days;SputnikLite;806;439;1245;266261;94005;360266
2022.07_16-08-2022;Карачаево-Черкесская Республика;45_75_days;SputnikV;4311;2401;6712;266261;94005;360266
2022.07_16-08-2022;Карачаево-Черкесская Республика;75_90_days;AllVaccines;4004;1747;5751;266261;94005;360266
2022.07_16-08-2022;Карачаево-Черкесская Республика;75_90_days;CoviVac;491;164;655;266261;94005;360266
2022.07_16-08-2022;Карачаево-Черкесская Республика;75_90_days;EpiVacCorona;829;576;1405;266261;94005;360266
2022.07_16-08-2022;Карачаево-Черкесская Республика;75_90_days;SputnikLite;395;152;547;266261;94005;360266
2022.07_16-08-2022;Карачаево-Черкесская Республика;75_90_days;SputnikV;2289;855;3144;266261;94005;360266
2022.07_16-08-2022;Карачаево-Черкесская Республика;90_105_days;AllVaccines;2214;1008;3222;266261;94005;360266
2022.07_16-08-2022;Карачаево-Черкесская Республика;90_105_days;CoviVac;292;82;374;266261;94005;360266
2022.07_16-08-2022;Карачаево-Черкесская Республика;90_105_days;EpiVacCorona;481;208;689;266261;94005;360266
2022.07_16-08-2022;Карачаево-Черкесская Республика;90_105_days;SputnikLite;495;241;736;266261;94005;360266
2022.07_16-08-2022;Карачаево-Черкесская Республика;90_105_days;SputnikV;946;477;1423;266261;94005;360266
2022.07_16-08-2022;Кемеровская область;105_165_days;AllVaccines;88343;33786;122129;1453976;610256;2064232
2022.07_16-08-2022;Кемеровская область;105_165_days;CoviVac;1127;319;1446;1453976;610256;2064232
2022.07_16-08-2022;Кемеровская область;105_165_days;EpiVacCorona;3986;2066;6052;1453976;610256;2064232
2022.07_16-08-2022;Кемеровская область;105_165_days;SputnikLite;36045;13088;49133;1453976;610256;2064232
2022.07_16-08-2022;Кемеровская область;105_165_days;SputnikV;47185;18313;65498;1453976;610256;2064232
2022.07_16-08-2022;Кемеровская область;165_195_days;AllVaccines;69936;30789;100725;1453976;610256;2064232
2022.07_16-08-2022;Кемеровская область;165_195_days;CoviVac;445;116;561;1453976;610256;2064232
2022.07_16-08-2022;Кемеровская область;165_195_days;EpiVacCorona;5192;2937;8129;1453976;610256;2064232
2022.07_16-08-2022;Кемеровская область;165_195_days;SputnikLite;41905;20051;61956;1453976;610256;2064232
2022.07_16-08-2022;Кемеровская область;165_195_days;SputnikV;22394;7685;30079;1453976;610256;2064232
2022.07_16-08-2022;Кемеровская область;21_45_days;AllVaccines;7023;4460;11483;1453976;610256;2064232
2022.07_16-08-2022;Кемеровская область;21_45_days;CoviVac;355;123;478;1453976;610256;2064232
2022.07_16-08-2022;Кемеровская область;21_45_days;EpiVacCorona;800;499;1299;1453976;610256;2064232
2022.07_16-08-2022;Кемеровская область;21_45_days;SputnikLite;148;82;230;1453976;610256;2064232
2022.07_16-08-2022;Кемеровская область;21_45_days;SputnikV;5720;3756;9476;1453976;610256;2064232
2022.07_16-08-2022;Кемеровская область;45_75_days;AllVaccines;6025;3680;9705;1453976;610256;2064232
2022.07_16-08-2022;Кемеровская область;45_75_days;CoviVac;454;169;623;1453976;610256;2064232
2022.07_16-08-2022;Кемеровская область;45_75_days;EpiVacCorona;636;399;1035;1453976;610256;2064232
2022.07_16-08-2022;Кемеровская область;45_75_days;SputnikLite;179;126;305;1453976;610256;2064232
2022.07_16-08-2022;Кемеровская область;45_75_days;SputnikV;4756;2986;7742;1453976;610256;2064232
2022.07_16-08-2022;Кемеровская область;75_90_days;AllVaccines;3892;1966;5858;1453976;610256;2064232
2022.07_16-08-2022;Кемеровская область;75_90_days;CoviVac;232;121;353;1453976;610256;2064232
2022.07_16-08-2022;Кемеровская область;75_90_days;EpiVacCorona;536;242;778;1453976;610256;2064232
2022.07_16-08-2022;Кемеровская область;75_90_days;SputnikLite;179;101;280;1453976;610256;2064232
2022.07_16-08-2022;Кемеровская область;75_90_days;SputnikV;2945;1502;4447;1453976;610256;2064232
2022.07_16-08-2022;Кемеровская область;90_105_days;AllVaccines;5123;2244;7367;1453976;610256;2064232
2022.07_16-08-2022;Кемеровская область;90_105_days;CoviVac;177;14;191;1453976;610256;2064232
2022.07_16-08-2022;Кемеровская область;90_105_days;EpiVacCorona;506;196;702;1453976;610256;2064232
2022.07_16-08-2022;Кемеровская область;90_105_days;SputnikLite;214;136;350;1453976;610256;2064232
2022.07_16-08-2022;Кемеровская область;90_105_days;SputnikV;4226;1898;6124;1453976;610256;2064232
2022.07_16-08-2022;Кировская область;105_165_days;AllVaccines;26038;18470;44508;663621;334585;998206
2022.07_16-08-2022;Кировская область;105_165_days;CoviVac;422;63;485;663621;334585;998206
2022.07_16-08-2022;Кировская область;105_165_days;EpiVacCorona;642;357;999;663621;334585;998206
2022.07_16-08-2022;Кировская область;105_165_days;SputnikLite;14452;8611;23063;663621;334585;998206
2022.07_16-08-2022;Кировская область;105_165_days;SputnikV;10522;9439;19961;663621;334585;998206
2022.07_16-08-2022;Кировская область;165_195_days;AllVaccines;31249;19602;50851;663621;334585;998206
2022.07_16-08-2022;Кировская область;165_195_days;CoviVac;475;107;582;663621;334585;998206
2022.07_16-08-2022;Кировская область;165_195_days;EpiVacCorona;1200;609;1809;663621;334585;998206
2022.07_16-08-2022;Кировская область;165_195_days;SputnikLite;22940;14365;37305;663621;334585;998206
2022.07_16-08-2022;Кировская область;165_195_days;SputnikV;6634;4521;11155;663621;334585;998206
2022.07_16-08-2022;Кировская область;21_45_days;AllVaccines;4670;5507;10177;663621;334585;998206
2022.07_16-08-2022;Кировская область;21_45_days;CoviVac;16;0;16;663621;334585;998206
2022.07_16-08-2022;Кировская область;21_45_days;EpiVacCorona;349;430;779;663621;334585;998206
2022.07_16-08-2022;Кировская область;21_45_days;SputnikLite;633;77;710;663621;334585;998206
2022.07_16-08-2022;Кировская область;21_45_days;SputnikV;3672;5000;8672;663621;334585;998206
2022.07_16-08-2022;Кировская область;45_75_days;AllVaccines;3952;4727;8679;663621;334585;998206
2022.07_16-08-2022;Кировская область;45_75_days;CoviVac;60;11;71;663621;334585;998206
2022.07_16-08-2022;Кировская область;45_75_days;EpiVacCorona;247;118;365;663621;334585;998206
2022.07_16-08-2022;Кировская область;45_75_days;SputnikLite;759;133;892;663621;334585;998206
2022.07_16-08-2022;Кировская область;45_75_days;SputnikV;2886;4465;7351;663621;334585;998206
2022.07_16-08-2022;Кировская область;75_90_days;AllVaccines;1815;1948;3763;663621;334585;998206
2022.07_16-08-2022;Кировская область;75_90_days;CoviVac;56;27;83;663621;334585;998206
2022.07_16-08-2022;Кировская область;75_90_days;EpiVacCorona;146;88;234;663621;334585;998206
2022.07_16-08-2022;Кировская область;75_90_days;SputnikLite;495;313;808;663621;334585;998206
2022.07_16-08-2022;Кировская область;75_90_days;SputnikV;1118;1520;2638;663621;334585;998206
2022.07_16-08-2022;Кировская область;90_105_days;AllVaccines;2237;2250;4487;663621;334585;998206
2022.07_16-08-2022;Кировская область;90_105_days;CoviVac;41;4;45;663621;334585;998206
2022.07_16-08-2022;Кировская область;90_105_days;EpiVacCorona;137;96;233;663621;334585;998206
2022.07_16-08-2022;Кировская область;90_105_days;SputnikLite;927;708;1635;663621;334585;998206
2022.07_16-08-2022;Кировская область;90_105_days;SputnikV;1132;1442;2574;663621;334585;998206
2022.07_16-08-2022;Костромская область;105_165_days;AllVaccines;14623;8188;22811;339046;160543;499589
2022.07_16-08-2022;Костромская область;105_165_days;CoviVac;575;204;779;339046;160543;499589
2022.07_16-08-2022;Костромская область;105_165_days;EpiVacCorona;1148;646;1794;339046;160543;499589
2022.07_16-08-2022;Костромская область;105_165_days;SputnikLite;5588;2736;8324;339046;160543;499589
2022.07_16-08-2022;Костромская область;105_165_days;SputnikV;7312;4602;11914;339046;160543;499589
2022.07_16-08-2022;Костромская область;165_195_days;AllVaccines;8424;4903;13327;339046;160543;499589
2022.07_16-08-2022;Костромская область;165_195_days;CoviVac;204;51;255;339046;160543;499589
2022.07_16-08-2022;Костромская область;165_195_days;EpiVacCorona;725;346;1071;339046;160543;499589
2022.07_16-08-2022;Костромская область;165_195_days;SputnikLite;4984;3381;8365;339046;160543;499589
2022.07_16-08-2022;Костромская область;165_195_days;SputnikV;2511;1125;3636;339046;160543;499589
2022.07_16-08-2022;Костромская область;21_45_days;AllVaccines;849;769;1618;339046;160543;499589
2022.07_16-08-2022;Костромская область;21_45_days;CoviVac;0;1;1;339046;160543;499589
2022.07_16-08-2022;Костромская область;21_45_days;EpiVacCorona;171;164;335;339046;160543;499589
2022.07_16-08-2022;Костромская область;21_45_days;SputnikLite;13;9;22;339046;160543;499589
2022.07_16-08-2022;Костромская область;21_45_days;SputnikV;665;595;1260;339046;160543;499589
2022.07_16-08-2022;Костромская область;45_75_days;AllVaccines;889;925;1814;339046;160543;499589
2022.07_16-08-2022;Костромская область;45_75_days;CoviVac;78;69;147;339046;160543;499589
2022.07_16-08-2022;Костромская область;45_75_days;EpiVacCorona;162;140;302;339046;160543;499589
2022.07_16-08-2022;Костромская область;45_75_days;SputnikLite;19;9;28;339046;160543;499589
2022.07_16-08-2022;Костромская область;45_75_days;SputnikV;630;707;1337;339046;160543;499589
2022.07_16-08-2022;Костромская область;75_90_days;AllVaccines;689;703;1392;339046;160543;499589
2022.07_16-08-2022;Костромская область;75_90_days;CoviVac;68;40;108;339046;160543;499589
2022.07_16-08-2022;Костромская область;75_90_days;EpiVacCorona;140;99;239;339046;160543;499589
2022.07_16-08-2022;Костромская область;75_90_days;SputnikLite;7;10;17;339046;160543;499589
2022.07_16-08-2022;Костромская область;75_90_days;SputnikV;474;554;1028;339046;160543;499589
2022.07_16-08-2022;Костромская область;90_105_days;AllVaccines;778;703;1481;339046;160543;499589
2022.07_16-08-2022;Костромская область;90_105_days;CoviVac;23;6;29;339046;160543;499589
2022.07_16-08-2022;Костромская область;90_105_days;EpiVacCorona;131;117;248;339046;160543;499589
2022.07_16-08-2022;Костромская область;90_105_days;SputnikLite;29;32;61;339046;160543;499589
2022.07_16-08-2022;Костромская область;90_105_days;SputnikV;595;548;1143;339046;160543;499589
2022.07_16-08-2022;Краснодарский край;105_165_days;AllVaccines;161516;125594;287110;3157155;1334085;4491240
2022.07_16-08-2022;Краснодарский край;105_165_days;CoviVac;1465;458;1923;3157155;1334085;4491240
2022.07_16-08-2022;Краснодарский край;105_165_days;EpiVacCorona;11791;11406;23197;3157155;1334085;4491240
2022.07_16-08-2022;Краснодарский край;105_165_days;SputnikLite;31305;14540;45845;3157155;1334085;4491240
2022.07_16-08-2022;Краснодарский край;105_165_days;SputnikV;116955;99190;216145;3157155;1334085;4491240
2022.07_16-08-2022;Краснодарский край;165_195_days;AllVaccines;133202;71658;204860;3157155;1334085;4491240
2022.07_16-08-2022;Краснодарский край;165_195_days;CoviVac;917;307;1224;3157155;1334085;4491240
2022.07_16-08-2022;Краснодарский край;165_195_days;EpiVacCorona;2592;1617;4209;3157155;1334085;4491240
2022.07_16-08-2022;Краснодарский край;165_195_days;SputnikLite;63305;35217;98522;3157155;1334085;4491240
2022.07_16-08-2022;Краснодарский край;165_195_days;SputnikV;66388;34517;100905;3157155;1334085;4491240
2022.07_16-08-2022;Краснодарский край;21_45_days;AllVaccines;30223;23288;53511;3157155;1334085;4491240
2022.07_16-08-2022;Краснодарский край;21_45_days;CoviVac;1260;910;2170;3157155;1334085;4491240
2022.07_16-08-2022;Краснодарский край;21_45_days;EpiVacCorona;3409;2637;6046;3157155;1334085;4491240
2022.07_16-08-2022;Краснодарский край;21_45_days;SputnikLite;1213;411;1624;3157155;1334085;4491240
2022.07_16-08-2022;Краснодарский край;21_45_days;SputnikV;24341;19330;43671;3157155;1334085;4491240
2022.07_16-08-2022;Краснодарский край;45_75_days;AllVaccines;26420;22793;49213;3157155;1334085;4491240
2022.07_16-08-2022;Краснодарский край;45_75_days;CoviVac;2454;1494;3948;3157155;1334085;4491240
2022.07_16-08-2022;Краснодарский край;45_75_days;EpiVacCorona;894;981;1875;3157155;1334085;4491240
2022.07_16-08-2022;Краснодарский край;45_75_days;SputnikLite;1423;637;2060;3157155;1334085;4491240
2022.07_16-08-2022;Краснодарский край;45_75_days;SputnikV;21649;19681;41330;3157155;1334085;4491240
2022.07_16-08-2022;Краснодарский край;75_90_days;AllVaccines;16218;15653;31871;3157155;1334085;4491240
2022.07_16-08-2022;Краснодарский край;75_90_days;CoviVac;583;308;891;3157155;1334085;4491240
2022.07_16-08-2022;Краснодарский край;75_90_days;EpiVacCorona;628;705;1333;3157155;1334085;4491240
2022.07_16-08-2022;Краснодарский край;75_90_days;SputnikLite;537;290;827;3157155;1334085;4491240
2022.07_16-08-2022;Краснодарский край;75_90_days;SputnikV;14470;14350;28820;3157155;1334085;4491240
2022.07_16-08-2022;Краснодарский край;90_105_days;AllVaccines;14550;17300;31850;3157155;1334085;4491240
2022.07_16-08-2022;Краснодарский край;90_105_days;CoviVac;478;216;694;3157155;1334085;4491240
2022.07_16-08-2022;Краснодарский край;90_105_days;EpiVacCorona;1282;1323;2605;3157155;1334085;4491240
2022.07_16-08-2022;Краснодарский край;90_105_days;SputnikLite;962;454;1416;3157155;1334085;4491240
2022.07_16-08-2022;Краснодарский край;90_105_days;SputnikV;11828;15307;27135;3157155;1334085;4491240
2022.07_16-08-2022;Красноярский край;105_165_days;AllVaccines;105088;39010;144098;1637377;585822;2223199
2022.07_16-08-2022;Красноярский край;105_165_days;CoviVac;1806;835;2641;1637377;585822;2223199
2022.07_16-08-2022;Красноярский край;105_165_days;EpiVacCorona;3477;2019;5496;1637377;585822;2223199
2022.07_16-08-2022;Красноярский край;105_165_days;SputnikLite;43173;13432;56605;1637377;585822;2223199
2022.07_16-08-2022;Красноярский край;105_165_days;SputnikV;56632;22724;79356;1637377;585822;2223199
2022.07_16-08-2022;Красноярский край;165_195_days;AllVaccines;84099;34285;118384;1637377;585822;2223199
2022.07_16-08-2022;Красноярский край;165_195_days;CoviVac;797;220;1017;1637377;585822;2223199
2022.07_16-08-2022;Красноярский край;165_195_days;EpiVacCorona;2580;1452;4032;1637377;585822;2223199
2022.07_16-08-2022;Красноярский край;165_195_days;SputnikLite;48401;23049;71450;1637377;585822;2223199
2022.07_16-08-2022;Красноярский край;165_195_days;SputnikV;32321;9564;41885;1637377;585822;2223199
2022.07_16-08-2022;Красноярский край;21_45_days;AllVaccines;9627;5774;15401;1637377;585822;2223199
2022.07_16-08-2022;Красноярский край;21_45_days;CoviVac;554;190;744;1637377;585822;2223199
2022.07_16-08-2022;Красноярский край;21_45_days;EpiVacCorona;1379;924;2303;1637377;585822;2223199
2022.07_16-08-2022;Красноярский край;21_45_days;SputnikLite;949;141;1090;1637377;585822;2223199
2022.07_16-08-2022;Красноярский край;21_45_days;SputnikV;6745;4519;11264;1637377;585822;2223199
2022.07_16-08-2022;Красноярский край;45_75_days;AllVaccines;10687;6422;17109;1637377;585822;2223199
2022.07_16-08-2022;Красноярский край;45_75_days;CoviVac;711;224;935;1637377;585822;2223199
2022.07_16-08-2022;Красноярский край;45_75_days;EpiVacCorona;1085;766;1851;1637377;585822;2223199
2022.07_16-08-2022;Красноярский край;45_75_days;SputnikLite;1302;433;1735;1637377;585822;2223199
2022.07_16-08-2022;Красноярский край;45_75_days;SputnikV;7589;4999;12588;1637377;585822;2223199
2022.07_16-08-2022;Красноярский край;75_90_days;AllVaccines;8331;3767;12098;1637377;585822;2223199
2022.07_16-08-2022;Красноярский край;75_90_days;CoviVac;384;192;576;1637377;585822;2223199
2022.07_16-08-2022;Красноярский край;75_90_days;EpiVacCorona;710;435;1145;1637377;585822;2223199
2022.07_16-08-2022;Красноярский край;75_90_days;SputnikLite;2473;259;2732;1637377;585822;2223199
2022.07_16-08-2022;Красноярский край;75_90_days;SputnikV;4764;2881;7645;1637377;585822;2223199
2022.07_16-08-2022;Красноярский край;90_105_days;AllVaccines;10142;4290;14432;1637377;585822;2223199
2022.07_16-08-2022;Красноярский край;90_105_days;CoviVac;381;129;510;1637377;585822;2223199
2022.07_16-08-2022;Красноярский край;90_105_days;EpiVacCorona;635;362;997;1637377;585822;2223199
2022.07_16-08-2022;Красноярский край;90_105_days;SputnikLite;2392;339;2731;1637377;585822;2223199
2022.07_16-08-2022;Красноярский край;90_105_days;SputnikV;6734;3460;10194;1637377;585822;2223199
2022.07_16-08-2022;Курганская область;105_165_days;AllVaccines;29782;18208;47990;425081;217502;642583
2022.07_16-08-2022;Курганская область;105_165_days;CoviVac;269;68;337;425081;217502;642583
2022.07_16-08-2022;Курганская область;105_165_days;EpiVacCorona;2119;1517;3636;425081;217502;642583
2022.07_16-08-2022;Курганская область;105_165_days;SputnikLite;17914;10089;28003;425081;217502;642583
2022.07_16-08-2022;Курганская область;105_165_days;SputnikV;9480;6534;16014;425081;217502;642583
2022.07_16-08-2022;Курганская область;165_195_days;AllVaccines;22908;14220;37128;425081;217502;642583
2022.07_16-08-2022;Курганская область;165_195_days;CoviVac;180;58;238;425081;217502;642583
2022.07_16-08-2022;Курганская область;165_195_days;EpiVacCorona;1194;856;2050;425081;217502;642583
2022.07_16-08-2022;Курганская область;165_195_days;SputnikLite;15679;10423;26102;425081;217502;642583
2022.07_16-08-2022;Курганская область;165_195_days;SputnikV;5855;2883;8738;425081;217502;642583
2022.07_16-08-2022;Курганская область;21_45_days;AllVaccines;4164;4753;8917;425081;217502;642583
2022.07_16-08-2022;Курганская область;21_45_days;CoviVac;224;288;512;425081;217502;642583
2022.07_16-08-2022;Курганская область;21_45_days;EpiVacCorona;966;950;1916;425081;217502;642583
2022.07_16-08-2022;Курганская область;21_45_days;SputnikLite;142;112;254;425081;217502;642583
2022.07_16-08-2022;Курганская область;21_45_days;SputnikV;2832;3403;6235;425081;217502;642583
2022.07_16-08-2022;Курганская область;45_75_days;AllVaccines;3116;3125;6241;425081;217502;642583
2022.07_16-08-2022;Курганская область;45_75_days;CoviVac;58;76;134;425081;217502;642583
2022.07_16-08-2022;Курганская область;45_75_days;EpiVacCorona;452;409;861;425081;217502;642583
2022.07_16-08-2022;Курганская область;45_75_days;SputnikLite;705;341;1046;425081;217502;642583
2022.07_16-08-2022;Курганская область;45_75_days;SputnikV;1901;2299;4200;425081;217502;642583
2022.07_16-08-2022;Курганская область;75_90_days;AllVaccines;1616;1464;3080;425081;217502;642583
2022.07_16-08-2022;Курганская область;75_90_days;CoviVac;46;58;104;425081;217502;642583
2022.07_16-08-2022;Курганская область;75_90_days;EpiVacCorona;227;179;406;425081;217502;642583
2022.07_16-08-2022;Курганская область;75_90_days;SputnikLite;351;211;562;425081;217502;642583
2022.07_16-08-2022;Курганская область;75_90_days;SputnikV;992;1016;2008;425081;217502;642583
2022.07_16-08-2022;Курганская область;90_105_days;AllVaccines;1628;1398;3026;425081;217502;642583
2022.07_16-08-2022;Курганская область;90_105_days;CoviVac;19;56;75;425081;217502;642583
2022.07_16-08-2022;Курганская область;90_105_days;EpiVacCorona;196;203;399;425081;217502;642583
2022.07_16-08-2022;Курганская область;90_105_days;SputnikLite;347;184;531;425081;217502;642583
2022.07_16-08-2022;Курганская область;90_105_days;SputnikV;1066;955;2021;425081;217502;642583
2022.07_16-08-2022;Курская область;105_165_days;AllVaccines;33841;12905;46746;604409;285634;890043
2022.07_16-08-2022;Курская область;105_165_days;CoviVac;1049;205;1254;604409;285634;890043
2022.07_16-08-2022;Курская область;105_165_days;EpiVacCorona;1954;854;2808;604409;285634;890043
2022.07_16-08-2022;Курская область;105_165_days;SputnikLite;17812;5916;23728;604409;285634;890043
2022.07_16-08-2022;Курская область;105_165_days;SputnikV;13026;5930;18956;604409;285634;890043
2022.07_16-08-2022;Курская область;165_195_days;AllVaccines;28113;13088;41201;604409;285634;890043
2022.07_16-08-2022;Курская область;165_195_days;CoviVac;437;105;542;604409;285634;890043
2022.07_16-08-2022;Курская область;165_195_days;EpiVacCorona;1431;723;2154;604409;285634;890043
2022.07_16-08-2022;Курская область;165_195_days;SputnikLite;21186;9875;31061;604409;285634;890043
2022.07_16-08-2022;Курская область;165_195_days;SputnikV;5059;2385;7444;604409;285634;890043
2022.07_16-08-2022;Курская область;21_45_days;AllVaccines;4911;4013;8924;604409;285634;890043
2022.07_16-08-2022;Курская область;21_45_days;EpiVacCorona;291;195;486;604409;285634;890043
2022.07_16-08-2022;Курская область;21_45_days;SputnikLite;2202;1500;3702;604409;285634;890043
2022.07_16-08-2022;Курская область;21_45_days;SputnikV;2418;2318;4736;604409;285634;890043
2022.07_16-08-2022;Курская область;45_75_days;AllVaccines;4501;3201;7702;604409;285634;890043
2022.07_16-08-2022;Курская область;45_75_days;CoviVac;7;2;9;604409;285634;890043
2022.07_16-08-2022;Курская область;45_75_days;EpiVacCorona;251;114;365;604409;285634;890043
2022.07_16-08-2022;Курская область;45_75_days;SputnikLite;1541;679;2220;604409;285634;890043
2022.07_16-08-2022;Курская область;45_75_days;SputnikV;2702;2406;5108;604409;285634;890043
2022.07_16-08-2022;Курская область;75_90_days;AllVaccines;2807;1442;4249;604409;285634;890043
2022.07_16-08-2022;Курская область;75_90_days;CoviVac;106;12;118;604409;285634;890043
2022.07_16-08-2022;Курская область;75_90_days;EpiVacCorona;180;119;299;604409;285634;890043
2022.07_16-08-2022;Курская область;75_90_days;SputnikLite;897;163;1060;604409;285634;890043
2022.07_16-08-2022;Курская область;75_90_days;SputnikV;1624;1148;2772;604409;285634;890043
2022.07_16-08-2022;Курская область;90_105_days;AllVaccines;4123;2153;6276;604409;285634;890043
2022.07_16-08-2022;Курская область;90_105_days;CoviVac;94;15;109;604409;285634;890043
2022.07_16-08-2022;Курская область;90_105_days;EpiVacCorona;284;138;422;604409;285634;890043
2022.07_16-08-2022;Курская область;90_105_days;SputnikLite;773;244;1017;604409;285634;890043
2022.07_16-08-2022;Курская область;90_105_days;SputnikV;2972;1756;4728;604409;285634;890043
2022.07_16-08-2022;Ленинградская область;105_165_days;AllVaccines;39416;19813;59229;1100343;462742;1563085
2022.07_16-08-2022;Ленинградская область;105_165_days;CoviVac;566;96;662;1100343;462742;1563085
2022.07_16-08-2022;Ленинградская область;105_165_days;EpiVacCorona;752;356;1108;1100343;462742;1563085
2022.07_16-08-2022;Ленинградская область;105_165_days;SputnikLite;12373;7350;19723;1100343;462742;1563085
2022.07_16-08-2022;Ленинградская область;105_165_days;SputnikV;25725;12011;37736;1100343;462742;1563085
2022.07_16-08-2022;Ленинградская область;165_195_days;AllVaccines;37004;20596;57600;1100343;462742;1563085
2022.07_16-08-2022;Ленинградская область;165_195_days;CoviVac;412;87;499;1100343;462742;1563085
2022.07_16-08-2022;Ленинградская область;165_195_days;EpiVacCorona;951;564;1515;1100343;462742;1563085
2022.07_16-08-2022;Ленинградская область;165_195_days;SputnikLite;18279;13581;31860;1100343;462742;1563085
2022.07_16-08-2022;Ленинградская область;165_195_days;SputnikV;17362;6364;23726;1100343;462742;1563085
2022.07_16-08-2022;Ленинградская область;21_45_days;AllVaccines;3634;2572;6206;1100343;462742;1563085
2022.07_16-08-2022;Ленинградская область;21_45_days;CoviVac;50;30;80;1100343;462742;1563085
2022.07_16-08-2022;Ленинградская область;21_45_days;EpiVacCorona;94;61;155;1100343;462742;1563085
2022.07_16-08-2022;Ленинградская область;21_45_days;SputnikLite;461;181;642;1100343;462742;1563085
2022.07_16-08-2022;Ленинградская область;21_45_days;SputnikV;3029;2300;5329;1100343;462742;1563085
2022.07_16-08-2022;Ленинградская область;45_75_days;AllVaccines;4242;3443;7685;1100343;462742;1563085
2022.07_16-08-2022;Ленинградская область;45_75_days;CoviVac;104;45;149;1100343;462742;1563085
2022.07_16-08-2022;Ленинградская область;45_75_days;EpiVacCorona;67;33;100;1100343;462742;1563085
2022.07_16-08-2022;Ленинградская область;45_75_days;SputnikLite;872;615;1487;1100343;462742;1563085
2022.07_16-08-2022;Ленинградская область;45_75_days;SputnikV;3199;2750;5949;1100343;462742;1563085
2022.07_16-08-2022;Ленинградская область;75_90_days;AllVaccines;2500;1939;4439;1100343;462742;1563085
2022.07_16-08-2022;Ленинградская область;75_90_days;CoviVac;141;66;207;1100343;462742;1563085
2022.07_16-08-2022;Ленинградская область;75_90_days;EpiVacCorona;67;24;91;1100343;462742;1563085
2022.07_16-08-2022;Ленинградская область;75_90_days;SputnikLite;434;363;797;1100343;462742;1563085
2022.07_16-08-2022;Ленинградская область;75_90_days;SputnikV;1858;1486;3344;1100343;462742;1563085
2022.07_16-08-2022;Ленинградская область;90_105_days;AllVaccines;2759;2071;4830;1100343;462742;1563085
2022.07_16-08-2022;Ленинградская область;90_105_days;CoviVac;156;52;208;1100343;462742;1563085
2022.07_16-08-2022;Ленинградская область;90_105_days;EpiVacCorona;88;26;114;1100343;462742;1563085
2022.07_16-08-2022;Ленинградская область;90_105_days;SputnikLite;606;438;1044;1100343;462742;1563085
2022.07_16-08-2022;Ленинградская область;90_105_days;SputnikV;1909;1555;3464;1100343;462742;1563085
2022.07_16-08-2022;Липецкая область;105_165_days;AllVaccines;34506;14465;48971;621641;290878;912519
2022.07_16-08-2022;Липецкая область;105_165_days;CoviVac;1208;79;1287;621641;290878;912519
2022.07_16-08-2022;Липецкая область;105_165_days;EpiVacCorona;2586;1545;4131;621641;290878;912519
2022.07_16-08-2022;Липецкая область;105_165_days;SputnikLite;11609;4856;16465;621641;290878;912519
2022.07_16-08-2022;Липецкая область;105_165_days;SputnikV;19103;7985;27088;621641;290878;912519
2022.07_16-08-2022;Липецкая область;165_195_days;AllVaccines;23698;11481;35179;621641;290878;912519
2022.07_16-08-2022;Липецкая область;165_195_days;CoviVac;154;19;173;621641;290878;912519
2022.07_16-08-2022;Липецкая область;165_195_days;EpiVacCorona;2335;857;3192;621641;290878;912519
2022.07_16-08-2022;Липецкая область;165_195_days;SputnikLite;14573;8559;23132;621641;290878;912519
2022.07_16-08-2022;Липецкая область;165_195_days;SputnikV;6636;2046;8682;621641;290878;912519
2022.07_16-08-2022;Липецкая область;21_45_days;AllVaccines;9292;5874;15166;621641;290878;912519
2022.07_16-08-2022;Липецкая область;21_45_days;CoviVac;248;44;292;621641;290878;912519
2022.07_16-08-2022;Липецкая область;21_45_days;EpiVacCorona;1319;546;1865;621641;290878;912519
2022.07_16-08-2022;Липецкая область;21_45_days;SputnikLite;74;6;80;621641;290878;912519
2022.07_16-08-2022;Липецкая область;21_45_days;SputnikV;7651;5278;12929;621641;290878;912519
2022.07_16-08-2022;Липецкая область;45_75_days;AllVaccines;6955;5386;12341;621641;290878;912519
2022.07_16-08-2022;Липецкая область;45_75_days;CoviVac;338;72;410;621641;290878;912519
2022.07_16-08-2022;Липецкая область;45_75_days;EpiVacCorona;931;1248;2179;621641;290878;912519
2022.07_16-08-2022;Липецкая область;45_75_days;SputnikLite;96;60;156;621641;290878;912519
2022.07_16-08-2022;Липецкая область;45_75_days;SputnikV;5590;4006;9596;621641;290878;912519
2022.07_16-08-2022;Липецкая область;75_90_days;AllVaccines;5082;4029;9111;621641;290878;912519
2022.07_16-08-2022;Липецкая область;75_90_days;CoviVac;150;22;172;621641;290878;912519
2022.07_16-08-2022;Липецкая область;75_90_days;EpiVacCorona;516;412;928;621641;290878;912519
2022.07_16-08-2022;Липецкая область;75_90_days;SputnikLite;157;80;237;621641;290878;912519
2022.07_16-08-2022;Липецкая область;75_90_days;SputnikV;4259;3515;7774;621641;290878;912519
2022.07_16-08-2022;Липецкая область;90_105_days;AllVaccines;5065;2788;7853;621641;290878;912519
2022.07_16-08-2022;Липецкая область;90_105_days;CoviVac;426;44;470;621641;290878;912519
2022.07_16-08-2022;Липецкая область;90_105_days;EpiVacCorona;352;447;799;621641;290878;912519
2022.07_16-08-2022;Липецкая область;90_105_days;SputnikLite;477;225;702;621641;290878;912519
2022.07_16-08-2022;Липецкая область;90_105_days;SputnikV;3810;2072;5882;621641;290878;912519
2022.07_16-08-2022;Магаданская область;105_165_days;AllVaccines;6306;1708;8014;83196;26810;110006
2022.07_16-08-2022;Магаданская область;105_165_days;CoviVac;167;22;189;83196;26810;110006
2022.07_16-08-2022;Магаданская область;105_165_days;EpiVacCorona;322;84;406;83196;26810;110006
2022.07_16-08-2022;Магаданская область;105_165_days;SputnikLite;3706;994;4700;83196;26810;110006
2022.07_16-08-2022;Магаданская область;105_165_days;SputnikV;2111;608;2719;83196;26810;110006
2022.07_16-08-2022;Магаданская область;165_195_days;AllVaccines;4889;1446;6335;83196;26810;110006
2022.07_16-08-2022;Магаданская область;165_195_days;CoviVac;115;27;142;83196;26810;110006
2022.07_16-08-2022;Магаданская область;165_195_days;EpiVacCorona;265;57;322;83196;26810;110006
2022.07_16-08-2022;Магаданская область;165_195_days;SputnikLite;3414;1131;4545;83196;26810;110006
2022.07_16-08-2022;Магаданская область;165_195_days;SputnikV;1095;231;1326;83196;26810;110006
2022.07_16-08-2022;Магаданская область;21_45_days;AllVaccines;685;136;821;83196;26810;110006
2022.07_16-08-2022;Магаданская область;21_45_days;EpiVacCorona;61;6;67;83196;26810;110006
2022.07_16-08-2022;Магаданская область;21_45_days;SputnikLite;365;77;442;83196;26810;110006
2022.07_16-08-2022;Магаданская область;21_45_days;SputnikV;259;53;312;83196;26810;110006
2022.07_16-08-2022;Магаданская область;45_75_days;AllVaccines;1354;349;1703;83196;26810;110006
2022.07_16-08-2022;Магаданская область;45_75_days;EpiVacCorona;37;7;44;83196;26810;110006
2022.07_16-08-2022;Магаданская область;45_75_days;SputnikLite;1078;282;1360;83196;26810;110006
2022.07_16-08-2022;Магаданская область;45_75_days;SputnikV;239;60;299;83196;26810;110006
2022.07_16-08-2022;Магаданская область;75_90_days;AllVaccines;541;220;761;83196;26810;110006
2022.07_16-08-2022;Магаданская область;75_90_days;EpiVacCorona;12;6;18;83196;26810;110006
2022.07_16-08-2022;Магаданская область;75_90_days;SputnikLite;425;180;605;83196;26810;110006
2022.07_16-08-2022;Магаданская область;75_90_days;SputnikV;104;34;138;83196;26810;110006
2022.07_16-08-2022;Магаданская область;90_105_days;AllVaccines;699;189;888;83196;26810;110006
2022.07_16-08-2022;Магаданская область;90_105_days;CoviVac;1;0;1;83196;26810;110006
2022.07_16-08-2022;Магаданская область;90_105_days;EpiVacCorona;17;4;21;83196;26810;110006
2022.07_16-08-2022;Магаданская область;90_105_days;SputnikLite;491;135;626;83196;26810;110006
2022.07_16-08-2022;Магаданская область;90_105_days;SputnikV;190;50;240;83196;26810;110006
2022.07_16-08-2022;Московская область;105_165_days;AllVaccines;236123;91037;327160;4485323;1674471;6159794
2022.07_16-08-2022;Московская область;105_165_days;CoviVac;2646;780;3426;4485323;1674471;6159794
2022.07_16-08-2022;Московская область;105_165_days;EpiVacCorona;4397;2677;7074;4485323;1674471;6159794
2022.07_16-08-2022;Московская область;105_165_days;SputnikLite;97468;46716;144184;4485323;1674471;6159794
2022.07_16-08-2022;Московская область;105_165_days;SputnikV;131612;40864;172476;4485323;1674471;6159794
2022.07_16-08-2022;Московская область;165_195_days;AllVaccines;166347;76013;242360;4485323;1674471;6159794
2022.07_16-08-2022;Московская область;165_195_days;CoviVac;878;340;1218;4485323;1674471;6159794
2022.07_16-08-2022;Московская область;165_195_days;EpiVacCorona;1641;1360;3001;4485323;1674471;6159794
2022.07_16-08-2022;Московская область;165_195_days;SputnikLite;100550;53748;154298;4485323;1674471;6159794
2022.07_16-08-2022;Московская область;165_195_days;SputnikV;63278;20565;83843;4485323;1674471;6159794
2022.07_16-08-2022;Московская область;21_45_days;AllVaccines;34763;14949;49712;4485323;1674471;6159794
2022.07_16-08-2022;Московская область;21_45_days;CoviVac;306;105;411;4485323;1674471;6159794
2022.07_16-08-2022;Московская область;21_45_days;EpiVacCorona;2548;1545;4093;4485323;1674471;6159794
2022.07_16-08-2022;Московская область;21_45_days;SputnikLite;8121;3851;11972;4485323;1674471;6159794
2022.07_16-08-2022;Московская область;21_45_days;SputnikV;23788;9448;33236;4485323;1674471;6159794
2022.07_16-08-2022;Московская область;45_75_days;AllVaccines;31455;18236;49691;4485323;1674471;6159794
2022.07_16-08-2022;Московская область;45_75_days;CoviVac;233;125;358;4485323;1674471;6159794
2022.07_16-08-2022;Московская область;45_75_days;EpiVacCorona;1706;1003;2709;4485323;1674471;6159794
2022.07_16-08-2022;Московская область;45_75_days;SputnikLite;11677;8261;19938;4485323;1674471;6159794
2022.07_16-08-2022;Московская область;45_75_days;SputnikV;17839;8847;26686;4485323;1674471;6159794
2022.07_16-08-2022;Московская область;75_90_days;AllVaccines;17166;10056;27222;4485323;1674471;6159794
2022.07_16-08-2022;Московская область;75_90_days;CoviVac;264;73;337;4485323;1674471;6159794
2022.07_16-08-2022;Московская область;75_90_days;EpiVacCorona;625;754;1379;4485323;1674471;6159794
2022.07_16-08-2022;Московская область;75_90_days;SputnikLite;6378;4611;10989;4485323;1674471;6159794
2022.07_16-08-2022;Московская область;75_90_days;SputnikV;9899;4618;14517;4485323;1674471;6159794
2022.07_16-08-2022;Московская область;90_105_days;AllVaccines;21026;10804;31830;4485323;1674471;6159794
2022.07_16-08-2022;Московская область;90_105_days;CoviVac;208;53;261;4485323;1674471;6159794
2022.07_16-08-2022;Московская область;90_105_days;EpiVacCorona;893;429;1322;4485323;1674471;6159794
2022.07_16-08-2022;Московская область;90_105_days;SputnikLite;8759;5944;14703;4485323;1674471;6159794
2022.07_16-08-2022;Московская область;90_105_days;SputnikV;11166;4378;15544;4485323;1674471;6159794
2022.07_16-08-2022;Мурманская область;105_165_days;AllVaccines;23254;9021;32275;436555;144366;580921
2022.07_16-08-2022;Мурманская область;105_165_days;CoviVac;503;79;582;436555;144366;580921
2022.07_16-08-2022;Мурманская область;105_165_days;EpiVacCorona;188;88;276;436555;144366;580921
2022.07_16-08-2022;Мурманская область;105_165_days;SputnikLite;13179;5404;18583;436555;144366;580921
2022.07_16-08-2022;Мурманская область;105_165_days;SputnikV;9384;3450;12834;436555;144366;580921
2022.07_16-08-2022;Мурманская область;165_195_days;AllVaccines;18845;7004;25849;436555;144366;580921
2022.07_16-08-2022;Мурманская область;165_195_days;CoviVac;230;37;267;436555;144366;580921
2022.07_16-08-2022;Мурманская область;165_195_days;EpiVacCorona;460;181;641;436555;144366;580921
2022.07_16-08-2022;Мурманская область;165_195_days;SputnikLite;11092;4976;16068;436555;144366;580921
2022.07_16-08-2022;Мурманская область;165_195_days;SputnikV;7063;1810;8873;436555;144366;580921
2022.07_16-08-2022;Мурманская область;21_45_days;AllVaccines;3049;1614;4663;436555;144366;580921
2022.07_16-08-2022;Мурманская область;21_45_days;EpiVacCorona;142;76;218;436555;144366;580921
2022.07_16-08-2022;Мурманская область;21_45_days;SputnikLite;485;147;632;436555;144366;580921
2022.07_16-08-2022;Мурманская область;21_45_days;SputnikV;2422;1391;3813;436555;144366;580921
2022.07_16-08-2022;Мурманская область;45_75_days;AllVaccines;3274;1447;4721;436555;144366;580921
2022.07_16-08-2022;Мурманская область;45_75_days;CoviVac;44;17;61;436555;144366;580921
2022.07_16-08-2022;Мурманская область;45_75_days;EpiVacCorona;90;32;122;436555;144366;580921
2022.07_16-08-2022;Мурманская область;45_75_days;SputnikLite;1131;374;1505;436555;144366;580921
2022.07_16-08-2022;Мурманская область;45_75_days;SputnikV;2009;1024;3033;436555;144366;580921
2022.07_16-08-2022;Мурманская область;75_90_days;AllVaccines;2694;1125;3819;436555;144366;580921
2022.07_16-08-2022;Мурманская область;75_90_days;CoviVac;106;26;132;436555;144366;580921
2022.07_16-08-2022;Мурманская область;75_90_days;EpiVacCorona;26;7;33;436555;144366;580921
2022.07_16-08-2022;Мурманская область;75_90_days;SputnikLite;1502;684;2186;436555;144366;580921
2022.07_16-08-2022;Мурманская область;75_90_days;SputnikV;1060;408;1468;436555;144366;580921
2022.07_16-08-2022;Мурманская область;90_105_days;AllVaccines;2990;1244;4234;436555;144366;580921
2022.07_16-08-2022;Мурманская область;90_105_days;CoviVac;77;22;99;436555;144366;580921
2022.07_16-08-2022;Мурманская область;90_105_days;EpiVacCorona;11;26;37;436555;144366;580921
2022.07_16-08-2022;Мурманская область;90_105_days;SputnikLite;1796;803;2599;436555;144366;580921
2022.07_16-08-2022;Мурманская область;90_105_days;SputnikV;1106;393;1499;436555;144366;580921
2022.07_16-08-2022;Ненецкий автономный округ;105_165_days;AllVaccines;807;397;1204;24931;7449;32380
2022.07_16-08-2022;Ненецкий автономный округ;105_165_days;EpiVacCorona;4;0;4;24931;7449;32380
2022.07_16-08-2022;Ненецкий автономный округ;105_165_days;SputnikLite;611;336;947;24931;7449;32380
2022.07_16-08-2022;Ненецкий автономный округ;105_165_days;SputnikV;192;61;253;24931;7449;32380
2022.07_16-08-2022;Ненецкий автономный округ;165_195_days;AllVaccines;954;316;1270;24931;7449;32380
2022.07_16-08-2022;Ненецкий автономный округ;165_195_days;EpiVacCorona;13;2;15;24931;7449;32380
2022.07_16-08-2022;Ненецкий автономный округ;165_195_days;SputnikLite;826;302;1128;24931;7449;32380
2022.07_16-08-2022;Ненецкий автономный округ;165_195_days;SputnikV;115;12;127;24931;7449;32380
2022.07_16-08-2022;Ненецкий автономный округ;21_45_days;AllVaccines;264;76;340;24931;7449;32380
2022.07_16-08-2022;Ненецкий автономный округ;21_45_days;SputnikLite;231;73;304;24931;7449;32380
2022.07_16-08-2022;Ненецкий автономный округ;21_45_days;SputnikV;33;3;36;24931;7449;32380
2022.07_16-08-2022;Ненецкий автономный округ;45_75_days;AllVaccines;313;131;444;24931;7449;32380
2022.07_16-08-2022;Ненецкий автономный округ;45_75_days;SputnikLite;295;122;417;24931;7449;32380
2022.07_16-08-2022;Ненецкий автономный округ;45_75_days;SputnikV;18;9;27;24931;7449;32380
2022.07_16-08-2022;Ненецкий автономный округ;75_90_days;AllVaccines;154;80;234;24931;7449;32380
2022.07_16-08-2022;Ненецкий автономный округ;75_90_days;SputnikLite;145;75;220;24931;7449;32380
2022.07_16-08-2022;Ненецкий автономный округ;75_90_days;SputnikV;9;5;14;24931;7449;32380
2022.07_16-08-2022;Ненецкий автономный округ;90_105_days;AllVaccines;94;38;132;24931;7449;32380
2022.07_16-08-2022;Ненецкий автономный округ;90_105_days;EpiVacCorona;4;0;4;24931;7449;32380
2022.07_16-08-2022;Ненецкий автономный округ;90_105_days;SputnikLite;81;36;117;24931;7449;32380
2022.07_16-08-2022;Ненецкий автономный округ;90_105_days;SputnikV;9;2;11;24931;7449;32380
2022.07_16-08-2022;Нижегородская область;105_165_days;AllVaccines;60496;28285;88781;1769909;800663;2570572
2022.07_16-08-2022;Нижегородская область;105_165_days;CoviVac;1295;380;1675;1769909;800663;2570572
2022.07_16-08-2022;Нижегородская область;105_165_days;EpiVacCorona;2630;1858;4488;1769909;800663;2570572
2022.07_16-08-2022;Нижегородская область;105_165_days;SputnikLite;26447;11565;38012;1769909;800663;2570572
2022.07_16-08-2022;Нижегородская область;105_165_days;SputnikV;30124;14482;44606;1769909;800663;2570572
2022.07_16-08-2022;Нижегородская область;165_195_days;AllVaccines;60928;36660;97588;1769909;800663;2570572
2022.07_16-08-2022;Нижегородская область;165_195_days;CoviVac;574;219;793;1769909;800663;2570572
2022.07_16-08-2022;Нижегородская область;165_195_days;EpiVacCorona;2110;1779;3889;1769909;800663;2570572
2022.07_16-08-2022;Нижегородская область;165_195_days;SputnikLite;41060;25486;66546;1769909;800663;2570572
2022.07_16-08-2022;Нижегородская область;165_195_days;SputnikV;17184;9176;26360;1769909;800663;2570572
2022.07_16-08-2022;Нижегородская область;21_45_days;AllVaccines;9815;9651;19466;1769909;800663;2570572
2022.07_16-08-2022;Нижегородская область;21_45_days;CoviVac;68;13;81;1769909;800663;2570572
2022.07_16-08-2022;Нижегородская область;21_45_days;EpiVacCorona;548;334;882;1769909;800663;2570572
2022.07_16-08-2022;Нижегородская область;21_45_days;SputnikLite;4351;4079;8430;1769909;800663;2570572
2022.07_16-08-2022;Нижегородская область;21_45_days;SputnikV;4848;5225;10073;1769909;800663;2570572
2022.07_16-08-2022;Нижегородская область;45_75_days;AllVaccines;6372;6208;12580;1769909;800663;2570572
2022.07_16-08-2022;Нижегородская область;45_75_days;CoviVac;188;70;258;1769909;800663;2570572
2022.07_16-08-2022;Нижегородская область;45_75_days;EpiVacCorona;499;356;855;1769909;800663;2570572
2022.07_16-08-2022;Нижегородская область;45_75_days;SputnikLite;560;332;892;1769909;800663;2570572
2022.07_16-08-2022;Нижегородская область;45_75_days;SputnikV;5125;5450;10575;1769909;800663;2570572
2022.07_16-08-2022;Нижегородская область;75_90_days;AllVaccines;4031;3842;7873;1769909;800663;2570572
2022.07_16-08-2022;Нижегородская область;75_90_days;CoviVac;103;26;129;1769909;800663;2570572
2022.07_16-08-2022;Нижегородская область;75_90_days;EpiVacCorona;285;229;514;1769909;800663;2570572
2022.07_16-08-2022;Нижегородская область;75_90_days;SputnikLite;405;240;645;1769909;800663;2570572
2022.07_16-08-2022;Нижегородская область;75_90_days;SputnikV;3238;3347;6585;1769909;800663;2570572
2022.07_16-08-2022;Нижегородская область;90_105_days;AllVaccines;5528;4525;10053;1769909;800663;2570572
2022.07_16-08-2022;Нижегородская область;90_105_days;CoviVac;154;45;199;1769909;800663;2570572
2022.07_16-08-2022;Нижегородская область;90_105_days;EpiVacCorona;470;319;789;1769909;800663;2570572
2022.07_16-08-2022;Нижегородская область;90_105_days;SputnikLite;894;603;1497;1769909;800663;2570572
2022.07_16-08-2022;Нижегородская область;90_105_days;SputnikV;4010;3558;7568;1769909;800663;2570572
2022.07_16-08-2022;Новгородская область;105_165_days;AllVaccines;10283;7534;17817;317276;158308;475584
2022.07_16-08-2022;Новгородская область;105_165_days;CoviVac;505;201;706;317276;158308;475584
2022.07_16-08-2022;Новгородская область;105_165_days;EpiVacCorona;720;623;1343;317276;158308;475584
2022.07_16-08-2022;Новгородская область;105_165_days;SputnikLite;2950;2170;5120;317276;158308;475584
2022.07_16-08-2022;Новгородская область;105_165_days;SputnikV;6108;4540;10648;317276;158308;475584
2022.07_16-08-2022;Новгородская область;165_195_days;AllVaccines;9354;6928;16282;317276;158308;475584
2022.07_16-08-2022;Новгородская область;165_195_days;CoviVac;294;125;419;317276;158308;475584
2022.07_16-08-2022;Новгородская область;165_195_days;EpiVacCorona;712;402;1114;317276;158308;475584
2022.07_16-08-2022;Новгородская область;165_195_days;SputnikLite;5042;4074;9116;317276;158308;475584
2022.07_16-08-2022;Новгородская область;165_195_days;SputnikV;3306;2327;5633;317276;158308;475584
2022.07_16-08-2022;Новгородская область;21_45_days;AllVaccines;1099;1076;2175;317276;158308;475584
2022.07_16-08-2022;Новгородская область;21_45_days;CoviVac;53;12;65;317276;158308;475584
2022.07_16-08-2022;Новгородская область;21_45_days;EpiVacCorona;54;44;98;317276;158308;475584
2022.07_16-08-2022;Новгородская область;21_45_days;SputnikLite;256;277;533;317276;158308;475584
2022.07_16-08-2022;Новгородская область;21_45_days;SputnikV;736;743;1479;317276;158308;475584
2022.07_16-08-2022;Новгородская область;45_75_days;AllVaccines;1165;1110;2275;317276;158308;475584
2022.07_16-08-2022;Новгородская область;45_75_days;CoviVac;95;37;132;317276;158308;475584
2022.07_16-08-2022;Новгородская область;45_75_days;EpiVacCorona;19;44;63;317276;158308;475584
2022.07_16-08-2022;Новгородская область;45_75_days;SputnikLite;389;350;739;317276;158308;475584
2022.07_16-08-2022;Новгородская область;45_75_days;SputnikV;662;679;1341;317276;158308;475584
2022.07_16-08-2022;Новгородская область;75_90_days;AllVaccines;808;706;1514;317276;158308;475584
2022.07_16-08-2022;Новгородская область;75_90_days;CoviVac;52;31;83;317276;158308;475584
2022.07_16-08-2022;Новгородская область;75_90_days;EpiVacCorona;15;38;53;317276;158308;475584
2022.07_16-08-2022;Новгородская область;75_90_days;SputnikLite;264;228;492;317276;158308;475584
2022.07_16-08-2022;Новгородская область;75_90_days;SputnikV;477;409;886;317276;158308;475584
2022.07_16-08-2022;Новгородская область;90_105_days;AllVaccines;883;842;1725;317276;158308;475584
2022.07_16-08-2022;Новгородская область;90_105_days;CoviVac;61;15;76;317276;158308;475584
2022.07_16-08-2022;Новгородская область;90_105_days;EpiVacCorona;57;54;111;317276;158308;475584
2022.07_16-08-2022;Новгородская область;90_105_days;SputnikLite;209;217;426;317276;158308;475584
2022.07_16-08-2022;Новгородская область;90_105_days;SputnikV;556;556;1112;317276;158308;475584
2022.07_16-08-2022;Новосибирская область;105_165_days;AllVaccines;71184;35668;106852;1571829;624100;2195929
2022.07_16-08-2022;Новосибирская область;105_165_days;CoviVac;1754;416;2170;1571829;624100;2195929
2022.07_16-08-2022;Новосибирская область;105_165_days;EpiVacCorona;1987;1249;3236;1571829;624100;2195929
2022.07_16-08-2022;Новосибирская область;105_165_days;SputnikLite;29084;14254;43338;1571829;624100;2195929
2022.07_16-08-2022;Новосибирская область;105_165_days;SputnikV;38359;19749;58108;1571829;624100;2195929
2022.07_16-08-2022;Новосибирская область;165_195_days;AllVaccines;75839;42221;118060;1571829;624100;2195929
2022.07_16-08-2022;Новосибирская область;165_195_days;CoviVac;835;230;1065;1571829;624100;2195929
2022.07_16-08-2022;Новосибирская область;165_195_days;EpiVacCorona;1530;982;2512;1571829;624100;2195929
2022.07_16-08-2022;Новосибирская область;165_195_days;SputnikLite;45225;31414;76639;1571829;624100;2195929
2022.07_16-08-2022;Новосибирская область;165_195_days;SputnikV;28249;9595;37844;1571829;624100;2195929
2022.07_16-08-2022;Новосибирская область;21_45_days;AllVaccines;5460;6015;11475;1571829;624100;2195929
2022.07_16-08-2022;Новосибирская область;21_45_days;CoviVac;139;65;204;1571829;624100;2195929
2022.07_16-08-2022;Новосибирская область;21_45_days;EpiVacCorona;827;920;1747;1571829;624100;2195929
2022.07_16-08-2022;Новосибирская область;21_45_days;SputnikLite;99;63;162;1571829;624100;2195929
2022.07_16-08-2022;Новосибирская область;21_45_days;SputnikV;4395;4967;9362;1571829;624100;2195929
2022.07_16-08-2022;Новосибирская область;45_75_days;AllVaccines;6496;5739;12235;1571829;624100;2195929
2022.07_16-08-2022;Новосибирская область;45_75_days;CoviVac;725;179;904;1571829;624100;2195929
2022.07_16-08-2022;Новосибирская область;45_75_days;EpiVacCorona;943;897;1840;1571829;624100;2195929
2022.07_16-08-2022;Новосибирская область;45_75_days;SputnikLite;267;113;380;1571829;624100;2195929
2022.07_16-08-2022;Новосибирская область;45_75_days;SputnikV;4561;4550;9111;1571829;624100;2195929
2022.07_16-08-2022;Новосибирская область;75_90_days;AllVaccines;3880;3132;7012;1571829;624100;2195929
2022.07_16-08-2022;Новосибирская область;75_90_days;CoviVac;262;89;351;1571829;624100;2195929
2022.07_16-08-2022;Новосибирская область;75_90_days;EpiVacCorona;218;215;433;1571829;624100;2195929
2022.07_16-08-2022;Новосибирская область;75_90_days;SputnikLite;222;131;353;1571829;624100;2195929
2022.07_16-08-2022;Новосибирская область;75_90_days;SputnikV;3178;2697;5875;1571829;624100;2195929
2022.07_16-08-2022;Новосибирская область;90_105_days;AllVaccines;5643;4038;9681;1571829;624100;2195929
2022.07_16-08-2022;Новосибирская область;90_105_days;CoviVac;258;70;328;1571829;624100;2195929
2022.07_16-08-2022;Новосибирская область;90_105_days;EpiVacCorona;305;302;607;1571829;624100;2195929
2022.07_16-08-2022;Новосибирская область;90_105_days;SputnikLite;517;311;828;1571829;624100;2195929
2022.07_16-08-2022;Новосибирская область;90_105_days;SputnikV;4563;3355;7918;1571829;624100;2195929
2022.07_16-08-2022;Омская область;105_165_days;AllVaccines;61534;23036;84570;1058291;431046;1489337
2022.07_16-08-2022;Омская область;105_165_days;CoviVac;996;213;1209;1058291;431046;1489337
2022.07_16-08-2022;Омская область;105_165_days;EpiVacCorona;2511;1114;3625;1058291;431046;1489337
2022.07_16-08-2022;Омская область;105_165_days;SputnikLite;24096;7758;31854;1058291;431046;1489337
2022.07_16-08-2022;Омская область;105_165_days;SputnikV;33931;13951;47882;1058291;431046;1489337
2022.07_16-08-2022;Омская область;165_195_days;AllVaccines;47300;21826;69126;1058291;431046;1489337
2022.07_16-08-2022;Омская область;165_195_days;CoviVac;492;143;635;1058291;431046;1489337
2022.07_16-08-2022;Омская область;165_195_days;EpiVacCorona;1620;633;2253;1058291;431046;1489337
2022.07_16-08-2022;Омская область;165_195_days;SputnikLite;25338;13279;38617;1058291;431046;1489337
2022.07_16-08-2022;Омская область;165_195_days;SputnikV;19850;7771;27621;1058291;431046;1489337
2022.07_16-08-2022;Омская область;21_45_days;AllVaccines;9259;5393;14652;1058291;431046;1489337
2022.07_16-08-2022;Омская область;21_45_days;CoviVac;118;35;153;1058291;431046;1489337
2022.07_16-08-2022;Омская область;21_45_days;EpiVacCorona;1968;911;2879;1058291;431046;1489337
2022.07_16-08-2022;Омская область;21_45_days;SputnikLite;270;162;432;1058291;431046;1489337
2022.07_16-08-2022;Омская область;21_45_days;SputnikV;6903;4285;11188;1058291;431046;1489337
2022.07_16-08-2022;Омская область;45_75_days;AllVaccines;7774;3908;11682;1058291;431046;1489337
2022.07_16-08-2022;Омская область;45_75_days;CoviVac;383;87;470;1058291;431046;1489337
2022.07_16-08-2022;Омская область;45_75_days;EpiVacCorona;1028;504;1532;1058291;431046;1489337
2022.07_16-08-2022;Омская область;45_75_days;SputnikLite;438;230;668;1058291;431046;1489337
2022.07_16-08-2022;Омская область;45_75_days;SputnikV;5925;3087;9012;1058291;431046;1489337
2022.07_16-08-2022;Омская область;75_90_days;AllVaccines;4293;2212;6505;1058291;431046;1489337
2022.07_16-08-2022;Омская область;75_90_days;CoviVac;360;93;453;1058291;431046;1489337
2022.07_16-08-2022;Омская область;75_90_days;EpiVacCorona;480;234;714;1058291;431046;1489337
2022.07_16-08-2022;Омская область;75_90_days;SputnikLite;597;210;807;1058291;431046;1489337
2022.07_16-08-2022;Омская область;75_90_days;SputnikV;2856;1675;4531;1058291;431046;1489337
2022.07_16-08-2022;Омская область;90_105_days;AllVaccines;5851;2669;8520;1058291;431046;1489337
2022.07_16-08-2022;Омская область;90_105_days;CoviVac;158;44;202;1058291;431046;1489337
2022.07_16-08-2022;Омская область;90_105_days;EpiVacCorona;619;232;851;1058291;431046;1489337
2022.07_16-08-2022;Омская область;90_105_days;SputnikLite;1211;591;1802;1058291;431046;1489337
2022.07_16-08-2022;Омская область;90_105_days;SputnikV;3863;1802;5665;1058291;431046;1489337
2022.07_16-08-2022;Оренбургская область;105_165_days;AllVaccines;74454;25524;99978;1068899;440686;1509585
2022.07_16-08-2022;Оренбургская область;105_165_days;CoviVac;1492;119;1611;1068899;440686;1509585
2022.07_16-08-2022;Оренбургская область;105_165_days;EpiVacCorona;2762;1083;3845;1068899;440686;1509585
2022.07_16-08-2022;Оренбургская область;105_165_days;SputnikLite;39236;12990;52226;1068899;440686;1509585
2022.07_16-08-2022;Оренбургская область;105_165_days;SputnikV;30964;11332;42296;1068899;440686;1509585
2022.07_16-08-2022;Оренбургская область;165_195_days;AllVaccines;58541;22507;81048;1068899;440686;1509585
2022.07_16-08-2022;Оренбургская область;165_195_days;CoviVac;567;76;643;1068899;440686;1509585
2022.07_16-08-2022;Оренбургская область;165_195_days;EpiVacCorona;2592;973;3565;1068899;440686;1509585
2022.07_16-08-2022;Оренбургская область;165_195_days;SputnikLite;42592;17086;59678;1068899;440686;1509585
2022.07_16-08-2022;Оренбургская область;165_195_days;SputnikV;12790;4372;17162;1068899;440686;1509585
2022.07_16-08-2022;Оренбургская область;21_45_days;AllVaccines;6883;4819;11702;1068899;440686;1509585
2022.07_16-08-2022;Оренбургская область;21_45_days;CoviVac;279;17;296;1068899;440686;1509585
2022.07_16-08-2022;Оренбургская область;21_45_days;EpiVacCorona;349;230;579;1068899;440686;1509585
2022.07_16-08-2022;Оренбургская область;21_45_days;SputnikLite;77;39;116;1068899;440686;1509585
2022.07_16-08-2022;Оренбургская область;21_45_days;SputnikV;6178;4533;10711;1068899;440686;1509585
2022.07_16-08-2022;Оренбургская область;45_75_days;AllVaccines;7015;4031;11046;1068899;440686;1509585
2022.07_16-08-2022;Оренбургская область;45_75_days;CoviVac;460;16;476;1068899;440686;1509585
2022.07_16-08-2022;Оренбургская область;45_75_days;EpiVacCorona;346;202;548;1068899;440686;1509585
2022.07_16-08-2022;Оренбургская область;45_75_days;SputnikLite;156;50;206;1068899;440686;1509585
2022.07_16-08-2022;Оренбургская область;45_75_days;SputnikV;6053;3763;9816;1068899;440686;1509585
2022.07_16-08-2022;Оренбургская область;75_90_days;AllVaccines;4361;2411;6772;1068899;440686;1509585
2022.07_16-08-2022;Оренбургская область;75_90_days;CoviVac;398;61;459;1068899;440686;1509585
2022.07_16-08-2022;Оренбургская область;75_90_days;EpiVacCorona;272;149;421;1068899;440686;1509585
2022.07_16-08-2022;Оренбургская область;75_90_days;SputnikLite;57;27;84;1068899;440686;1509585
2022.07_16-08-2022;Оренбургская область;75_90_days;SputnikV;3634;2174;5808;1068899;440686;1509585
2022.07_16-08-2022;Оренбургская область;90_105_days;AllVaccines;6122;2996;9118;1068899;440686;1509585
2022.07_16-08-2022;Оренбургская область;90_105_days;CoviVac;376;27;403;1068899;440686;1509585
2022.07_16-08-2022;Оренбургская область;90_105_days;EpiVacCorona;292;125;417;1068899;440686;1509585
2022.07_16-08-2022;Оренбургская область;90_105_days;SputnikLite;73;43;116;1068899;440686;1509585
2022.07_16-08-2022;Оренбургская область;90_105_days;SputnikV;5381;2801;8182;1068899;440686;1509585
2022.07_16-08-2022;Орловская область;105_165_days;AllVaccines;13712;6720;20432;398663;193123;591786
2022.07_16-08-2022;Орловская область;105_165_days;CoviVac;368;59;427;398663;193123;591786
2022.07_16-08-2022;Орловская область;105_165_days;EpiVacCorona;881;301;1182;398663;193123;591786
2022.07_16-08-2022;Орловская область;105_165_days;SputnikLite;5778;3030;8808;398663;193123;591786
2022.07_16-08-2022;Орловская область;105_165_days;SputnikV;6685;3330;10015;398663;193123;591786
2022.07_16-08-2022;Орловская область;165_195_days;AllVaccines;15631;9036;24667;398663;193123;591786
2022.07_16-08-2022;Орловская область;165_195_days;CoviVac;330;81;411;398663;193123;591786
2022.07_16-08-2022;Орловская область;165_195_days;EpiVacCorona;546;256;802;398663;193123;591786
2022.07_16-08-2022;Орловская область;165_195_days;SputnikLite;10007;6490;16497;398663;193123;591786
2022.07_16-08-2022;Орловская область;165_195_days;SputnikV;4748;2209;6957;398663;193123;591786
2022.07_16-08-2022;Орловская область;21_45_days;AllVaccines;2706;1426;4132;398663;193123;591786
2022.07_16-08-2022;Орловская область;21_45_days;CoviVac;1;0;1;398663;193123;591786
2022.07_16-08-2022;Орловская область;21_45_days;EpiVacCorona;122;57;179;398663;193123;591786
2022.07_16-08-2022;Орловская область;21_45_days;SputnikLite;66;28;94;398663;193123;591786
2022.07_16-08-2022;Орловская область;21_45_days;SputnikV;2517;1341;3858;398663;193123;591786
2022.07_16-08-2022;Орловская область;45_75_days;AllVaccines;1521;1166;2687;398663;193123;591786
2022.07_16-08-2022;Орловская область;45_75_days;CoviVac;3;0;3;398663;193123;591786
2022.07_16-08-2022;Орловская область;45_75_days;EpiVacCorona;178;39;217;398663;193123;591786
2022.07_16-08-2022;Орловская область;45_75_days;SputnikLite;112;75;187;398663;193123;591786
2022.07_16-08-2022;Орловская область;45_75_days;SputnikV;1228;1052;2280;398663;193123;591786
2022.07_16-08-2022;Орловская область;75_90_days;AllVaccines;1236;796;2032;398663;193123;591786
2022.07_16-08-2022;Орловская область;75_90_days;CoviVac;48;3;51;398663;193123;591786
2022.07_16-08-2022;Орловская область;75_90_days;EpiVacCorona;153;32;185;398663;193123;591786
2022.07_16-08-2022;Орловская область;75_90_days;SputnikLite;60;34;94;398663;193123;591786
2022.07_16-08-2022;Орловская область;75_90_days;SputnikV;975;727;1702;398663;193123;591786
2022.07_16-08-2022;Орловская область;90_105_days;AllVaccines;1261;845;2106;398663;193123;591786
2022.07_16-08-2022;Орловская область;90_105_days;CoviVac;59;6;65;398663;193123;591786
2022.07_16-08-2022;Орловская область;90_105_days;EpiVacCorona;90;32;122;398663;193123;591786
2022.07_16-08-2022;Орловская область;90_105_days;SputnikLite;78;49;127;398663;193123;591786
2022.07_16-08-2022;Орловская область;90_105_days;SputnikV;1034;758;1792;398663;193123;591786
2022.07_16-08-2022;Пензенская область;105_165_days;AllVaccines;53221;56688;109909;710438;350687;1061125
2022.07_16-08-2022;Пензенская область;105_165_days;CoviVac;1547;827;2374;710438;350687;1061125
2022.07_16-08-2022;Пензенская область;105_165_days;EpiVacCorona;3339;6900;10239;710438;350687;1061125
2022.07_16-08-2022;Пензенская область;105_165_days;SputnikLite;21405;10686;32091;710438;350687;1061125
2022.07_16-08-2022;Пензенская область;105_165_days;SputnikV;26930;38275;65205;710438;350687;1061125
2022.07_16-08-2022;Пензенская область;165_195_days;AllVaccines;32085;29114;61199;710438;350687;1061125
2022.07_16-08-2022;Пензенская область;165_195_days;CoviVac;258;132;390;710438;350687;1061125
2022.07_16-08-2022;Пензенская область;165_195_days;EpiVacCorona;1037;3265;4302;710438;350687;1061125
2022.07_16-08-2022;Пензенская область;165_195_days;SputnikLite;21789;11776;33565;710438;350687;1061125
2022.07_16-08-2022;Пензенская область;165_195_days;SputnikV;9001;13941;22942;710438;350687;1061125
2022.07_16-08-2022;Пензенская область;21_45_days;AllVaccines;15986;16491;32477;710438;350687;1061125
2022.07_16-08-2022;Пензенская область;21_45_days;EpiVacCorona;538;590;1128;710438;350687;1061125
2022.07_16-08-2022;Пензенская область;21_45_days;SputnikLite;279;223;502;710438;350687;1061125
2022.07_16-08-2022;Пензенская область;21_45_days;SputnikV;15169;15678;30847;710438;350687;1061125
2022.07_16-08-2022;Пензенская область;45_75_days;AllVaccines;15081;15687;30768;710438;350687;1061125
2022.07_16-08-2022;Пензенская область;45_75_days;CoviVac;5;2;7;710438;350687;1061125
2022.07_16-08-2022;Пензенская область;45_75_days;EpiVacCorona;1704;1965;3669;710438;350687;1061125
2022.07_16-08-2022;Пензенская область;45_75_days;SputnikLite;447;369;816;710438;350687;1061125
2022.07_16-08-2022;Пензенская область;45_75_days;SputnikV;12925;13351;26276;710438;350687;1061125
2022.07_16-08-2022;Пензенская область;75_90_days;AllVaccines;9640;12131;21771;710438;350687;1061125
2022.07_16-08-2022;Пензенская область;75_90_days;CoviVac;251;63;314;710438;350687;1061125
2022.07_16-08-2022;Пензенская область;75_90_days;EpiVacCorona;736;835;1571;710438;350687;1061125
2022.07_16-08-2022;Пензенская область;75_90_days;SputnikLite;185;182;367;710438;350687;1061125
2022.07_16-08-2022;Пензенская область;75_90_days;SputnikV;8468;11051;19519;710438;350687;1061125
2022.07_16-08-2022;Пензенская область;90_105_days;AllVaccines;10453;21673;32126;710438;350687;1061125
2022.07_16-08-2022;Пензенская область;90_105_days;CoviVac;210;144;354;710438;350687;1061125
2022.07_16-08-2022;Пензенская область;90_105_days;EpiVacCorona;618;1305;1923;710438;350687;1061125
2022.07_16-08-2022;Пензенская область;90_105_days;SputnikLite;475;241;716;710438;350687;1061125
2022.07_16-08-2022;Пензенская область;90_105_days;SputnikV;9150;19983;29133;710438;350687;1061125
2022.07_16-08-2022;Пермский край;105_165_days;AllVaccines;51463;26407;77870;1423011;574038;1997049
2022.07_16-08-2022;Пермский край;105_165_days;CoviVac;1110;206;1316;1423011;574038;1997049
2022.07_16-08-2022;Пермский край;105_165_days;EpiVacCorona;1424;828;2252;1423011;574038;1997049
2022.07_16-08-2022;Пермский край;105_165_days;SputnikLite;22079;11603;33682;1423011;574038;1997049
2022.07_16-08-2022;Пермский край;105_165_days;SputnikV;26850;13770;40620;1423011;574038;1997049
2022.07_16-08-2022;Пермский край;165_195_days;AllVaccines;53850;29285;83135;1423011;574038;1997049
2022.07_16-08-2022;Пермский край;165_195_days;CoviVac;923;193;1116;1423011;574038;1997049
2022.07_16-08-2022;Пермский край;165_195_days;EpiVacCorona;934;370;1304;1423011;574038;1997049
2022.07_16-08-2022;Пермский край;165_195_days;SputnikLite;32966;22183;55149;1423011;574038;1997049
2022.07_16-08-2022;Пермский край;165_195_days;SputnikV;19027;6539;25566;1423011;574038;1997049
2022.07_16-08-2022;Пермский край;21_45_days;AllVaccines;4027;3754;7781;1423011;574038;1997049
2022.07_16-08-2022;Пермский край;21_45_days;CoviVac;12;11;23;1423011;574038;1997049
2022.07_16-08-2022;Пермский край;21_45_days;EpiVacCorona;556;358;914;1423011;574038;1997049
2022.07_16-08-2022;Пермский край;21_45_days;SputnikLite;201;87;288;1423011;574038;1997049
2022.07_16-08-2022;Пермский край;21_45_days;SputnikV;3258;3298;6556;1423011;574038;1997049
2022.07_16-08-2022;Пермский край;45_75_days;AllVaccines;4407;4320;8727;1423011;574038;1997049
2022.07_16-08-2022;Пермский край;45_75_days;CoviVac;126;88;214;1423011;574038;1997049
2022.07_16-08-2022;Пермский край;45_75_days;EpiVacCorona;317;399;716;1423011;574038;1997049
2022.07_16-08-2022;Пермский край;45_75_days;SputnikLite;751;374;1125;1423011;574038;1997049
2022.07_16-08-2022;Пермский край;45_75_days;SputnikV;3213;3459;6672;1423011;574038;1997049
2022.07_16-08-2022;Пермский край;75_90_days;AllVaccines;2954;2623;5577;1423011;574038;1997049
2022.07_16-08-2022;Пермский край;75_90_days;CoviVac;150;81;231;1423011;574038;1997049
2022.07_16-08-2022;Пермский край;75_90_days;EpiVacCorona;121;137;258;1423011;574038;1997049
2022.07_16-08-2022;Пермский край;75_90_days;SputnikLite;524;268;792;1423011;574038;1997049
2022.07_16-08-2022;Пермский край;75_90_days;SputnikV;2159;2137;4296;1423011;574038;1997049
2022.07_16-08-2022;Пермский край;90_105_days;AllVaccines;4025;3325;7350;1423011;574038;1997049
2022.07_16-08-2022;Пермский край;90_105_days;CoviVac;133;70;203;1423011;574038;1997049
2022.07_16-08-2022;Пермский край;90_105_days;EpiVacCorona;221;171;392;1423011;574038;1997049
2022.07_16-08-2022;Пермский край;90_105_days;SputnikLite;659;337;996;1423011;574038;1997049
2022.07_16-08-2022;Пермский край;90_105_days;SputnikV;3012;2747;5759;1423011;574038;1997049
2022.07_16-08-2022;Приморский край;105_165_days;AllVaccines;50576;21803;72379;1086430;416518;1502948
2022.07_16-08-2022;Приморский край;105_165_days;CoviVac;615;55;670;1086430;416518;1502948
2022.07_16-08-2022;Приморский край;105_165_days;EpiVacCorona;3354;1649;5003;1086430;416518;1502948
2022.07_16-08-2022;Приморский край;105_165_days;SputnikLite;27897;13869;41766;1086430;416518;1502948
2022.07_16-08-2022;Приморский край;105_165_days;SputnikV;18710;6230;24940;1086430;416518;1502948
2022.07_16-08-2022;Приморский край;165_195_days;AllVaccines;43459;23760;67219;1086430;416518;1502948
2022.07_16-08-2022;Приморский край;165_195_days;CoviVac;300;33;333;1086430;416518;1502948
2022.07_16-08-2022;Приморский край;165_195_days;EpiVacCorona;1127;630;1757;1086430;416518;1502948
2022.07_16-08-2022;Приморский край;165_195_days;SputnikLite;23186;17291;40477;1086430;416518;1502948
2022.07_16-08-2022;Приморский край;165_195_days;SputnikV;18846;5806;24652;1086430;416518;1502948
2022.07_16-08-2022;Приморский край;21_45_days;AllVaccines;5362;3403;8765;1086430;416518;1502948
2022.07_16-08-2022;Приморский край;21_45_days;CoviVac;253;74;327;1086430;416518;1502948
2022.07_16-08-2022;Приморский край;21_45_days;EpiVacCorona;1415;1024;2439;1086430;416518;1502948
2022.07_16-08-2022;Приморский край;21_45_days;SputnikLite;1404;902;2306;1086430;416518;1502948
2022.07_16-08-2022;Приморский край;21_45_days;SputnikV;2290;1403;3693;1086430;416518;1502948
2022.07_16-08-2022;Приморский край;45_75_days;AllVaccines;6703;4511;11214;1086430;416518;1502948
2022.07_16-08-2022;Приморский край;45_75_days;CoviVac;257;50;307;1086430;416518;1502948
2022.07_16-08-2022;Приморский край;45_75_days;EpiVacCorona;482;492;974;1086430;416518;1502948
2022.07_16-08-2022;Приморский край;45_75_days;SputnikLite;3046;2159;5205;1086430;416518;1502948
2022.07_16-08-2022;Приморский край;45_75_days;SputnikV;2918;1810;4728;1086430;416518;1502948
2022.07_16-08-2022;Приморский край;75_90_days;AllVaccines;3438;2027;5465;1086430;416518;1502948
2022.07_16-08-2022;Приморский край;75_90_days;CoviVac;290;56;346;1086430;416518;1502948
2022.07_16-08-2022;Приморский край;75_90_days;EpiVacCorona;345;335;680;1086430;416518;1502948
2022.07_16-08-2022;Приморский край;75_90_days;SputnikLite;1499;850;2349;1086430;416518;1502948
2022.07_16-08-2022;Приморский край;75_90_days;SputnikV;1304;786;2090;1086430;416518;1502948
2022.07_16-08-2022;Приморский край;90_105_days;AllVaccines;4121;1983;6104;1086430;416518;1502948
2022.07_16-08-2022;Приморский край;90_105_days;CoviVac;150;16;166;1086430;416518;1502948
2022.07_16-08-2022;Приморский край;90_105_days;EpiVacCorona;310;217;527;1086430;416518;1502948
2022.07_16-08-2022;Приморский край;90_105_days;SputnikLite;2512;1334;3846;1086430;416518;1502948
2022.07_16-08-2022;Приморский край;90_105_days;SputnikV;1149;416;1565;1086430;416518;1502948
2022.07_16-08-2022;Псковская область;105_165_days;AllVaccines;14965;7629;22594;337881;166663;504544
2022.07_16-08-2022;Псковская область;105_165_days;CoviVac;371;36;407;337881;166663;504544
2022.07_16-08-2022;Псковская область;105_165_days;EpiVacCorona;859;519;1378;337881;166663;504544
2022.07_16-08-2022;Псковская область;105_165_days;SputnikLite;3785;1971;5756;337881;166663;504544
2022.07_16-08-2022;Псковская область;105_165_days;SputnikV;9950;5103;15053;337881;166663;504544
2022.07_16-08-2022;Псковская область;165_195_days;AllVaccines;13113;7318;20431;337881;166663;504544
2022.07_16-08-2022;Псковская область;165_195_days;CoviVac;344;34;378;337881;166663;504544
2022.07_16-08-2022;Псковская область;165_195_days;EpiVacCorona;471;292;763;337881;166663;504544
2022.07_16-08-2022;Псковская область;165_195_days;SputnikLite;7148;5182;12330;337881;166663;504544
2022.07_16-08-2022;Псковская область;165_195_days;SputnikV;5150;1810;6960;337881;166663;504544
2022.07_16-08-2022;Псковская область;21_45_days;AllVaccines;1197;924;2121;337881;166663;504544
2022.07_16-08-2022;Псковская область;21_45_days;CoviVac;32;7;39;337881;166663;504544
2022.07_16-08-2022;Псковская область;21_45_days;EpiVacCorona;165;48;213;337881;166663;504544
2022.07_16-08-2022;Псковская область;21_45_days;SputnikLite;177;12;189;337881;166663;504544
2022.07_16-08-2022;Псковская область;21_45_days;SputnikV;823;857;1680;337881;166663;504544
2022.07_16-08-2022;Псковская область;45_75_days;AllVaccines;1558;2768;4326;337881;166663;504544
2022.07_16-08-2022;Псковская область;45_75_days;CoviVac;72;35;107;337881;166663;504544
2022.07_16-08-2022;Псковская область;45_75_days;EpiVacCorona;156;105;261;337881;166663;504544
2022.07_16-08-2022;Псковская область;45_75_days;SputnikLite;131;20;151;337881;166663;504544
2022.07_16-08-2022;Псковская область;45_75_days;SputnikV;1199;2608;3807;337881;166663;504544
2022.07_16-08-2022;Псковская область;75_90_days;AllVaccines;872;709;1581;337881;166663;504544
2022.07_16-08-2022;Псковская область;75_90_days;CoviVac;37;15;52;337881;166663;504544
2022.07_16-08-2022;Псковская область;75_90_days;EpiVacCorona;65;46;111;337881;166663;504544
2022.07_16-08-2022;Псковская область;75_90_days;SputnikLite;31;10;41;337881;166663;504544
2022.07_16-08-2022;Псковская область;75_90_days;SputnikV;739;638;1377;337881;166663;504544
2022.07_16-08-2022;Псковская область;90_105_days;AllVaccines;1077;943;2020;337881;166663;504544
2022.07_16-08-2022;Псковская область;90_105_days;CoviVac;22;3;25;337881;166663;504544
2022.07_16-08-2022;Псковская область;90_105_days;EpiVacCorona;113;57;170;337881;166663;504544
2022.07_16-08-2022;Псковская область;90_105_days;SputnikLite;52;9;61;337881;166663;504544
2022.07_16-08-2022;Псковская область;90_105_days;SputnikV;890;874;1764;337881;166663;504544
2022.07_16-08-2022;РФ;105_165_days;AllVaccines;4201111;1908526;6109637;82332898;33454776;115787674
2022.07_16-08-2022;РФ;105_165_days;CoviVac;75387;19745;95132;82332898;33454776;115787674
2022.07_16-08-2022;РФ;105_165_days;EpiVacCorona;208374;121514;329888;82332898;33454776;115787674
2022.07_16-08-2022;РФ;105_165_days;SputnikLite;1652600;672291;2324891;82332898;33454776;115787674
2022.07_16-08-2022;РФ;105_165_days;SputnikV;2264750;1094976;3359726;82332898;33454776;115787674
2022.07_16-08-2022;РФ;165_195_days;AllVaccines;3398455;1592719;4991174;82332898;33454776;115787674
2022.07_16-08-2022;РФ;165_195_days;CoviVac;33315;8344;41659;82332898;33454776;115787674
2022.07_16-08-2022;РФ;165_195_days;EpiVacCorona;106182;58386;164568;82332898;33454776;115787674
2022.07_16-08-2022;РФ;165_195_days;SputnikLite;2103506;1064175;3167681;82332898;33454776;115787674
2022.07_16-08-2022;РФ;165_195_days;SputnikV;1155452;461814;1617266;82332898;33454776;115787674
2022.07_16-08-2022;РФ;21_45_days;AllVaccines;626926;415418;1042344;82332898;33454776;115787674
2022.07_16-08-2022;РФ;21_45_days;CoviVac;19808;7985;27793;82332898;33454776;115787674
2022.07_16-08-2022;РФ;21_45_days;EpiVacCorona;63683;46510;110193;82332898;33454776;115787674
2022.07_16-08-2022;РФ;21_45_days;SputnikLite;57933;25959;83892;82332898;33454776;115787674
2022.07_16-08-2022;РФ;21_45_days;SputnikV;485502;334964;820466;82332898;33454776;115787674
2022.07_16-08-2022;РФ;45_75_days;AllVaccines;607048;402000;1009048;82332898;33454776;115787674
2022.07_16-08-2022;РФ;45_75_days;CoviVac;29557;10879;40436;82332898;33454776;115787674
2022.07_16-08-2022;РФ;45_75_days;EpiVacCorona;40636;30197;70833;82332898;33454776;115787674
2022.07_16-08-2022;РФ;45_75_days;SputnikLite;92172;49738;141910;82332898;33454776;115787674
2022.07_16-08-2022;РФ;45_75_days;SputnikV;444683;311186;755869;82332898;33454776;115787674
2022.07_16-08-2022;РФ;75_90_days;AllVaccines;361823;227730;589553;82332898;33454776;115787674
2022.07_16-08-2022;РФ;75_90_days;CoviVac;20636;7801;28437;82332898;33454776;115787674
2022.07_16-08-2022;РФ;75_90_days;EpiVacCorona;24520;17693;42213;82332898;33454776;115787674
2022.07_16-08-2022;РФ;75_90_days;SputnikLite;68665;33212;101877;82332898;33454776;115787674
2022.07_16-08-2022;РФ;75_90_days;SputnikV;248002;169024;417026;82332898;33454776;115787674
2022.07_16-08-2022;РФ;90_105_days;AllVaccines;396253;256327;652580;82332898;33454776;115787674
2022.07_16-08-2022;РФ;90_105_days;CoviVac;16267;4934;21201;82332898;33454776;115787674
2022.07_16-08-2022;РФ;90_105_days;EpiVacCorona;35659;22911;58570;82332898;33454776;115787674
2022.07_16-08-2022;РФ;90_105_days;SputnikLite;86049;45244;131293;82332898;33454776;115787674
2022.07_16-08-2022;РФ;90_105_days;SputnikV;258278;183238;441516;82332898;33454776;115787674
2022.07_16-08-2022;Республика Адыгея;105_165_days;AllVaccines;9270;4755;14025;256368;104563;360931
2022.07_16-08-2022;Республика Адыгея;105_165_days;CoviVac;64;15;79;256368;104563;360931
2022.07_16-08-2022;Республика Адыгея;105_165_days;EpiVacCorona;129;70;199;256368;104563;360931
2022.07_16-08-2022;Республика Адыгея;105_165_days;SputnikLite;5135;2452;7587;256368;104563;360931
2022.07_16-08-2022;Республика Адыгея;105_165_days;SputnikV;3942;2218;6160;256368;104563;360931
2022.07_16-08-2022;Республика Адыгея;165_195_days;AllVaccines;9057;4360;13417;256368;104563;360931
2022.07_16-08-2022;Республика Адыгея;165_195_days;CoviVac;61;11;72;256368;104563;360931
2022.07_16-08-2022;Республика Адыгея;165_195_days;EpiVacCorona;376;136;512;256368;104563;360931
2022.07_16-08-2022;Республика Адыгея;165_195_days;SputnikLite;6598;3436;10034;256368;104563;360931
2022.07_16-08-2022;Республика Адыгея;165_195_days;SputnikV;2022;777;2799;256368;104563;360931
2022.07_16-08-2022;Республика Адыгея;21_45_days;AllVaccines;811;748;1559;256368;104563;360931
2022.07_16-08-2022;Республика Адыгея;21_45_days;EpiVacCorona;65;127;192;256368;104563;360931
2022.07_16-08-2022;Республика Адыгея;21_45_days;SputnikLite;179;107;286;256368;104563;360931
2022.07_16-08-2022;Республика Адыгея;21_45_days;SputnikV;567;514;1081;256368;104563;360931
2022.07_16-08-2022;Республика Адыгея;45_75_days;AllVaccines;564;617;1181;256368;104563;360931
2022.07_16-08-2022;Республика Адыгея;45_75_days;CoviVac;5;0;5;256368;104563;360931
2022.07_16-08-2022;Республика Адыгея;45_75_days;EpiVacCorona;12;10;22;256368;104563;360931
2022.07_16-08-2022;Республика Адыгея;45_75_days;SputnikLite;296;234;530;256368;104563;360931
2022.07_16-08-2022;Республика Адыгея;45_75_days;SputnikV;251;373;624;256368;104563;360931
2022.07_16-08-2022;Республика Адыгея;75_90_days;AllVaccines;650;423;1073;256368;104563;360931
2022.07_16-08-2022;Республика Адыгея;75_90_days;EpiVacCorona;4;2;6;256368;104563;360931
2022.07_16-08-2022;Республика Адыгея;75_90_days;SputnikLite;328;205;533;256368;104563;360931
2022.07_16-08-2022;Республика Адыгея;75_90_days;SputnikV;318;216;534;256368;104563;360931
2022.07_16-08-2022;Республика Адыгея;90_105_days;AllVaccines;631;481;1112;256368;104563;360931
2022.07_16-08-2022;Республика Адыгея;90_105_days;CoviVac;3;0;3;256368;104563;360931
2022.07_16-08-2022;Республика Адыгея;90_105_days;EpiVacCorona;0;2;2;256368;104563;360931
2022.07_16-08-2022;Республика Адыгея;90_105_days;SputnikLite;469;302;771;256368;104563;360931
2022.07_16-08-2022;Республика Адыгея;90_105_days;SputnikV;159;177;336;256368;104563;360931
2022.07_16-08-2022;Республика Алтай;105_165_days;AllVaccines;8394;2792;11186;117210;36468;153678
2022.07_16-08-2022;Республика Алтай;105_165_days;CoviVac;331;60;391;117210;36468;153678
2022.07_16-08-2022;Республика Алтай;105_165_days;EpiVacCorona;472;117;589;117210;36468;153678
2022.07_16-08-2022;Республика Алтай;105_165_days;SputnikLite;3754;920;4674;117210;36468;153678
2022.07_16-08-2022;Республика Алтай;105_165_days;SputnikV;3837;1695;5532;117210;36468;153678
2022.07_16-08-2022;Республика Алтай;165_195_days;AllVaccines;7791;2451;10242;117210;36468;153678
2022.07_16-08-2022;Республика Алтай;165_195_days;CoviVac;81;22;103;117210;36468;153678
2022.07_16-08-2022;Республика Алтай;165_195_days;EpiVacCorona;210;71;281;117210;36468;153678
2022.07_16-08-2022;Республика Алтай;165_195_days;SputnikLite;5899;1863;7762;117210;36468;153678
2022.07_16-08-2022;Республика Алтай;165_195_days;SputnikV;1601;495;2096;117210;36468;153678
2022.07_16-08-2022;Республика Алтай;21_45_days;AllVaccines;939;630;1569;117210;36468;153678
2022.07_16-08-2022;Республика Алтай;21_45_days;CoviVac;4;2;6;117210;36468;153678
2022.07_16-08-2022;Республика Алтай;21_45_days;EpiVacCorona;79;42;121;117210;36468;153678
2022.07_16-08-2022;Республика Алтай;21_45_days;SputnikLite;210;19;229;117210;36468;153678
2022.07_16-08-2022;Республика Алтай;21_45_days;SputnikV;646;567;1213;117210;36468;153678
2022.07_16-08-2022;Республика Алтай;45_75_days;AllVaccines;835;663;1498;117210;36468;153678
2022.07_16-08-2022;Республика Алтай;45_75_days;CoviVac;57;36;93;117210;36468;153678
2022.07_16-08-2022;Республика Алтай;45_75_days;EpiVacCorona;58;42;100;117210;36468;153678
2022.07_16-08-2022;Республика Алтай;45_75_days;SputnikLite;176;70;246;117210;36468;153678
2022.07_16-08-2022;Республика Алтай;45_75_days;SputnikV;544;515;1059;117210;36468;153678
2022.07_16-08-2022;Республика Алтай;75_90_days;AllVaccines;752;567;1319;117210;36468;153678
2022.07_16-08-2022;Республика Алтай;75_90_days;CoviVac;123;88;211;117210;36468;153678
2022.07_16-08-2022;Республика Алтай;75_90_days;EpiVacCorona;55;37;92;117210;36468;153678
2022.07_16-08-2022;Республика Алтай;75_90_days;SputnikLite;152;86;238;117210;36468;153678
2022.07_16-08-2022;Республика Алтай;75_90_days;SputnikV;422;356;778;117210;36468;153678
2022.07_16-08-2022;Республика Алтай;90_105_days;AllVaccines;1028;510;1538;117210;36468;153678
2022.07_16-08-2022;Республика Алтай;90_105_days;CoviVac;93;42;135;117210;36468;153678
2022.07_16-08-2022;Республика Алтай;90_105_days;EpiVacCorona;230;47;277;117210;36468;153678
2022.07_16-08-2022;Республика Алтай;90_105_days;SputnikLite;193;99;292;117210;36468;153678
2022.07_16-08-2022;Республика Алтай;90_105_days;SputnikV;512;322;834;117210;36468;153678
2022.07_16-08-2022;Республика Башкортостан;105_165_days;AllVaccines;138835;70480;209315;2235962;869874;3105836
2022.07_16-08-2022;Республика Башкортостан;105_165_days;CoviVac;1646;499;2145;2235962;869874;3105836
2022.07_16-08-2022;Республика Башкортостан;105_165_days;EpiVacCorona;9773;7192;16965;2235962;869874;3105836
2022.07_16-08-2022;Республика Башкортостан;105_165_days;SputnikLite;42858;14116;56974;2235962;869874;3105836
2022.07_16-08-2022;Республика Башкортостан;105_165_days;SputnikV;84558;48673;133231;2235962;869874;3105836
2022.07_16-08-2022;Республика Башкортостан;165_195_days;AllVaccines;102185;39114;141299;2235962;869874;3105836
2022.07_16-08-2022;Республика Башкортостан;165_195_days;CoviVac;1799;339;2138;2235962;869874;3105836
2022.07_16-08-2022;Республика Башкортостан;165_195_days;EpiVacCorona;5752;3524;9276;2235962;869874;3105836
2022.07_16-08-2022;Республика Башкортостан;165_195_days;SputnikLite;55497;22036;77533;2235962;869874;3105836
2022.07_16-08-2022;Республика Башкортостан;165_195_days;SputnikV;39137;13215;52352;2235962;869874;3105836
2022.07_16-08-2022;Республика Башкортостан;21_45_days;AllVaccines;80444;58266;138710;2235962;869874;3105836
2022.07_16-08-2022;Республика Башкортостан;21_45_days;CoviVac;1476;794;2270;2235962;869874;3105836
2022.07_16-08-2022;Республика Башкортостан;21_45_days;EpiVacCorona;6235;6345;12580;2235962;869874;3105836
2022.07_16-08-2022;Республика Башкортостан;21_45_days;SputnikLite;2873;428;3301;2235962;869874;3105836
2022.07_16-08-2022;Республика Башкортостан;21_45_days;SputnikV;69860;50699;120559;2235962;869874;3105836
2022.07_16-08-2022;Республика Башкортостан;45_75_days;AllVaccines;39743;29274;69017;2235962;869874;3105836
2022.07_16-08-2022;Республика Башкортостан;45_75_days;CoviVac;4208;1537;5745;2235962;869874;3105836
2022.07_16-08-2022;Республика Башкортостан;45_75_days;EpiVacCorona;2638;1843;4481;2235962;869874;3105836
2022.07_16-08-2022;Республика Башкортостан;45_75_days;SputnikLite;5347;1234;6581;2235962;869874;3105836
2022.07_16-08-2022;Республика Башкортостан;45_75_days;SputnikV;27550;24660;52210;2235962;869874;3105836
2022.07_16-08-2022;Республика Башкортостан;75_90_days;AllVaccines;17578;11459;29037;2235962;869874;3105836
2022.07_16-08-2022;Республика Башкортостан;75_90_days;CoviVac;2802;1638;4440;2235962;869874;3105836
2022.07_16-08-2022;Республика Башкортостан;75_90_days;EpiVacCorona;1268;1044;2312;2235962;869874;3105836
2022.07_16-08-2022;Республика Башкортостан;75_90_days;SputnikLite;2951;669;3620;2235962;869874;3105836
2022.07_16-08-2022;Республика Башкортостан;75_90_days;SputnikV;10557;8108;18665;2235962;869874;3105836
2022.07_16-08-2022;Республика Башкортостан;90_105_days;AllVaccines;15336;9359;24695;2235962;869874;3105836
2022.07_16-08-2022;Республика Башкортостан;90_105_days;CoviVac;1238;630;1868;2235962;869874;3105836
2022.07_16-08-2022;Республика Башкортостан;90_105_days;EpiVacCorona;1867;1505;3372;2235962;869874;3105836
2022.07_16-08-2022;Республика Башкортостан;90_105_days;SputnikLite;4046;1167;5213;2235962;869874;3105836
2022.07_16-08-2022;Республика Башкортостан;90_105_days;SputnikV;8185;6057;14242;2235962;869874;3105836
2022.07_16-08-2022;Республика Бурятия;105_165_days;AllVaccines;42132;16455;58587;542372;176777;719149
2022.07_16-08-2022;Республика Бурятия;105_165_days;CoviVac;536;198;734;542372;176777;719149
2022.07_16-08-2022;Республика Бурятия;105_165_days;EpiVacCorona;1979;957;2936;542372;176777;719149
2022.07_16-08-2022;Республика Бурятия;105_165_days;SputnikLite;14667;4986;19653;542372;176777;719149
2022.07_16-08-2022;Республика Бурятия;105_165_days;SputnikV;24950;10314;35264;542372;176777;719149
2022.07_16-08-2022;Республика Бурятия;165_195_days;AllVaccines;28512;11076;39588;542372;176777;719149
2022.07_16-08-2022;Республика Бурятия;165_195_days;CoviVac;213;67;280;542372;176777;719149
2022.07_16-08-2022;Республика Бурятия;165_195_days;EpiVacCorona;938;536;1474;542372;176777;719149
2022.07_16-08-2022;Республика Бурятия;165_195_days;SputnikLite;17381;7172;24553;542372;176777;719149
2022.07_16-08-2022;Республика Бурятия;165_195_days;SputnikV;9980;3301;13281;542372;176777;719149
2022.07_16-08-2022;Республика Бурятия;21_45_days;AllVaccines;4106;2599;6705;542372;176777;719149
2022.07_16-08-2022;Республика Бурятия;21_45_days;CoviVac;297;140;437;542372;176777;719149
2022.07_16-08-2022;Республика Бурятия;21_45_days;EpiVacCorona;741;291;1032;542372;176777;719149
2022.07_16-08-2022;Республика Бурятия;21_45_days;SputnikLite;75;13;88;542372;176777;719149
2022.07_16-08-2022;Республика Бурятия;21_45_days;SputnikV;2993;2155;5148;542372;176777;719149
2022.07_16-08-2022;Республика Бурятия;45_75_days;AllVaccines;3805;2269;6074;542372;176777;719149
2022.07_16-08-2022;Республика Бурятия;45_75_days;CoviVac;383;171;554;542372;176777;719149
2022.07_16-08-2022;Республика Бурятия;45_75_days;EpiVacCorona;466;247;713;542372;176777;719149
2022.07_16-08-2022;Республика Бурятия;45_75_days;SputnikLite;169;39;208;542372;176777;719149
2022.07_16-08-2022;Республика Бурятия;45_75_days;SputnikV;2787;1812;4599;542372;176777;719149
2022.07_16-08-2022;Республика Бурятия;75_90_days;AllVaccines;2907;1290;4197;542372;176777;719149
2022.07_16-08-2022;Республика Бурятия;75_90_days;CoviVac;278;77;355;542372;176777;719149
2022.07_16-08-2022;Республика Бурятия;75_90_days;EpiVacCorona;455;238;693;542372;176777;719149
2022.07_16-08-2022;Республика Бурятия;75_90_days;SputnikLite;171;42;213;542372;176777;719149
2022.07_16-08-2022;Республика Бурятия;75_90_days;SputnikV;2003;933;2936;542372;176777;719149
2022.07_16-08-2022;Республика Бурятия;90_105_days;AllVaccines;3302;1595;4897;542372;176777;719149
2022.07_16-08-2022;Республика Бурятия;90_105_days;CoviVac;275;117;392;542372;176777;719149
2022.07_16-08-2022;Республика Бурятия;90_105_days;EpiVacCorona;630;469;1099;542372;176777;719149
2022.07_16-08-2022;Республика Бурятия;90_105_days;SputnikLite;366;139;505;542372;176777;719149
2022.07_16-08-2022;Республика Бурятия;90_105_days;SputnikV;2031;870;2901;542372;176777;719149
2022.07_16-08-2022;Республика Дагестан;105_165_days;AllVaccines;269150;74655;343805;1856109;394621;2250730
2022.07_16-08-2022;Республика Дагестан;105_165_days;CoviVac;7108;2044;9152;1856109;394621;2250730
2022.07_16-08-2022;Республика Дагестан;105_165_days;EpiVacCorona;26385;7181;33566;1856109;394621;2250730
2022.07_16-08-2022;Республика Дагестан;105_165_days;SputnikLite;19945;4400;24345;1856109;394621;2250730
2022.07_16-08-2022;Республика Дагестан;105_165_days;SputnikV;215712;61030;276742;1856109;394621;2250730
2022.07_16-08-2022;Республика Дагестан;165_195_days;AllVaccines;82365;21934;104299;1856109;394621;2250730
2022.07_16-08-2022;Республика Дагестан;165_195_days;CoviVac;1146;219;1365;1856109;394621;2250730
2022.07_16-08-2022;Республика Дагестан;165_195_days;EpiVacCorona;10985;2120;13105;1856109;394621;2250730
2022.07_16-08-2022;Республика Дагестан;165_195_days;SputnikLite;18416;4771;23187;1856109;394621;2250730
2022.07_16-08-2022;Республика Дагестан;165_195_days;SputnikV;51818;14824;66642;1856109;394621;2250730
2022.07_16-08-2022;Республика Дагестан;21_45_days;AllVaccines;33409;9001;42410;1856109;394621;2250730
2022.07_16-08-2022;Республика Дагестан;21_45_days;CoviVac;201;59;260;1856109;394621;2250730
2022.07_16-08-2022;Республика Дагестан;21_45_days;EpiVacCorona;226;144;370;1856109;394621;2250730
2022.07_16-08-2022;Республика Дагестан;21_45_days;SputnikLite;138;10;148;1856109;394621;2250730
2022.07_16-08-2022;Республика Дагестан;21_45_days;SputnikV;32844;8788;41632;1856109;394621;2250730
2022.07_16-08-2022;Республика Дагестан;45_75_days;AllVaccines;75037;23845;98882;1856109;394621;2250730
2022.07_16-08-2022;Республика Дагестан;45_75_days;CoviVac;316;75;391;1856109;394621;2250730
2022.07_16-08-2022;Республика Дагестан;45_75_days;EpiVacCorona;925;214;1139;1856109;394621;2250730
2022.07_16-08-2022;Республика Дагестан;45_75_days;SputnikLite;639;106;745;1856109;394621;2250730
2022.07_16-08-2022;Республика Дагестан;45_75_days;SputnikV;73157;23450;96607;1856109;394621;2250730
2022.07_16-08-2022;Республика Дагестан;75_90_days;AllVaccines;30659;7187;37846;1856109;394621;2250730
2022.07_16-08-2022;Республика Дагестан;75_90_days;CoviVac;935;286;1221;1856109;394621;2250730
2022.07_16-08-2022;Республика Дагестан;75_90_days;EpiVacCorona;836;172;1008;1856109;394621;2250730
2022.07_16-08-2022;Республика Дагестан;75_90_days;SputnikLite;174;14;188;1856109;394621;2250730
2022.07_16-08-2022;Республика Дагестан;75_90_days;SputnikV;28714;6715;35429;1856109;394621;2250730
2022.07_16-08-2022;Республика Дагестан;90_105_days;AllVaccines;27228;10591;37819;1856109;394621;2250730
2022.07_16-08-2022;Республика Дагестан;90_105_days;CoviVac;1736;509;2245;1856109;394621;2250730
2022.07_16-08-2022;Республика Дагестан;90_105_days;EpiVacCorona;3550;2339;5889;1856109;394621;2250730
2022.07_16-08-2022;Республика Дагестан;90_105_days;SputnikLite;153;19;172;1856109;394621;2250730
2022.07_16-08-2022;Республика Дагестан;90_105_days;SputnikV;21789;7724;29513;1856109;394621;2250730
2022.07_16-08-2022;Республика Ингушетия;105_165_days;AllVaccines;26088;4192;30280;295583;61477;357060
2022.07_16-08-2022;Республика Ингушетия;105_165_days;CoviVac;110;9;119;295583;61477;357060
2022.07_16-08-2022;Республика Ингушетия;105_165_days;EpiVacCorona;5352;1032;6384;295583;61477;357060
2022.07_16-08-2022;Республика Ингушетия;105_165_days;SputnikLite;9347;1341;10688;295583;61477;357060
2022.07_16-08-2022;Республика Ингушетия;105_165_days;SputnikV;11279;1810;13089;295583;61477;357060
2022.07_16-08-2022;Республика Ингушетия;165_195_days;AllVaccines;22992;4163;27155;295583;61477;357060
2022.07_16-08-2022;Республика Ингушетия;165_195_days;CoviVac;42;29;71;295583;61477;357060
2022.07_16-08-2022;Республика Ингушетия;165_195_days;EpiVacCorona;15;2;17;295583;61477;357060
2022.07_16-08-2022;Республика Ингушетия;165_195_days;SputnikLite;13821;2331;16152;295583;61477;357060
2022.07_16-08-2022;Республика Ингушетия;165_195_days;SputnikV;9114;1801;10915;295583;61477;357060
2022.07_16-08-2022;Республика Ингушетия;21_45_days;AllVaccines;4755;758;5513;295583;61477;357060
2022.07_16-08-2022;Республика Ингушетия;21_45_days;CoviVac;400;45;445;295583;61477;357060
2022.07_16-08-2022;Республика Ингушетия;21_45_days;EpiVacCorona;31;7;38;295583;61477;357060
2022.07_16-08-2022;Республика Ингушетия;21_45_days;SputnikV;4324;706;5030;295583;61477;357060
2022.07_16-08-2022;Республика Ингушетия;45_75_days;AllVaccines;10309;1416;11725;295583;61477;357060
2022.07_16-08-2022;Республика Ингушетия;45_75_days;CoviVac;757;91;848;295583;61477;357060
2022.07_16-08-2022;Республика Ингушетия;45_75_days;EpiVacCorona;247;42;289;295583;61477;357060
2022.07_16-08-2022;Республика Ингушетия;45_75_days;SputnikLite;4;0;4;295583;61477;357060
2022.07_16-08-2022;Республика Ингушетия;45_75_days;SputnikV;9301;1283;10584;295583;61477;357060
2022.07_16-08-2022;Республика Ингушетия;75_90_days;AllVaccines;4726;702;5428;295583;61477;357060
2022.07_16-08-2022;Республика Ингушетия;75_90_days;CoviVac;218;34;252;295583;61477;357060
2022.07_16-08-2022;Республика Ингушетия;75_90_days;EpiVacCorona;275;48;323;295583;61477;357060
2022.07_16-08-2022;Республика Ингушетия;75_90_days;SputnikLite;2;0;2;295583;61477;357060
2022.07_16-08-2022;Республика Ингушетия;75_90_days;SputnikV;4231;620;4851;295583;61477;357060
2022.07_16-08-2022;Республика Ингушетия;90_105_days;AllVaccines;6117;967;7084;295583;61477;357060
2022.07_16-08-2022;Республика Ингушетия;90_105_days;CoviVac;165;18;183;295583;61477;357060
2022.07_16-08-2022;Республика Ингушетия;90_105_days;EpiVacCorona;5003;822;5825;295583;61477;357060
2022.07_16-08-2022;Республика Ингушетия;90_105_days;SputnikLite;32;5;37;295583;61477;357060
2022.07_16-08-2022;Республика Ингушетия;90_105_days;SputnikV;917;122;1039;295583;61477;357060
2022.07_16-08-2022;Республика Калмыкия;105_165_days;AllVaccines;5594;2750;8344;150440;54890;205330
2022.07_16-08-2022;Республика Калмыкия;105_165_days;CoviVac;33;15;48;150440;54890;205330
2022.07_16-08-2022;Республика Калмыкия;105_165_days;EpiVacCorona;170;56;226;150440;54890;205330
2022.07_16-08-2022;Республика Калмыкия;105_165_days;SputnikLite;4366;2135;6501;150440;54890;205330
2022.07_16-08-2022;Республика Калмыкия;105_165_days;SputnikV;1025;544;1569;150440;54890;205330
2022.07_16-08-2022;Республика Калмыкия;165_195_days;AllVaccines;6364;2592;8956;150440;54890;205330
2022.07_16-08-2022;Республика Калмыкия;165_195_days;CoviVac;86;27;113;150440;54890;205330
2022.07_16-08-2022;Республика Калмыкия;165_195_days;EpiVacCorona;278;146;424;150440;54890;205330
2022.07_16-08-2022;Республика Калмыкия;165_195_days;SputnikLite;5456;2225;7681;150440;54890;205330
2022.07_16-08-2022;Республика Калмыкия;165_195_days;SputnikV;544;194;738;150440;54890;205330
2022.07_16-08-2022;Республика Калмыкия;21_45_days;AllVaccines;669;522;1191;150440;54890;205330
2022.07_16-08-2022;Республика Калмыкия;21_45_days;CoviVac;4;0;4;150440;54890;205330
2022.07_16-08-2022;Республика Калмыкия;21_45_days;EpiVacCorona;116;52;168;150440;54890;205330
2022.07_16-08-2022;Республика Калмыкия;21_45_days;SputnikLite;180;108;288;150440;54890;205330
2022.07_16-08-2022;Республика Калмыкия;21_45_days;SputnikV;369;362;731;150440;54890;205330
2022.07_16-08-2022;Республика Калмыкия;45_75_days;AllVaccines;1466;1080;2546;150440;54890;205330
2022.07_16-08-2022;Республика Калмыкия;45_75_days;CoviVac;1;4;5;150440;54890;205330
2022.07_16-08-2022;Республика Калмыкия;45_75_days;EpiVacCorona;155;59;214;150440;54890;205330
2022.07_16-08-2022;Республика Калмыкия;45_75_days;SputnikLite;966;730;1696;150440;54890;205330
2022.07_16-08-2022;Республика Калмыкия;45_75_days;SputnikV;344;287;631;150440;54890;205330
2022.07_16-08-2022;Республика Калмыкия;75_90_days;AllVaccines;768;676;1444;150440;54890;205330
2022.07_16-08-2022;Республика Калмыкия;75_90_days;CoviVac;2;0;2;150440;54890;205330
2022.07_16-08-2022;Республика Калмыкия;75_90_days;EpiVacCorona;20;9;29;150440;54890;205330
2022.07_16-08-2022;Республика Калмыкия;75_90_days;SputnikLite;634;556;1190;150440;54890;205330
2022.07_16-08-2022;Республика Калмыкия;75_90_days;SputnikV;112;111;223;150440;54890;205330
2022.07_16-08-2022;Республика Калмыкия;90_105_days;AllVaccines;810;564;1374;150440;54890;205330
2022.07_16-08-2022;Республика Калмыкия;90_105_days;CoviVac;2;0;2;150440;54890;205330
2022.07_16-08-2022;Республика Калмыкия;90_105_days;EpiVacCorona;15;14;29;150440;54890;205330
2022.07_16-08-2022;Республика Калмыкия;90_105_days;SputnikLite;621;460;1081;150440;54890;205330
2022.07_16-08-2022;Республика Калмыкия;90_105_days;SputnikV;172;90;262;150440;54890;205330
2022.07_16-08-2022;Республика Карелия;105_165_days;AllVaccines;19164;11235;30399;334874;149526;484400
2022.07_16-08-2022;Республика Карелия;105_165_days;CoviVac;366;74;440;334874;149526;484400
2022.07_16-08-2022;Республика Карелия;105_165_days;EpiVacCorona;691;468;1159;334874;149526;484400
2022.07_16-08-2022;Республика Карелия;105_165_days;SputnikLite;10021;5505;15526;334874;149526;484400
2022.07_16-08-2022;Республика Карелия;105_165_days;SputnikV;8086;5188;13274;334874;149526;484400
2022.07_16-08-2022;Республика Карелия;165_195_days;AllVaccines;12298;6738;19036;334874;149526;484400
2022.07_16-08-2022;Республика Карелия;165_195_days;CoviVac;322;86;408;334874;149526;484400
2022.07_16-08-2022;Республика Карелия;165_195_days;EpiVacCorona;428;285;713;334874;149526;484400
2022.07_16-08-2022;Республика Карелия;165_195_days;SputnikLite;7911;4581;12492;334874;149526;484400
2022.07_16-08-2022;Республика Карелия;165_195_days;SputnikV;3637;1786;5423;334874;149526;484400
2022.07_16-08-2022;Республика Карелия;21_45_days;AllVaccines;1414;1991;3405;334874;149526;484400
2022.07_16-08-2022;Республика Карелия;21_45_days;EpiVacCorona;178;241;419;334874;149526;484400
2022.07_16-08-2022;Республика Карелия;21_45_days;SputnikLite;129;46;175;334874;149526;484400
2022.07_16-08-2022;Республика Карелия;21_45_days;SputnikV;1107;1704;2811;334874;149526;484400
2022.07_16-08-2022;Республика Карелия;45_75_days;AllVaccines;2234;3037;5271;334874;149526;484400
2022.07_16-08-2022;Республика Карелия;45_75_days;CoviVac;2;1;3;334874;149526;484400
2022.07_16-08-2022;Республика Карелия;45_75_days;EpiVacCorona;85;165;250;334874;149526;484400
2022.07_16-08-2022;Республика Карелия;45_75_days;SputnikLite;975;1048;2023;334874;149526;484400
2022.07_16-08-2022;Республика Карелия;45_75_days;SputnikV;1172;1823;2995;334874;149526;484400
2022.07_16-08-2022;Республика Карелия;75_90_days;AllVaccines;1080;1269;2349;334874;149526;484400
2022.07_16-08-2022;Республика Карелия;75_90_days;CoviVac;10;12;22;334874;149526;484400
2022.07_16-08-2022;Республика Карелия;75_90_days;EpiVacCorona;25;34;59;334874;149526;484400
2022.07_16-08-2022;Республика Карелия;75_90_days;SputnikLite;520;568;1088;334874;149526;484400
2022.07_16-08-2022;Республика Карелия;75_90_days;SputnikV;525;655;1180;334874;149526;484400
2022.07_16-08-2022;Республика Карелия;90_105_days;AllVaccines;1742;1728;3470;334874;149526;484400
2022.07_16-08-2022;Республика Карелия;90_105_days;CoviVac;14;4;18;334874;149526;484400
2022.07_16-08-2022;Республика Карелия;90_105_days;EpiVacCorona;30;39;69;334874;149526;484400
2022.07_16-08-2022;Республика Карелия;90_105_days;SputnikLite;934;944;1878;334874;149526;484400
2022.07_16-08-2022;Республика Карелия;90_105_days;SputnikV;764;741;1505;334874;149526;484400
2022.07_16-08-2022;Республика Коми;105_165_days;AllVaccines;22627;9506;32133;465210;166370;631580
2022.07_16-08-2022;Республика Коми;105_165_days;CoviVac;416;121;537;465210;166370;631580
2022.07_16-08-2022;Республика Коми;105_165_days;EpiVacCorona;692;330;1022;465210;166370;631580
2022.07_16-08-2022;Республика Коми;105_165_days;SputnikLite;10975;3750;14725;465210;166370;631580
2022.07_16-08-2022;Республика Коми;105_165_days;SputnikV;10544;5305;15849;465210;166370;631580
2022.07_16-08-2022;Республика Коми;165_195_days;AllVaccines;18574;8274;26848;465210;166370;631580
2022.07_16-08-2022;Республика Коми;165_195_days;CoviVac;237;57;294;465210;166370;631580
2022.07_16-08-2022;Республика Коми;165_195_days;EpiVacCorona;537;235;772;465210;166370;631580
2022.07_16-08-2022;Республика Коми;165_195_days;SputnikLite;13170;5713;18883;465210;166370;631580
2022.07_16-08-2022;Республика Коми;165_195_days;SputnikV;4630;2269;6899;465210;166370;631580
2022.07_16-08-2022;Республика Коми;21_45_days;AllVaccines;2299;1585;3884;465210;166370;631580
2022.07_16-08-2022;Республика Коми;21_45_days;CoviVac;242;47;289;465210;166370;631580
2022.07_16-08-2022;Республика Коми;21_45_days;EpiVacCorona;207;136;343;465210;166370;631580
2022.07_16-08-2022;Республика Коми;21_45_days;SputnikLite;134;31;165;465210;166370;631580
2022.07_16-08-2022;Республика Коми;21_45_days;SputnikV;1716;1371;3087;465210;166370;631580
2022.07_16-08-2022;Республика Коми;45_75_days;AllVaccines;2403;1693;4096;465210;166370;631580
2022.07_16-08-2022;Республика Коми;45_75_days;CoviVac;73;13;86;465210;166370;631580
2022.07_16-08-2022;Республика Коми;45_75_days;EpiVacCorona;147;86;233;465210;166370;631580
2022.07_16-08-2022;Республика Коми;45_75_days;SputnikLite;316;136;452;465210;166370;631580
2022.07_16-08-2022;Республика Коми;45_75_days;SputnikV;1867;1458;3325;465210;166370;631580
2022.07_16-08-2022;Республика Коми;75_90_days;AllVaccines;1443;768;2211;465210;166370;631580
2022.07_16-08-2022;Республика Коми;75_90_days;CoviVac;179;28;207;465210;166370;631580
2022.07_16-08-2022;Республика Коми;75_90_days;EpiVacCorona;60;56;116;465210;166370;631580
2022.07_16-08-2022;Республика Коми;75_90_days;SputnikLite;210;125;335;465210;166370;631580
2022.07_16-08-2022;Республика Коми;75_90_days;SputnikV;994;559;1553;465210;166370;631580
2022.07_16-08-2022;Республика Коми;90_105_days;AllVaccines;2073;885;2958;465210;166370;631580
2022.07_16-08-2022;Республика Коми;90_105_days;CoviVac;76;32;108;465210;166370;631580
2022.07_16-08-2022;Республика Коми;90_105_days;EpiVacCorona;75;26;101;465210;166370;631580
2022.07_16-08-2022;Республика Коми;90_105_days;SputnikLite;930;331;1261;465210;166370;631580
2022.07_16-08-2022;Республика Коми;90_105_days;SputnikV;992;496;1488;465210;166370;631580
2022.07_16-08-2022;Республика Крым;105_165_days;AllVaccines;41198;19850;61048;1036087;480146;1516233
2022.07_16-08-2022;Республика Крым;105_165_days;CoviVac;843;284;1127;1036087;480146;1516233
2022.07_16-08-2022;Республика Крым;105_165_days;EpiVacCorona;4046;2270;6316;1036087;480146;1516233
2022.07_16-08-2022;Республика Крым;105_165_days;SputnikLite;13721;6976;20697;1036087;480146;1516233
2022.07_16-08-2022;Республика Крым;105_165_days;SputnikV;22588;10320;32908;1036087;480146;1516233
2022.07_16-08-2022;Республика Крым;165_195_days;AllVaccines;53150;29590;82740;1036087;480146;1516233
2022.07_16-08-2022;Республика Крым;165_195_days;CoviVac;278;86;364;1036087;480146;1516233
2022.07_16-08-2022;Республика Крым;165_195_days;EpiVacCorona;1662;1009;2671;1036087;480146;1516233
2022.07_16-08-2022;Республика Крым;165_195_days;SputnikLite;34358;23415;57773;1036087;480146;1516233
2022.07_16-08-2022;Республика Крым;165_195_days;SputnikV;16852;5080;21932;1036087;480146;1516233
2022.07_16-08-2022;Республика Крым;21_45_days;AllVaccines;8232;5426;13658;1036087;480146;1516233
2022.07_16-08-2022;Республика Крым;21_45_days;CoviVac;635;222;857;1036087;480146;1516233
2022.07_16-08-2022;Республика Крым;21_45_days;EpiVacCorona;1443;746;2189;1036087;480146;1516233
2022.07_16-08-2022;Республика Крым;21_45_days;SputnikLite;54;4;58;1036087;480146;1516233
2022.07_16-08-2022;Республика Крым;21_45_days;SputnikV;6100;4454;10554;1036087;480146;1516233
2022.07_16-08-2022;Республика Крым;45_75_days;AllVaccines;5990;3763;9753;1036087;480146;1516233
2022.07_16-08-2022;Республика Крым;45_75_days;CoviVac;599;170;769;1036087;480146;1516233
2022.07_16-08-2022;Республика Крым;45_75_days;EpiVacCorona;447;295;742;1036087;480146;1516233
2022.07_16-08-2022;Республика Крым;45_75_days;SputnikLite;288;76;364;1036087;480146;1516233
2022.07_16-08-2022;Республика Крым;45_75_days;SputnikV;4656;3222;7878;1036087;480146;1516233
2022.07_16-08-2022;Республика Крым;75_90_days;AllVaccines;4953;3194;8147;1036087;480146;1516233
2022.07_16-08-2022;Республика Крым;75_90_days;CoviVac;402;144;546;1036087;480146;1516233
2022.07_16-08-2022;Республика Крым;75_90_days;EpiVacCorona;327;276;603;1036087;480146;1516233
2022.07_16-08-2022;Республика Крым;75_90_days;SputnikLite;106;15;121;1036087;480146;1516233
2022.07_16-08-2022;Республика Крым;75_90_days;SputnikV;4118;2759;6877;1036087;480146;1516233
2022.07_16-08-2022;Республика Крым;90_105_days;AllVaccines;4800;2722;7522;1036087;480146;1516233
2022.07_16-08-2022;Республика Крым;90_105_days;CoviVac;242;97;339;1036087;480146;1516233
2022.07_16-08-2022;Республика Крым;90_105_days;EpiVacCorona;357;235;592;1036087;480146;1516233
2022.07_16-08-2022;Республика Крым;90_105_days;SputnikLite;398;71;469;1036087;480146;1516233
2022.07_16-08-2022;Республика Крым;90_105_days;SputnikV;3803;2319;6122;1036087;480146;1516233
2022.07_16-08-2022;Республика Марий Эл;105_165_days;AllVaccines;13248;11136;24384;370626;156749;527375
2022.07_16-08-2022;Республика Марий Эл;105_165_days;CoviVac;462;257;719;370626;156749;527375
2022.07_16-08-2022;Республика Марий Эл;105_165_days;EpiVacCorona;804;903;1707;370626;156749;527375
2022.07_16-08-2022;Республика Марий Эл;105_165_days;SputnikLite;7115;5434;12549;370626;156749;527375
2022.07_16-08-2022;Республика Марий Эл;105_165_days;SputnikV;4867;4542;9409;370626;156749;527375
2022.07_16-08-2022;Республика Марий Эл;165_195_days;AllVaccines;13816;7927;21743;370626;156749;527375
2022.07_16-08-2022;Республика Марий Эл;165_195_days;CoviVac;108;52;160;370626;156749;527375
2022.07_16-08-2022;Республика Марий Эл;165_195_days;EpiVacCorona;415;257;672;370626;156749;527375
2022.07_16-08-2022;Республика Марий Эл;165_195_days;SputnikLite;9668;6031;15699;370626;156749;527375
2022.07_16-08-2022;Республика Марий Эл;165_195_days;SputnikV;3625;1587;5212;370626;156749;527375
2022.07_16-08-2022;Республика Марий Эл;21_45_days;AllVaccines;2305;847;3152;370626;156749;527375
2022.07_16-08-2022;Республика Марий Эл;21_45_days;EpiVacCorona;122;30;152;370626;156749;527375
2022.07_16-08-2022;Республика Марий Эл;21_45_days;SputnikLite;465;15;480;370626;156749;527375
2022.07_16-08-2022;Республика Марий Эл;21_45_days;SputnikV;1718;802;2520;370626;156749;527375
2022.07_16-08-2022;Республика Марий Эл;45_75_days;AllVaccines;1719;638;2357;370626;156749;527375
2022.07_16-08-2022;Республика Марий Эл;45_75_days;EpiVacCorona;97;19;116;370626;156749;527375
2022.07_16-08-2022;Республика Марий Эл;45_75_days;SputnikLite;470;16;486;370626;156749;527375
2022.07_16-08-2022;Республика Марий Эл;45_75_days;SputnikV;1152;603;1755;370626;156749;527375
2022.07_16-08-2022;Республика Марий Эл;75_90_days;AllVaccines;1344;570;1914;370626;156749;527375
2022.07_16-08-2022;Республика Марий Эл;75_90_days;CoviVac;5;2;7;370626;156749;527375
2022.07_16-08-2022;Республика Марий Эл;75_90_days;EpiVacCorona;64;21;85;370626;156749;527375
2022.07_16-08-2022;Республика Марий Эл;75_90_days;SputnikLite;505;37;542;370626;156749;527375
2022.07_16-08-2022;Республика Марий Эл;75_90_days;SputnikV;770;510;1280;370626;156749;527375
2022.07_16-08-2022;Республика Марий Эл;90_105_days;AllVaccines;1117;547;1664;370626;156749;527375
2022.07_16-08-2022;Республика Марий Эл;90_105_days;CoviVac;9;2;11;370626;156749;527375
2022.07_16-08-2022;Республика Марий Эл;90_105_days;EpiVacCorona;67;26;93;370626;156749;527375
2022.07_16-08-2022;Республика Марий Эл;90_105_days;SputnikLite;383;41;424;370626;156749;527375
2022.07_16-08-2022;Республика Марий Эл;90_105_days;SputnikV;658;478;1136;370626;156749;527375
2022.07_16-08-2022;Республика Мордовия;105_165_days;AllVaccines;41725;21505;63230;448319;198808;647127
2022.07_16-08-2022;Республика Мордовия;105_165_days;CoviVac;732;257;989;448319;198808;647127
2022.07_16-08-2022;Республика Мордовия;105_165_days;EpiVacCorona;3694;2292;5986;448319;198808;647127
2022.07_16-08-2022;Республика Мордовия;105_165_days;SputnikLite;20942;9251;30193;448319;198808;647127
2022.07_16-08-2022;Республика Мордовия;105_165_days;SputnikV;16357;9705;26062;448319;198808;647127
2022.07_16-08-2022;Республика Мордовия;165_195_days;AllVaccines;27833;12493;40326;448319;198808;647127
2022.07_16-08-2022;Республика Мордовия;165_195_days;CoviVac;223;65;288;448319;198808;647127
2022.07_16-08-2022;Республика Мордовия;165_195_days;EpiVacCorona;1364;804;2168;448319;198808;647127
2022.07_16-08-2022;Республика Мордовия;165_195_days;SputnikLite;21109;8532;29641;448319;198808;647127
2022.07_16-08-2022;Республика Мордовия;165_195_days;SputnikV;5137;3092;8229;448319;198808;647127
2022.07_16-08-2022;Республика Мордовия;21_45_days;AllVaccines;10640;8126;18766;448319;198808;647127
2022.07_16-08-2022;Республика Мордовия;21_45_days;CoviVac;2;7;9;448319;198808;647127
2022.07_16-08-2022;Республика Мордовия;21_45_days;EpiVacCorona;3117;2549;5666;448319;198808;647127
2022.07_16-08-2022;Республика Мордовия;21_45_days;SputnikLite;75;54;129;448319;198808;647127
2022.07_16-08-2022;Республика Мордовия;21_45_days;SputnikV;7446;5516;12962;448319;198808;647127
2022.07_16-08-2022;Республика Мордовия;45_75_days;AllVaccines;9196;9393;18589;448319;198808;647127
2022.07_16-08-2022;Республика Мордовия;45_75_days;CoviVac;10;27;37;448319;198808;647127
2022.07_16-08-2022;Республика Мордовия;45_75_days;EpiVacCorona;890;850;1740;448319;198808;647127
2022.07_16-08-2022;Республика Мордовия;45_75_days;SputnikLite;1072;919;1991;448319;198808;647127
2022.07_16-08-2022;Республика Мордовия;45_75_days;SputnikV;7224;7597;14821;448319;198808;647127
2022.07_16-08-2022;Республика Мордовия;75_90_days;AllVaccines;7565;5515;13080;448319;198808;647127
2022.07_16-08-2022;Республика Мордовия;75_90_days;CoviVac;142;52;194;448319;198808;647127
2022.07_16-08-2022;Республика Мордовия;75_90_days;EpiVacCorona;584;590;1174;448319;198808;647127
2022.07_16-08-2022;Республика Мордовия;75_90_days;SputnikLite;1028;880;1908;448319;198808;647127
2022.07_16-08-2022;Республика Мордовия;75_90_days;SputnikV;5811;3993;9804;448319;198808;647127
2022.07_16-08-2022;Республика Мордовия;90_105_days;AllVaccines;6969;4810;11779;448319;198808;647127
2022.07_16-08-2022;Республика Мордовия;90_105_days;CoviVac;147;40;187;448319;198808;647127
2022.07_16-08-2022;Республика Мордовия;90_105_days;EpiVacCorona;383;410;793;448319;198808;647127
2022.07_16-08-2022;Республика Мордовия;90_105_days;SputnikLite;2114;1453;3567;448319;198808;647127
2022.07_16-08-2022;Республика Мордовия;90_105_days;SputnikV;4325;2907;7232;448319;198808;647127
2022.07_16-08-2022;Республика Саха (Якутия);105_165_days;AllVaccines;32429;7577;40006;568643;148395;717038
2022.07_16-08-2022;Республика Саха (Якутия);105_165_days;CoviVac;372;47;419;568643;148395;717038
2022.07_16-08-2022;Республика Саха (Якутия);105_165_days;EpiVacCorona;1329;475;1804;568643;148395;717038
2022.07_16-08-2022;Республика Саха (Якутия);105_165_days;SputnikLite;9459;1641;11100;568643;148395;717038
2022.07_16-08-2022;Республика Саха (Якутия);105_165_days;SputnikV;21269;5414;26683;568643;148395;717038
2022.07_16-08-2022;Республика Саха (Якутия);165_195_days;AllVaccines;27359;6986;34345;568643;148395;717038
2022.07_16-08-2022;Республика Саха (Якутия);165_195_days;CoviVac;258;34;292;568643;148395;717038
2022.07_16-08-2022;Республика Саха (Якутия);165_195_days;EpiVacCorona;359;128;487;568643;148395;717038
2022.07_16-08-2022;Республика Саха (Якутия);165_195_days;SputnikLite;18856;4605;23461;568643;148395;717038
2022.07_16-08-2022;Республика Саха (Якутия);165_195_days;SputnikV;7886;2219;10105;568643;148395;717038
2022.07_16-08-2022;Республика Саха (Якутия);21_45_days;AllVaccines;2221;669;2890;568643;148395;717038
2022.07_16-08-2022;Республика Саха (Якутия);21_45_days;CoviVac;140;23;163;568643;148395;717038
2022.07_16-08-2022;Республика Саха (Якутия);21_45_days;EpiVacCorona;471;113;584;568643;148395;717038
2022.07_16-08-2022;Республика Саха (Якутия);21_45_days;SputnikLite;46;15;61;568643;148395;717038
2022.07_16-08-2022;Республика Саха (Якутия);21_45_days;SputnikV;1564;518;2082;568643;148395;717038
2022.07_16-08-2022;Республика Саха (Якутия);45_75_days;AllVaccines;3290;918;4208;568643;148395;717038
2022.07_16-08-2022;Республика Саха (Якутия);45_75_days;CoviVac;150;39;189;568643;148395;717038
2022.07_16-08-2022;Республика Саха (Якутия);45_75_days;EpiVacCorona;336;91;427;568643;148395;717038
2022.07_16-08-2022;Республика Саха (Якутия);45_75_days;SputnikLite;166;46;212;568643;148395;717038
2022.07_16-08-2022;Республика Саха (Якутия);45_75_days;SputnikV;2638;742;3380;568643;148395;717038
2022.07_16-08-2022;Республика Саха (Якутия);75_90_days;AllVaccines;2095;607;2702;568643;148395;717038
2022.07_16-08-2022;Республика Саха (Якутия);75_90_days;CoviVac;54;14;68;568643;148395;717038
2022.07_16-08-2022;Республика Саха (Якутия);75_90_days;EpiVacCorona;261;43;304;568643;148395;717038
2022.07_16-08-2022;Республика Саха (Якутия);75_90_days;SputnikLite;243;90;333;568643;148395;717038
2022.07_16-08-2022;Республика Саха (Якутия);75_90_days;SputnikV;1537;460;1997;568643;148395;717038
2022.07_16-08-2022;Республика Саха (Якутия);90_105_days;AllVaccines;3079;716;3795;568643;148395;717038
2022.07_16-08-2022;Республика Саха (Якутия);90_105_days;CoviVac;83;9;92;568643;148395;717038
2022.07_16-08-2022;Республика Саха (Якутия);90_105_days;EpiVacCorona;279;58;337;568643;148395;717038
2022.07_16-08-2022;Республика Саха (Якутия);90_105_days;SputnikLite;514;170;684;568643;148395;717038
2022.07_16-08-2022;Республика Саха (Якутия);90_105_days;SputnikV;2203;479;2682;568643;148395;717038
2022.07_16-08-2022;Республика Северная Осетия - Алания;105_165_days;AllVaccines;11735;4376;16111;385443;144230;529673
2022.07_16-08-2022;Республика Северная Осетия - Алания;105_165_days;CoviVac;171;277;448;385443;144230;529673
2022.07_16-08-2022;Республика Северная Осетия - Алания;105_165_days;EpiVacCorona;540;642;1182;385443;144230;529673
2022.07_16-08-2022;Республика Северная Осетия - Алания;105_165_days;SputnikLite;3974;1312;5286;385443;144230;529673
2022.07_16-08-2022;Республика Северная Осетия - Алания;105_165_days;SputnikV;7050;2145;9195;385443;144230;529673
2022.07_16-08-2022;Республика Северная Осетия - Алания;165_195_days;AllVaccines;10102;3316;13418;385443;144230;529673
2022.07_16-08-2022;Республика Северная Осетия - Алания;165_195_days;CoviVac;59;40;99;385443;144230;529673
2022.07_16-08-2022;Республика Северная Осетия - Алания;165_195_days;EpiVacCorona;1768;576;2344;385443;144230;529673
2022.07_16-08-2022;Республика Северная Осетия - Алания;165_195_days;SputnikLite;4946;1718;6664;385443;144230;529673
2022.07_16-08-2022;Республика Северная Осетия - Алания;165_195_days;SputnikV;3329;982;4311;385443;144230;529673
2022.07_16-08-2022;Республика Северная Осетия - Алания;21_45_days;AllVaccines;2226;1292;3518;385443;144230;529673
2022.07_16-08-2022;Республика Северная Осетия - Алания;21_45_days;CoviVac;87;20;107;385443;144230;529673
2022.07_16-08-2022;Республика Северная Осетия - Алания;21_45_days;EpiVacCorona;1;0;1;385443;144230;529673
2022.07_16-08-2022;Республика Северная Осетия - Алания;21_45_days;SputnikLite;160;18;178;385443;144230;529673
2022.07_16-08-2022;Республика Северная Осетия - Алания;21_45_days;SputnikV;1978;1254;3232;385443;144230;529673
2022.07_16-08-2022;Республика Северная Осетия - Алания;45_75_days;AllVaccines;2519;1597;4116;385443;144230;529673
2022.07_16-08-2022;Республика Северная Осетия - Алания;45_75_days;CoviVac;170;120;290;385443;144230;529673
2022.07_16-08-2022;Республика Северная Осетия - Алания;45_75_days;EpiVacCorona;83;18;101;385443;144230;529673
2022.07_16-08-2022;Республика Северная Осетия - Алания;45_75_days;SputnikLite;149;49;198;385443;144230;529673
2022.07_16-08-2022;Республика Северная Осетия - Алания;45_75_days;SputnikV;2117;1410;3527;385443;144230;529673
2022.07_16-08-2022;Республика Северная Осетия - Алания;75_90_days;AllVaccines;1215;790;2005;385443;144230;529673
2022.07_16-08-2022;Республика Северная Осетия - Алания;75_90_days;CoviVac;227;230;457;385443;144230;529673
2022.07_16-08-2022;Республика Северная Осетия - Алания;75_90_days;EpiVacCorona;8;3;11;385443;144230;529673
2022.07_16-08-2022;Республика Северная Осетия - Алания;75_90_days;SputnikLite;87;30;117;385443;144230;529673
2022.07_16-08-2022;Республика Северная Осетия - Алания;75_90_days;SputnikV;893;527;1420;385443;144230;529673
2022.07_16-08-2022;Республика Северная Осетия - Алания;90_105_days;AllVaccines;1464;819;2283;385443;144230;529673
2022.07_16-08-2022;Республика Северная Осетия - Алания;90_105_days;CoviVac;66;12;78;385443;144230;529673
2022.07_16-08-2022;Республика Северная Осетия - Алания;90_105_days;EpiVacCorona;21;10;31;385443;144230;529673
2022.07_16-08-2022;Республика Северная Осетия - Алания;90_105_days;SputnikLite;207;65;272;385443;144230;529673
2022.07_16-08-2022;Республика Северная Осетия - Алания;90_105_days;SputnikV;1170;732;1902;385443;144230;529673
2022.07_16-08-2022;Республика Татарстан;105_165_days;AllVaccines;97695;41595;139290;2180132;866477;3046609
2022.07_16-08-2022;Республика Татарстан;105_165_days;CoviVac;971;427;1398;2180132;866477;3046609
2022.07_16-08-2022;Республика Татарстан;105_165_days;EpiVacCorona;1971;1531;3502;2180132;866477;3046609
2022.07_16-08-2022;Республика Татарстан;105_165_days;SputnikLite;39085;15939;55024;2180132;866477;3046609
2022.07_16-08-2022;Республика Татарстан;105_165_days;SputnikV;55668;23698;79366;2180132;866477;3046609
2022.07_16-08-2022;Республика Татарстан;165_195_days;AllVaccines;67221;38336;105557;2180132;866477;3046609
2022.07_16-08-2022;Республика Татарстан;165_195_days;CoviVac;332;129;461;2180132;866477;3046609
2022.07_16-08-2022;Республика Татарстан;165_195_days;EpiVacCorona;1153;960;2113;2180132;866477;3046609
2022.07_16-08-2022;Республика Татарстан;165_195_days;SputnikLite;35809;22818;58627;2180132;866477;3046609
2022.07_16-08-2022;Республика Татарстан;165_195_days;SputnikV;29927;14429;44356;2180132;866477;3046609
2022.07_16-08-2022;Республика Татарстан;21_45_days;AllVaccines;14386;6557;20943;2180132;866477;3046609
2022.07_16-08-2022;Республика Татарстан;21_45_days;CoviVac;401;212;613;2180132;866477;3046609
2022.07_16-08-2022;Республика Татарстан;21_45_days;EpiVacCorona;979;398;1377;2180132;866477;3046609
2022.07_16-08-2022;Республика Татарстан;21_45_days;SputnikLite;2077;942;3019;2180132;866477;3046609
2022.07_16-08-2022;Республика Татарстан;21_45_days;SputnikV;10929;5005;15934;2180132;866477;3046609
2022.07_16-08-2022;Республика Татарстан;45_75_days;AllVaccines;12710;7072;19782;2180132;866477;3046609
2022.07_16-08-2022;Республика Татарстан;45_75_days;CoviVac;454;178;632;2180132;866477;3046609
2022.07_16-08-2022;Республика Татарстан;45_75_days;EpiVacCorona;380;127;507;2180132;866477;3046609
2022.07_16-08-2022;Республика Татарстан;45_75_days;SputnikLite;4934;3606;8540;2180132;866477;3046609
2022.07_16-08-2022;Республика Татарстан;45_75_days;SputnikV;6942;3161;10103;2180132;866477;3046609
2022.07_16-08-2022;Республика Татарстан;75_90_days;AllVaccines;7033;3623;10656;2180132;866477;3046609
2022.07_16-08-2022;Республика Татарстан;75_90_days;CoviVac;86;37;123;2180132;866477;3046609
2022.07_16-08-2022;Республика Татарстан;75_90_days;EpiVacCorona;362;204;566;2180132;866477;3046609
2022.07_16-08-2022;Республика Татарстан;75_90_days;SputnikLite;3210;1989;5199;2180132;866477;3046609
2022.07_16-08-2022;Республика Татарстан;75_90_days;SputnikV;3375;1393;4768;2180132;866477;3046609
2022.07_16-08-2022;Республика Татарстан;90_105_days;AllVaccines;9923;4782;14705;2180132;866477;3046609
2022.07_16-08-2022;Республика Татарстан;90_105_days;CoviVac;82;29;111;2180132;866477;3046609
2022.07_16-08-2022;Республика Татарстан;90_105_days;EpiVacCorona;840;444;1284;2180132;866477;3046609
2022.07_16-08-2022;Республика Татарстан;90_105_days;SputnikLite;4218;2595;6813;2180132;866477;3046609
2022.07_16-08-2022;Республика Татарстан;90_105_days;SputnikV;4783;1714;6497;2180132;866477;3046609
2022.07_16-08-2022;Республика Тыва;105_165_days;AllVaccines;18491;3224;21715;176122;31028;207150
2022.07_16-08-2022;Республика Тыва;105_165_days;CoviVac;134;39;173;176122;31028;207150
2022.07_16-08-2022;Республика Тыва;105_165_days;EpiVacCorona;446;70;516;176122;31028;207150
2022.07_16-08-2022;Республика Тыва;105_165_days;SputnikLite;9502;1689;11191;176122;31028;207150
2022.07_16-08-2022;Республика Тыва;105_165_days;SputnikV;8409;1426;9835;176122;31028;207150
2022.07_16-08-2022;Республика Тыва;165_195_days;AllVaccines;11889;2438;14327;176122;31028;207150
2022.07_16-08-2022;Республика Тыва;165_195_days;CoviVac;4;0;4;176122;31028;207150
2022.07_16-08-2022;Республика Тыва;165_195_days;EpiVacCorona;99;6;105;176122;31028;207150
2022.07_16-08-2022;Республика Тыва;165_195_days;SputnikLite;9443;2052;11495;176122;31028;207150
2022.07_16-08-2022;Республика Тыва;165_195_days;SputnikV;2343;380;2723;176122;31028;207150
2022.07_16-08-2022;Республика Тыва;21_45_days;AllVaccines;2916;661;3577;176122;31028;207150
2022.07_16-08-2022;Республика Тыва;21_45_days;CoviVac;3;0;3;176122;31028;207150
2022.07_16-08-2022;Республика Тыва;21_45_days;EpiVacCorona;884;203;1087;176122;31028;207150
2022.07_16-08-2022;Республика Тыва;21_45_days;SputnikLite;683;76;759;176122;31028;207150
2022.07_16-08-2022;Республика Тыва;21_45_days;SputnikV;1346;382;1728;176122;31028;207150
2022.07_16-08-2022;Республика Тыва;45_75_days;AllVaccines;3472;863;4335;176122;31028;207150
2022.07_16-08-2022;Республика Тыва;45_75_days;CoviVac;90;14;104;176122;31028;207150
2022.07_16-08-2022;Республика Тыва;45_75_days;EpiVacCorona;756;204;960;176122;31028;207150
2022.07_16-08-2022;Республика Тыва;45_75_days;SputnikLite;581;60;641;176122;31028;207150
2022.07_16-08-2022;Республика Тыва;45_75_days;SputnikV;2045;585;2630;176122;31028;207150
2022.07_16-08-2022;Республика Тыва;75_90_days;AllVaccines;3449;814;4263;176122;31028;207150
2022.07_16-08-2022;Республика Тыва;75_90_days;CoviVac;448;71;519;176122;31028;207150
2022.07_16-08-2022;Республика Тыва;75_90_days;EpiVacCorona;413;117;530;176122;31028;207150
2022.07_16-08-2022;Республика Тыва;75_90_days;SputnikLite;987;187;1174;176122;31028;207150
2022.07_16-08-2022;Республика Тыва;75_90_days;SputnikV;1601;439;2040;176122;31028;207150
2022.07_16-08-2022;Республика Тыва;90_105_days;AllVaccines;2463;455;2918;176122;31028;207150
2022.07_16-08-2022;Республика Тыва;90_105_days;CoviVac;177;22;199;176122;31028;207150
2022.07_16-08-2022;Республика Тыва;90_105_days;EpiVacCorona;196;43;239;176122;31028;207150
2022.07_16-08-2022;Республика Тыва;90_105_days;SputnikLite;1077;171;1248;176122;31028;207150
2022.07_16-08-2022;Республика Тыва;90_105_days;SputnikV;1013;219;1232;176122;31028;207150
2022.07_16-08-2022;Республика Хакасия;105_165_days;AllVaccines;16514;6317;22831;291439;112190;403629
2022.07_16-08-2022;Республика Хакасия;105_165_days;CoviVac;340;89;429;291439;112190;403629
2022.07_16-08-2022;Республика Хакасия;105_165_days;EpiVacCorona;761;260;1021;291439;112190;403629
2022.07_16-08-2022;Республика Хакасия;105_165_days;SputnikLite;8330;2616;10946;291439;112190;403629
2022.07_16-08-2022;Республика Хакасия;105_165_days;SputnikV;7083;3352;10435;291439;112190;403629
2022.07_16-08-2022;Республика Хакасия;165_195_days;AllVaccines;13387;5538;18925;291439;112190;403629
2022.07_16-08-2022;Республика Хакасия;165_195_days;CoviVac;214;68;282;291439;112190;403629
2022.07_16-08-2022;Республика Хакасия;165_195_days;EpiVacCorona;444;174;618;291439;112190;403629
2022.07_16-08-2022;Республика Хакасия;165_195_days;SputnikLite;9699;4130;13829;291439;112190;403629
2022.07_16-08-2022;Республика Хакасия;165_195_days;SputnikV;3030;1166;4196;291439;112190;403629
2022.07_16-08-2022;Республика Хакасия;21_45_days;AllVaccines;1184;938;2122;291439;112190;403629
2022.07_16-08-2022;Республика Хакасия;21_45_days;EpiVacCorona;135;107;242;291439;112190;403629
2022.07_16-08-2022;Республика Хакасия;21_45_days;SputnikLite;2;0;2;291439;112190;403629
2022.07_16-08-2022;Республика Хакасия;21_45_days;SputnikV;1047;831;1878;291439;112190;403629
2022.07_16-08-2022;Республика Хакасия;45_75_days;AllVaccines;1118;724;1842;291439;112190;403629
2022.07_16-08-2022;Республика Хакасия;45_75_days;CoviVac;30;5;35;291439;112190;403629
2022.07_16-08-2022;Республика Хакасия;45_75_days;EpiVacCorona;85;80;165;291439;112190;403629
2022.07_16-08-2022;Республика Хакасия;45_75_days;SputnikLite;76;57;133;291439;112190;403629
2022.07_16-08-2022;Республика Хакасия;45_75_days;SputnikV;927;582;1509;291439;112190;403629
2022.07_16-08-2022;Республика Хакасия;75_90_days;AllVaccines;767;431;1198;291439;112190;403629
2022.07_16-08-2022;Республика Хакасия;75_90_days;CoviVac;70;30;100;291439;112190;403629
2022.07_16-08-2022;Республика Хакасия;75_90_days;EpiVacCorona;63;44;107;291439;112190;403629
2022.07_16-08-2022;Республика Хакасия;75_90_days;SputnikLite;69;56;125;291439;112190;403629
2022.07_16-08-2022;Республика Хакасия;75_90_days;SputnikV;565;301;866;291439;112190;403629
2022.07_16-08-2022;Республика Хакасия;90_105_days;AllVaccines;939;428;1367;291439;112190;403629
2022.07_16-08-2022;Республика Хакасия;90_105_days;CoviVac;92;20;112;291439;112190;403629
2022.07_16-08-2022;Республика Хакасия;90_105_days;EpiVacCorona;49;19;68;291439;112190;403629
2022.07_16-08-2022;Республика Хакасия;90_105_days;SputnikLite;86;59;145;291439;112190;403629
2022.07_16-08-2022;Республика Хакасия;90_105_days;SputnikV;712;330;1042;291439;112190;403629
2022.07_16-08-2022;Ростовская область;105_165_days;AllVaccines;165237;80605;245842;2367942;1020468;3388410
2022.07_16-08-2022;Ростовская область;105_165_days;CoviVac;2122;566;2688;2367942;1020468;3388410
2022.07_16-08-2022;Ростовская область;105_165_days;EpiVacCorona;8062;4966;13028;2367942;1020468;3388410
2022.07_16-08-2022;Ростовская область;105_165_days;SputnikLite;57002;17411;74413;2367942;1020468;3388410
2022.07_16-08-2022;Ростовская область;105_165_days;SputnikV;98051;57662;155713;2367942;1020468;3388410
2022.07_16-08-2022;Ростовская область;165_195_days;AllVaccines;86377;40554;126931;2367942;1020468;3388410
2022.07_16-08-2022;Ростовская область;165_195_days;CoviVac;641;237;878;2367942;1020468;3388410
2022.07_16-08-2022;Ростовская область;165_195_days;EpiVacCorona;1044;615;1659;2367942;1020468;3388410
2022.07_16-08-2022;Ростовская область;165_195_days;SputnikLite;45856;19536;65392;2367942;1020468;3388410
2022.07_16-08-2022;Ростовская область;165_195_days;SputnikV;38836;20166;59002;2367942;1020468;3388410
2022.07_16-08-2022;Ростовская область;21_45_days;AllVaccines;24682;17653;42335;2367942;1020468;3388410
2022.07_16-08-2022;Ростовская область;21_45_days;CoviVac;990;424;1414;2367942;1020468;3388410
2022.07_16-08-2022;Ростовская область;21_45_days;EpiVacCorona;2730;1754;4484;2367942;1020468;3388410
2022.07_16-08-2022;Ростовская область;21_45_days;SputnikLite;400;163;563;2367942;1020468;3388410
2022.07_16-08-2022;Ростовская область;21_45_days;SputnikV;20562;15312;35874;2367942;1020468;3388410
2022.07_16-08-2022;Ростовская область;45_75_days;AllVaccines;28203;18118;46321;2367942;1020468;3388410
2022.07_16-08-2022;Ростовская область;45_75_days;CoviVac;2297;660;2957;2367942;1020468;3388410
2022.07_16-08-2022;Ростовская область;45_75_days;EpiVacCorona;1965;1438;3403;2367942;1020468;3388410
2022.07_16-08-2022;Ростовская область;45_75_days;SputnikLite;1950;1008;2958;2367942;1020468;3388410
2022.07_16-08-2022;Ростовская область;45_75_days;SputnikV;21991;15012;37003;2367942;1020468;3388410
2022.07_16-08-2022;Ростовская область;75_90_days;AllVaccines;16703;11711;28414;2367942;1020468;3388410
2022.07_16-08-2022;Ростовская область;75_90_days;CoviVac;683;207;890;2367942;1020468;3388410
2022.07_16-08-2022;Ростовская область;75_90_days;EpiVacCorona;1491;893;2384;2367942;1020468;3388410
2022.07_16-08-2022;Ростовская область;75_90_days;SputnikLite;1788;856;2644;2367942;1020468;3388410
2022.07_16-08-2022;Ростовская область;75_90_days;SputnikV;12741;9755;22496;2367942;1020468;3388410
2022.07_16-08-2022;Ростовская область;90_105_days;AllVaccines;15376;10561;25937;2367942;1020468;3388410
2022.07_16-08-2022;Ростовская область;90_105_days;CoviVac;369;204;573;2367942;1020468;3388410
2022.07_16-08-2022;Ростовская область;90_105_days;EpiVacCorona;1794;1608;3402;2367942;1020468;3388410
2022.07_16-08-2022;Ростовская область;90_105_days;SputnikLite;761;261;1022;2367942;1020468;3388410
2022.07_16-08-2022;Ростовская область;90_105_days;SputnikV;12452;8488;20940;2367942;1020468;3388410
2022.07_16-08-2022;Рязанская область;105_165_days;AllVaccines;22068;10464;32532;600731;301318;902049
2022.07_16-08-2022;Рязанская область;105_165_days;CoviVac;447;130;577;600731;301318;902049
2022.07_16-08-2022;Рязанская область;105_165_days;EpiVacCorona;429;184;613;600731;301318;902049
2022.07_16-08-2022;Рязанская область;105_165_days;SputnikLite;9405;5215;14620;600731;301318;902049
2022.07_16-08-2022;Рязанская область;105_165_days;SputnikV;11787;4935;16722;600731;301318;902049
2022.07_16-08-2022;Рязанская область;165_195_days;AllVaccines;28441;14295;42736;600731;301318;902049
2022.07_16-08-2022;Рязанская область;165_195_days;CoviVac;384;94;478;600731;301318;902049
2022.07_16-08-2022;Рязанская область;165_195_days;EpiVacCorona;890;336;1226;600731;301318;902049
2022.07_16-08-2022;Рязанская область;165_195_days;SputnikLite;16394;10328;26722;600731;301318;902049
2022.07_16-08-2022;Рязанская область;165_195_days;SputnikV;10773;3537;14310;600731;301318;902049
2022.07_16-08-2022;Рязанская область;21_45_days;AllVaccines;2455;1750;4205;600731;301318;902049
2022.07_16-08-2022;Рязанская область;21_45_days;CoviVac;176;128;304;600731;301318;902049
2022.07_16-08-2022;Рязанская область;21_45_days;EpiVacCorona;575;436;1011;600731;301318;902049
2022.07_16-08-2022;Рязанская область;21_45_days;SputnikLite;185;94;279;600731;301318;902049
2022.07_16-08-2022;Рязанская область;21_45_days;SputnikV;1519;1092;2611;600731;301318;902049
2022.07_16-08-2022;Рязанская область;45_75_days;AllVaccines;1554;1229;2783;600731;301318;902049
2022.07_16-08-2022;Рязанская область;45_75_days;CoviVac;128;62;190;600731;301318;902049
2022.07_16-08-2022;Рязанская область;45_75_days;EpiVacCorona;63;34;97;600731;301318;902049
2022.07_16-08-2022;Рязанская область;45_75_days;SputnikLite;231;191;422;600731;301318;902049
2022.07_16-08-2022;Рязанская область;45_75_days;SputnikV;1132;942;2074;600731;301318;902049
2022.07_16-08-2022;Рязанская область;75_90_days;AllVaccines;1625;1067;2692;600731;301318;902049
2022.07_16-08-2022;Рязанская область;75_90_days;CoviVac;73;15;88;600731;301318;902049
2022.07_16-08-2022;Рязанская область;75_90_days;EpiVacCorona;50;5;55;600731;301318;902049
2022.07_16-08-2022;Рязанская область;75_90_days;SputnikLite;372;319;691;600731;301318;902049
2022.07_16-08-2022;Рязанская область;75_90_days;SputnikV;1130;728;1858;600731;301318;902049
2022.07_16-08-2022;Рязанская область;90_105_days;AllVaccines;1929;1915;3844;600731;301318;902049
2022.07_16-08-2022;Рязанская область;90_105_days;CoviVac;86;29;115;600731;301318;902049
2022.07_16-08-2022;Рязанская область;90_105_days;EpiVacCorona;43;23;66;600731;301318;902049
2022.07_16-08-2022;Рязанская область;90_105_days;SputnikLite;839;976;1815;600731;301318;902049
2022.07_16-08-2022;Рязанская область;90_105_days;SputnikV;961;887;1848;600731;301318;902049
2022.07_16-08-2022;Самарская область;105_165_days;AllVaccines;79395;46347;125742;1769846;769791;2539637
2022.07_16-08-2022;Самарская область;105_165_days;CoviVac;1081;450;1531;1769846;769791;2539637
2022.07_16-08-2022;Самарская область;105_165_days;EpiVacCorona;3146;3685;6831;1769846;769791;2539637
2022.07_16-08-2022;Самарская область;105_165_days;SputnikLite;30519;12533;43052;1769846;769791;2539637
2022.07_16-08-2022;Самарская область;105_165_days;SputnikV;44649;29679;74328;1769846;769791;2539637
2022.07_16-08-2022;Самарская область;165_195_days;AllVaccines;62785;36395;99180;1769846;769791;2539637
2022.07_16-08-2022;Самарская область;165_195_days;CoviVac;518;212;730;1769846;769791;2539637
2022.07_16-08-2022;Самарская область;165_195_days;EpiVacCorona;1002;1185;2187;1769846;769791;2539637
2022.07_16-08-2022;Самарская область;165_195_days;SputnikLite;38959;23443;62402;1769846;769791;2539637
2022.07_16-08-2022;Самарская область;165_195_days;SputnikV;22306;11555;33861;1769846;769791;2539637
2022.07_16-08-2022;Самарская область;21_45_days;AllVaccines;11794;10383;22177;1769846;769791;2539637
2022.07_16-08-2022;Самарская область;21_45_days;CoviVac;329;262;591;1769846;769791;2539637
2022.07_16-08-2022;Самарская область;21_45_days;EpiVacCorona;748;814;1562;1769846;769791;2539637
2022.07_16-08-2022;Самарская область;21_45_days;SputnikLite;3133;1631;4764;1769846;769791;2539637
2022.07_16-08-2022;Самарская область;21_45_days;SputnikV;7584;7676;15260;1769846;769791;2539637
2022.07_16-08-2022;Самарская область;45_75_days;AllVaccines;13031;11458;24489;1769846;769791;2539637
2022.07_16-08-2022;Самарская область;45_75_days;CoviVac;350;223;573;1769846;769791;2539637
2022.07_16-08-2022;Самарская область;45_75_days;EpiVacCorona;635;903;1538;1769846;769791;2539637
2022.07_16-08-2022;Самарская область;45_75_days;SputnikLite;4643;2414;7057;1769846;769791;2539637
2022.07_16-08-2022;Самарская область;45_75_days;SputnikV;7403;7918;15321;1769846;769791;2539637
2022.07_16-08-2022;Самарская область;75_90_days;AllVaccines;11783;10271;22054;1769846;769791;2539637
2022.07_16-08-2022;Самарская область;75_90_days;CoviVac;389;147;536;1769846;769791;2539637
2022.07_16-08-2022;Самарская область;75_90_days;EpiVacCorona;754;1205;1959;1769846;769791;2539637
2022.07_16-08-2022;Самарская область;75_90_days;SputnikLite;4408;1229;5637;1769846;769791;2539637
2022.07_16-08-2022;Самарская область;75_90_days;SputnikV;6232;7690;13922;1769846;769791;2539637
2022.07_16-08-2022;Самарская область;90_105_days;AllVaccines;9159;9790;18949;1769846;769791;2539637
2022.07_16-08-2022;Самарская область;90_105_days;CoviVac;174;137;311;1769846;769791;2539637
2022.07_16-08-2022;Самарская область;90_105_days;EpiVacCorona;856;1313;2169;1769846;769791;2539637
2022.07_16-08-2022;Самарская область;90_105_days;SputnikLite;2769;1725;4494;1769846;769791;2539637
2022.07_16-08-2022;Самарская область;90_105_days;SputnikV;5360;6615;11975;1769846;769791;2539637
2022.07_16-08-2022;Саратовская область;105_165_days;AllVaccines;58605;33333;91938;1348454;599954;1948408
2022.07_16-08-2022;Саратовская область;105_165_days;CoviVac;1292;473;1765;1348454;599954;1948408
2022.07_16-08-2022;Саратовская область;105_165_days;EpiVacCorona;4796;3732;8528;1348454;599954;1948408
2022.07_16-08-2022;Саратовская область;105_165_days;SputnikLite;26028;12359;38387;1348454;599954;1948408
2022.07_16-08-2022;Саратовская область;105_165_days;SputnikV;26489;16769;43258;1348454;599954;1948408
2022.07_16-08-2022;Саратовская область;165_195_days;AllVaccines;49307;25549;74856;1348454;599954;1948408
2022.07_16-08-2022;Саратовская область;165_195_days;CoviVac;684;187;871;1348454;599954;1948408
2022.07_16-08-2022;Саратовская область;165_195_days;EpiVacCorona;2163;1186;3349;1348454;599954;1948408
2022.07_16-08-2022;Саратовская область;165_195_days;SputnikLite;31833;17087;48920;1348454;599954;1948408
2022.07_16-08-2022;Саратовская область;165_195_days;SputnikV;14627;7089;21716;1348454;599954;1948408
2022.07_16-08-2022;Саратовская область;21_45_days;AllVaccines;11974;7238;19212;1348454;599954;1948408
2022.07_16-08-2022;Саратовская область;21_45_days;CoviVac;511;116;627;1348454;599954;1948408
2022.07_16-08-2022;Саратовская область;21_45_days;EpiVacCorona;1527;976;2503;1348454;599954;1948408
2022.07_16-08-2022;Саратовская область;21_45_days;SputnikLite;325;129;454;1348454;599954;1948408
2022.07_16-08-2022;Саратовская область;21_45_days;SputnikV;9611;6017;15628;1348454;599954;1948408
2022.07_16-08-2022;Саратовская область;45_75_days;AllVaccines;10929;7667;18596;1348454;599954;1948408
2022.07_16-08-2022;Саратовская область;45_75_days;CoviVac;1259;340;1599;1348454;599954;1948408
2022.07_16-08-2022;Саратовская область;45_75_days;EpiVacCorona;1137;1631;2768;1348454;599954;1948408
2022.07_16-08-2022;Саратовская область;45_75_days;SputnikLite;2373;1077;3450;1348454;599954;1948408
2022.07_16-08-2022;Саратовская область;45_75_days;SputnikV;6160;4619;10779;1348454;599954;1948408
2022.07_16-08-2022;Саратовская область;75_90_days;AllVaccines;7146;4210;11356;1348454;599954;1948408
2022.07_16-08-2022;Саратовская область;75_90_days;CoviVac;447;175;622;1348454;599954;1948408
2022.07_16-08-2022;Саратовская область;75_90_days;EpiVacCorona;662;530;1192;1348454;599954;1948408
2022.07_16-08-2022;Саратовская область;75_90_days;SputnikLite;1132;737;1869;1348454;599954;1948408
2022.07_16-08-2022;Саратовская область;75_90_days;SputnikV;4905;2768;7673;1348454;599954;1948408
2022.07_16-08-2022;Саратовская область;90_105_days;AllVaccines;6829;5391;12220;1348454;599954;1948408
2022.07_16-08-2022;Саратовская область;90_105_days;CoviVac;360;117;477;1348454;599954;1948408
2022.07_16-08-2022;Саратовская область;90_105_days;EpiVacCorona;1099;567;1666;1348454;599954;1948408
2022.07_16-08-2022;Саратовская область;90_105_days;SputnikLite;1576;1009;2585;1348454;599954;1948408
2022.07_16-08-2022;Саратовская область;90_105_days;SputnikV;3794;3698;7492;1348454;599954;1948408
2022.07_16-08-2022;Сахалинская область;105_165_days;AllVaccines;16951;5261;22212;276677;101794;378471
2022.07_16-08-2022;Сахалинская область;105_165_days;CoviVac;490;73;563;276677;101794;378471
2022.07_16-08-2022;Сахалинская область;105_165_days;EpiVacCorona;871;154;1025;276677;101794;378471
2022.07_16-08-2022;Сахалинская область;105_165_days;SputnikLite;10009;3404;13413;276677;101794;378471
2022.07_16-08-2022;Сахалинская область;105_165_days;SputnikV;5581;1630;7211;276677;101794;378471
2022.07_16-08-2022;Сахалинская область;165_195_days;AllVaccines;17190;6329;23519;276677;101794;378471
2022.07_16-08-2022;Сахалинская область;165_195_days;CoviVac;219;53;272;276677;101794;378471
2022.07_16-08-2022;Сахалинская область;165_195_days;EpiVacCorona;366;102;468;276677;101794;378471
2022.07_16-08-2022;Сахалинская область;165_195_days;SputnikLite;13371;5350;18721;276677;101794;378471
2022.07_16-08-2022;Сахалинская область;165_195_days;SputnikV;3234;824;4058;276677;101794;378471
2022.07_16-08-2022;Сахалинская область;21_45_days;AllVaccines;1741;829;2570;276677;101794;378471
2022.07_16-08-2022;Сахалинская область;21_45_days;CoviVac;2;0;2;276677;101794;378471
2022.07_16-08-2022;Сахалинская область;21_45_days;EpiVacCorona;258;104;362;276677;101794;378471
2022.07_16-08-2022;Сахалинская область;21_45_days;SputnikLite;165;56;221;276677;101794;378471
2022.07_16-08-2022;Сахалинская область;21_45_days;SputnikV;1316;669;1985;276677;101794;378471
2022.07_16-08-2022;Сахалинская область;45_75_days;AllVaccines;2300;1069;3369;276677;101794;378471
2022.07_16-08-2022;Сахалинская область;45_75_days;CoviVac;6;1;7;276677;101794;378471
2022.07_16-08-2022;Сахалинская область;45_75_days;EpiVacCorona;119;12;131;276677;101794;378471
2022.07_16-08-2022;Сахалинская область;45_75_days;SputnikLite;1259;702;1961;276677;101794;378471
2022.07_16-08-2022;Сахалинская область;45_75_days;SputnikV;916;354;1270;276677;101794;378471
2022.07_16-08-2022;Сахалинская область;75_90_days;AllVaccines;1720;697;2417;276677;101794;378471
2022.07_16-08-2022;Сахалинская область;75_90_days;CoviVac;7;2;9;276677;101794;378471
2022.07_16-08-2022;Сахалинская область;75_90_days;EpiVacCorona;179;16;195;276677;101794;378471
2022.07_16-08-2022;Сахалинская область;75_90_days;SputnikLite;1007;502;1509;276677;101794;378471
2022.07_16-08-2022;Сахалинская область;75_90_days;SputnikV;527;177;704;276677;101794;378471
2022.07_16-08-2022;Сахалинская область;90_105_days;AllVaccines;2150;723;2873;276677;101794;378471
2022.07_16-08-2022;Сахалинская область;90_105_days;CoviVac;80;5;85;276677;101794;378471
2022.07_16-08-2022;Сахалинская область;90_105_days;EpiVacCorona;82;8;90;276677;101794;378471
2022.07_16-08-2022;Сахалинская область;90_105_days;SputnikLite;1194;565;1759;276677;101794;378471
2022.07_16-08-2022;Сахалинская область;90_105_days;SputnikV;794;145;939;276677;101794;378471
2022.07_16-08-2022;Свердловская область;105_165_days;AllVaccines;119488;56861;176349;2364046;987486;3351532
2022.07_16-08-2022;Свердловская область;105_165_days;CoviVac;921;236;1157;2364046;987486;3351532
2022.07_16-08-2022;Свердловская область;105_165_days;EpiVacCorona;8238;4045;12283;2364046;987486;3351532
2022.07_16-08-2022;Свердловская область;105_165_days;SputnikLite;44721;19335;64056;2364046;987486;3351532
2022.07_16-08-2022;Свердловская область;105_165_days;SputnikV;65608;33245;98853;2364046;987486;3351532
2022.07_16-08-2022;Свердловская область;165_195_days;AllVaccines;101226;54126;155352;2364046;987486;3351532
2022.07_16-08-2022;Свердловская область;165_195_days;CoviVac;390;111;501;2364046;987486;3351532
2022.07_16-08-2022;Свердловская область;165_195_days;EpiVacCorona;3401;2281;5682;2364046;987486;3351532
2022.07_16-08-2022;Свердловская область;165_195_days;SputnikLite;59467;33286;92753;2364046;987486;3351532
2022.07_16-08-2022;Свердловская область;165_195_days;SputnikV;37968;18448;56416;2364046;987486;3351532
2022.07_16-08-2022;Свердловская область;21_45_days;AllVaccines;19794;15487;35281;2364046;987486;3351532
2022.07_16-08-2022;Свердловская область;21_45_days;CoviVac;1128;585;1713;2364046;987486;3351532
2022.07_16-08-2022;Свердловская область;21_45_days;EpiVacCorona;1803;1278;3081;2364046;987486;3351532
2022.07_16-08-2022;Свердловская область;21_45_days;SputnikLite;1180;562;1742;2364046;987486;3351532
2022.07_16-08-2022;Свердловская область;21_45_days;SputnikV;15683;13062;28745;2364046;987486;3351532
2022.07_16-08-2022;Свердловская область;45_75_days;AllVaccines;19425;14260;33685;2364046;987486;3351532
2022.07_16-08-2022;Свердловская область;45_75_days;CoviVac;614;244;858;2364046;987486;3351532
2022.07_16-08-2022;Свердловская область;45_75_days;EpiVacCorona;1366;766;2132;2364046;987486;3351532
2022.07_16-08-2022;Свердловская область;45_75_days;SputnikLite;2515;1396;3911;2364046;987486;3351532
2022.07_16-08-2022;Свердловская область;45_75_days;SputnikV;14930;11854;26784;2364046;987486;3351532
2022.07_16-08-2022;Свердловская область;75_90_days;AllVaccines;11736;7723;19459;2364046;987486;3351532
2022.07_16-08-2022;Свердловская область;75_90_days;CoviVac;176;54;230;2364046;987486;3351532
2022.07_16-08-2022;Свердловская область;75_90_days;EpiVacCorona;720;347;1067;2364046;987486;3351532
2022.07_16-08-2022;Свердловская область;75_90_days;SputnikLite;1811;1070;2881;2364046;987486;3351532
2022.07_16-08-2022;Свердловская область;75_90_days;SputnikV;9029;6252;15281;2364046;987486;3351532
2022.07_16-08-2022;Свердловская область;90_105_days;AllVaccines;15189;10420;25609;2364046;987486;3351532
2022.07_16-08-2022;Свердловская область;90_105_days;CoviVac;178;49;227;2364046;987486;3351532
2022.07_16-08-2022;Свердловская область;90_105_days;EpiVacCorona;885;505;1390;2364046;987486;3351532
2022.07_16-08-2022;Свердловская область;90_105_days;SputnikLite;2388;1334;3722;2364046;987486;3351532
2022.07_16-08-2022;Свердловская область;90_105_days;SputnikV;11738;8532;20270;2364046;987486;3351532
2022.07_16-08-2022;Смоленская область;105_165_days;AllVaccines;21205;11259;32464;521379;238479;759858
2022.07_16-08-2022;Смоленская область;105_165_days;CoviVac;606;197;803;521379;238479;759858
2022.07_16-08-2022;Смоленская область;105_165_days;EpiVacCorona;1670;965;2635;521379;238479;759858
2022.07_16-08-2022;Смоленская область;105_165_days;SputnikLite;6801;3316;10117;521379;238479;759858
2022.07_16-08-2022;Смоленская область;105_165_days;SputnikV;12128;6781;18909;521379;238479;759858
2022.07_16-08-2022;Смоленская область;165_195_days;AllVaccines;17287;10463;27750;521379;238479;759858
2022.07_16-08-2022;Смоленская область;165_195_days;CoviVac;187;39;226;521379;238479;759858
2022.07_16-08-2022;Смоленская область;165_195_days;EpiVacCorona;1017;645;1662;521379;238479;759858
2022.07_16-08-2022;Смоленская область;165_195_days;SputnikLite;10434;7038;17472;521379;238479;759858
2022.07_16-08-2022;Смоленская область;165_195_days;SputnikV;5649;2741;8390;521379;238479;759858
2022.07_16-08-2022;Смоленская область;21_45_days;AllVaccines;2768;1889;4657;521379;238479;759858
2022.07_16-08-2022;Смоленская область;21_45_days;CoviVac;119;49;168;521379;238479;759858
2022.07_16-08-2022;Смоленская область;21_45_days;EpiVacCorona;271;299;570;521379;238479;759858
2022.07_16-08-2022;Смоленская область;21_45_days;SputnikLite;405;81;486;521379;238479;759858
2022.07_16-08-2022;Смоленская область;21_45_days;SputnikV;1973;1460;3433;521379;238479;759858
2022.07_16-08-2022;Смоленская область;45_75_days;AllVaccines;2872;2328;5200;521379;238479;759858
2022.07_16-08-2022;Смоленская область;45_75_days;CoviVac;184;285;469;521379;238479;759858
2022.07_16-08-2022;Смоленская область;45_75_days;EpiVacCorona;334;360;694;521379;238479;759858
2022.07_16-08-2022;Смоленская область;45_75_days;SputnikLite;616;349;965;521379;238479;759858
2022.07_16-08-2022;Смоленская область;45_75_days;SputnikV;1738;1334;3072;521379;238479;759858
2022.07_16-08-2022;Смоленская область;75_90_days;AllVaccines;1767;1158;2925;521379;238479;759858
2022.07_16-08-2022;Смоленская область;75_90_days;CoviVac;83;26;109;521379;238479;759858
2022.07_16-08-2022;Смоленская область;75_90_days;EpiVacCorona;111;55;166;521379;238479;759858
2022.07_16-08-2022;Смоленская область;75_90_days;SputnikLite;717;401;1118;521379;238479;759858
2022.07_16-08-2022;Смоленская область;75_90_days;SputnikV;856;676;1532;521379;238479;759858
2022.07_16-08-2022;Смоленская область;90_105_days;AllVaccines;2809;1749;4558;521379;238479;759858
2022.07_16-08-2022;Смоленская область;90_105_days;CoviVac;162;51;213;521379;238479;759858
2022.07_16-08-2022;Смоленская область;90_105_days;EpiVacCorona;116;93;209;521379;238479;759858
2022.07_16-08-2022;Смоленская область;90_105_days;SputnikLite;1195;790;1985;521379;238479;759858
2022.07_16-08-2022;Смоленская область;90_105_days;SputnikV;1336;815;2151;521379;238479;759858
2022.07_16-08-2022;Ставропольский край;105_165_days;AllVaccines;53724;32307;86031;1590669;616030;2206699
2022.07_16-08-2022;Ставропольский край;105_165_days;CoviVac;1281;973;2254;1590669;616030;2206699
2022.07_16-08-2022;Ставропольский край;105_165_days;EpiVacCorona;6551;4369;10920;1590669;616030;2206699
2022.07_16-08-2022;Ставропольский край;105_165_days;SputnikLite;19230;8239;27469;1590669;616030;2206699
2022.07_16-08-2022;Ставропольский край;105_165_days;SputnikV;26662;18726;45388;1590669;616030;2206699
2022.07_16-08-2022;Ставропольский край;165_195_days;AllVaccines;53434;24749;78183;1590669;616030;2206699
2022.07_16-08-2022;Ставропольский край;165_195_days;CoviVac;426;161;587;1590669;616030;2206699
2022.07_16-08-2022;Ставропольский край;165_195_days;EpiVacCorona;3435;1529;4964;1590669;616030;2206699
2022.07_16-08-2022;Ставропольский край;165_195_days;SputnikLite;29188;17188;46376;1590669;616030;2206699
2022.07_16-08-2022;Ставропольский край;165_195_days;SputnikV;20385;5871;26256;1590669;616030;2206699
2022.07_16-08-2022;Ставропольский край;21_45_days;AllVaccines;7908;4485;12393;1590669;616030;2206699
2022.07_16-08-2022;Ставропольский край;21_45_days;CoviVac;708;232;940;1590669;616030;2206699
2022.07_16-08-2022;Ставропольский край;21_45_days;EpiVacCorona;583;224;807;1590669;616030;2206699
2022.07_16-08-2022;Ставропольский край;21_45_days;SputnikLite;466;180;646;1590669;616030;2206699
2022.07_16-08-2022;Ставропольский край;21_45_days;SputnikV;6151;3849;10000;1590669;616030;2206699
2022.07_16-08-2022;Ставропольский край;45_75_days;AllVaccines;8092;5096;13188;1590669;616030;2206699
2022.07_16-08-2022;Ставропольский край;45_75_days;CoviVac;420;184;604;1590669;616030;2206699
2022.07_16-08-2022;Ставропольский край;45_75_days;EpiVacCorona;487;256;743;1590669;616030;2206699
2022.07_16-08-2022;Ставропольский край;45_75_days;SputnikLite;1361;686;2047;1590669;616030;2206699
2022.07_16-08-2022;Ставропольский край;45_75_days;SputnikV;5824;3970;9794;1590669;616030;2206699
2022.07_16-08-2022;Ставропольский край;75_90_days;AllVaccines;5862;2894;8756;1590669;616030;2206699
2022.07_16-08-2022;Ставропольский край;75_90_days;CoviVac;330;147;477;1590669;616030;2206699
2022.07_16-08-2022;Ставропольский край;75_90_days;EpiVacCorona;823;386;1209;1590669;616030;2206699
2022.07_16-08-2022;Ставропольский край;75_90_days;SputnikLite;529;404;933;1590669;616030;2206699
2022.07_16-08-2022;Ставропольский край;75_90_days;SputnikV;4180;1957;6137;1590669;616030;2206699
2022.07_16-08-2022;Ставропольский край;90_105_days;AllVaccines;6561;3761;10322;1590669;616030;2206699
2022.07_16-08-2022;Ставропольский край;90_105_days;CoviVac;220;81;301;1590669;616030;2206699
2022.07_16-08-2022;Ставропольский край;90_105_days;EpiVacCorona;795;402;1197;1590669;616030;2206699
2022.07_16-08-2022;Ставропольский край;90_105_days;SputnikLite;674;416;1090;1590669;616030;2206699
2022.07_16-08-2022;Ставропольский край;90_105_days;SputnikV;4872;2862;7734;1590669;616030;2206699
2022.07_16-08-2022;Тамбовская область;105_165_days;AllVaccines;39026;24388;63414;545785;279936;825721
2022.07_16-08-2022;Тамбовская область;105_165_days;CoviVac;1086;139;1225;545785;279936;825721
2022.07_16-08-2022;Тамбовская область;105_165_days;EpiVacCorona;4726;3750;8476;545785;279936;825721
2022.07_16-08-2022;Тамбовская область;105_165_days;SputnikLite;12039;4137;16176;545785;279936;825721
2022.07_16-08-2022;Тамбовская область;105_165_days;SputnikV;21175;16362;37537;545785;279936;825721
2022.07_16-08-2022;Тамбовская область;165_195_days;AllVaccines;25448;13567;39015;545785;279936;825721
2022.07_16-08-2022;Тамбовская область;165_195_days;CoviVac;402;61;463;545785;279936;825721
2022.07_16-08-2022;Тамбовская область;165_195_days;EpiVacCorona;1699;1144;2843;545785;279936;825721
2022.07_16-08-2022;Тамбовская область;165_195_days;SputnikLite;16982;6537;23519;545785;279936;825721
2022.07_16-08-2022;Тамбовская область;165_195_days;SputnikV;6365;5825;12190;545785;279936;825721
2022.07_16-08-2022;Тамбовская область;21_45_days;AllVaccines;10263;12551;22814;545785;279936;825721
2022.07_16-08-2022;Тамбовская область;21_45_days;CoviVac;438;100;538;545785;279936;825721
2022.07_16-08-2022;Тамбовская область;21_45_days;EpiVacCorona;2414;2855;5269;545785;279936;825721
2022.07_16-08-2022;Тамбовская область;21_45_days;SputnikLite;85;96;181;545785;279936;825721
2022.07_16-08-2022;Тамбовская область;21_45_days;SputnikV;7326;9500;16826;545785;279936;825721
2022.07_16-08-2022;Тамбовская область;45_75_days;AllVaccines;10930;13959;24889;545785;279936;825721
2022.07_16-08-2022;Тамбовская область;45_75_days;CoviVac;1102;339;1441;545785;279936;825721
2022.07_16-08-2022;Тамбовская область;45_75_days;EpiVacCorona;1214;1748;2962;545785;279936;825721
2022.07_16-08-2022;Тамбовская область;45_75_days;SputnikLite;142;35;177;545785;279936;825721
2022.07_16-08-2022;Тамбовская область;45_75_days;SputnikV;8472;11837;20309;545785;279936;825721
2022.07_16-08-2022;Тамбовская область;75_90_days;AllVaccines;3895;4962;8857;545785;279936;825721
2022.07_16-08-2022;Тамбовская область;75_90_days;CoviVac;554;182;736;545785;279936;825721
2022.07_16-08-2022;Тамбовская область;75_90_days;EpiVacCorona;452;668;1120;545785;279936;825721
2022.07_16-08-2022;Тамбовская область;75_90_days;SputnikLite;38;21;59;545785;279936;825721
2022.07_16-08-2022;Тамбовская область;75_90_days;SputnikV;2851;4091;6942;545785;279936;825721
2022.07_16-08-2022;Тамбовская область;90_105_days;AllVaccines;4158;3564;7722;545785;279936;825721
2022.07_16-08-2022;Тамбовская область;90_105_days;CoviVac;759;163;922;545785;279936;825721
2022.07_16-08-2022;Тамбовская область;90_105_days;EpiVacCorona;674;621;1295;545785;279936;825721
2022.07_16-08-2022;Тамбовская область;90_105_days;SputnikLite;86;55;141;545785;279936;825721
2022.07_16-08-2022;Тамбовская область;90_105_days;SputnikV;2639;2725;5364;545785;279936;825721
2022.07_16-08-2022;Тверская область;105_165_days;AllVaccines;28798;17910;46708;681519;330234;1011753
2022.07_16-08-2022;Тверская область;105_165_days;CoviVac;797;212;1009;681519;330234;1011753
2022.07_16-08-2022;Тверская область;105_165_days;EpiVacCorona;1243;951;2194;681519;330234;1011753
2022.07_16-08-2022;Тверская область;105_165_days;SputnikLite;15794;9766;25560;681519;330234;1011753
2022.07_16-08-2022;Тверская область;105_165_days;SputnikV;10964;6981;17945;681519;330234;1011753
2022.07_16-08-2022;Тверская область;165_195_days;AllVaccines;22705;12543;35248;681519;330234;1011753
2022.07_16-08-2022;Тверская область;165_195_days;CoviVac;503;102;605;681519;330234;1011753
2022.07_16-08-2022;Тверская область;165_195_days;EpiVacCorona;946;578;1524;681519;330234;1011753
2022.07_16-08-2022;Тверская область;165_195_days;SputnikLite;16500;9590;26090;681519;330234;1011753
2022.07_16-08-2022;Тверская область;165_195_days;SputnikV;4756;2273;7029;681519;330234;1011753
2022.07_16-08-2022;Тверская область;21_45_days;AllVaccines;2318;2935;5253;681519;330234;1011753
2022.07_16-08-2022;Тверская область;21_45_days;CoviVac;20;5;25;681519;330234;1011753
2022.07_16-08-2022;Тверская область;21_45_days;EpiVacCorona;474;394;868;681519;330234;1011753
2022.07_16-08-2022;Тверская область;21_45_days;SputnikLite;174;163;337;681519;330234;1011753
2022.07_16-08-2022;Тверская область;21_45_days;SputnikV;1650;2373;4023;681519;330234;1011753
2022.07_16-08-2022;Тверская область;45_75_days;AllVaccines;2792;3210;6002;681519;330234;1011753
2022.07_16-08-2022;Тверская область;45_75_days;CoviVac;132;29;161;681519;330234;1011753
2022.07_16-08-2022;Тверская область;45_75_days;EpiVacCorona;270;304;574;681519;330234;1011753
2022.07_16-08-2022;Тверская область;45_75_days;SputnikLite;708;826;1534;681519;330234;1011753
2022.07_16-08-2022;Тверская область;45_75_days;SputnikV;1682;2051;3733;681519;330234;1011753
2022.07_16-08-2022;Тверская область;75_90_days;AllVaccines;1885;1981;3866;681519;330234;1011753
2022.07_16-08-2022;Тверская область;75_90_days;CoviVac;79;15;94;681519;330234;1011753
2022.07_16-08-2022;Тверская область;75_90_days;EpiVacCorona;116;121;237;681519;330234;1011753
2022.07_16-08-2022;Тверская область;75_90_days;SputnikLite;514;713;1227;681519;330234;1011753
2022.07_16-08-2022;Тверская область;75_90_days;SputnikV;1176;1132;2308;681519;330234;1011753
2022.07_16-08-2022;Тверская область;90_105_days;AllVaccines;2276;2464;4740;681519;330234;1011753
2022.07_16-08-2022;Тверская область;90_105_days;CoviVac;180;41;221;681519;330234;1011753
2022.07_16-08-2022;Тверская область;90_105_days;EpiVacCorona;76;85;161;681519;330234;1011753
2022.07_16-08-2022;Тверская область;90_105_days;SputnikLite;731;1044;1775;681519;330234;1011753
2022.07_16-08-2022;Тверская область;90_105_days;SputnikV;1289;1294;2583;681519;330234;1011753
2022.07_16-08-2022;Томская область;105_165_days;AllVaccines;31688;14950;46638;621613;222482;844095
2022.07_16-08-2022;Томская область;105_165_days;CoviVac;528;52;580;621613;222482;844095
2022.07_16-08-2022;Томская область;105_165_days;EpiVacCorona;1845;736;2581;621613;222482;844095
2022.07_16-08-2022;Томская область;105_165_days;SputnikLite;16008;7348;23356;621613;222482;844095
2022.07_16-08-2022;Томская область;105_165_days;SputnikV;13307;6814;20121;621613;222482;844095
2022.07_16-08-2022;Томская область;165_195_days;AllVaccines;26675;11775;38450;621613;222482;844095
2022.07_16-08-2022;Томская область;165_195_days;CoviVac;324;56;380;621613;222482;844095
2022.07_16-08-2022;Томская область;165_195_days;EpiVacCorona;1193;481;1674;621613;222482;844095
2022.07_16-08-2022;Томская область;165_195_days;SputnikLite;16544;8860;25404;621613;222482;844095
2022.07_16-08-2022;Томская область;165_195_days;SputnikV;8614;2378;10992;621613;222482;844095
2022.07_16-08-2022;Томская область;21_45_days;AllVaccines;2922;1754;4676;621613;222482;844095
2022.07_16-08-2022;Томская область;21_45_days;CoviVac;163;14;177;621613;222482;844095
2022.07_16-08-2022;Томская область;21_45_days;EpiVacCorona;86;36;122;621613;222482;844095
2022.07_16-08-2022;Томская область;21_45_days;SputnikLite;869;582;1451;621613;222482;844095
2022.07_16-08-2022;Томская область;21_45_days;SputnikV;1804;1122;2926;621613;222482;844095
2022.07_16-08-2022;Томская область;45_75_days;AllVaccines;3036;2219;5255;621613;222482;844095
2022.07_16-08-2022;Томская область;45_75_days;CoviVac;203;80;283;621613;222482;844095
2022.07_16-08-2022;Томская область;45_75_days;EpiVacCorona;190;229;419;621613;222482;844095
2022.07_16-08-2022;Томская область;45_75_days;SputnikLite;1000;716;1716;621613;222482;844095
2022.07_16-08-2022;Томская область;45_75_days;SputnikV;1643;1194;2837;621613;222482;844095
2022.07_16-08-2022;Томская область;75_90_days;AllVaccines;1669;1191;2860;621613;222482;844095
2022.07_16-08-2022;Томская область;75_90_days;CoviVac;79;20;99;621613;222482;844095
2022.07_16-08-2022;Томская область;75_90_days;EpiVacCorona;130;62;192;621613;222482;844095
2022.07_16-08-2022;Томская область;75_90_days;SputnikLite;463;387;850;621613;222482;844095
2022.07_16-08-2022;Томская область;75_90_days;SputnikV;997;722;1719;621613;222482;844095
2022.07_16-08-2022;Томская область;90_105_days;AllVaccines;2426;1696;4122;621613;222482;844095
2022.07_16-08-2022;Томская область;90_105_days;CoviVac;96;6;102;621613;222482;844095
2022.07_16-08-2022;Томская область;90_105_days;EpiVacCorona;157;77;234;621613;222482;844095
2022.07_16-08-2022;Томская область;90_105_days;SputnikLite;552;401;953;621613;222482;844095
2022.07_16-08-2022;Томская область;90_105_days;SputnikV;1621;1212;2833;621613;222482;844095
2022.07_16-08-2022;Тульская область;105_165_days;AllVaccines;45773;20102;65875;804510;401385;1205895
2022.07_16-08-2022;Тульская область;105_165_days;CoviVac;677;173;850;804510;401385;1205895
2022.07_16-08-2022;Тульская область;105_165_days;EpiVacCorona;3079;1697;4776;804510;401385;1205895
2022.07_16-08-2022;Тульская область;105_165_days;SputnikLite;16294;5900;22194;804510;401385;1205895
2022.07_16-08-2022;Тульская область;105_165_days;SputnikV;25723;12332;38055;804510;401385;1205895
2022.07_16-08-2022;Тульская область;165_195_days;AllVaccines;35651;17613;53264;804510;401385;1205895
2022.07_16-08-2022;Тульская область;165_195_days;CoviVac;265;108;373;804510;401385;1205895
2022.07_16-08-2022;Тульская область;165_195_days;EpiVacCorona;863;886;1749;804510;401385;1205895
2022.07_16-08-2022;Тульская область;165_195_days;SputnikLite;27688;12629;40317;804510;401385;1205895
2022.07_16-08-2022;Тульская область;165_195_days;SputnikV;6835;3990;10825;804510;401385;1205895
2022.07_16-08-2022;Тульская область;21_45_days;AllVaccines;4764;3789;8553;804510;401385;1205895
2022.07_16-08-2022;Тульская область;21_45_days;CoviVac;307;135;442;804510;401385;1205895
2022.07_16-08-2022;Тульская область;21_45_days;EpiVacCorona;252;290;542;804510;401385;1205895
2022.07_16-08-2022;Тульская область;21_45_days;SputnikLite;8;0;8;804510;401385;1205895
2022.07_16-08-2022;Тульская область;21_45_days;SputnikV;4197;3364;7561;804510;401385;1205895
2022.07_16-08-2022;Тульская область;45_75_days;AllVaccines;4437;3261;7698;804510;401385;1205895
2022.07_16-08-2022;Тульская область;45_75_days;CoviVac;205;99;304;804510;401385;1205895
2022.07_16-08-2022;Тульская область;45_75_days;EpiVacCorona;266;233;499;804510;401385;1205895
2022.07_16-08-2022;Тульская область;45_75_days;SputnikLite;110;11;121;804510;401385;1205895
2022.07_16-08-2022;Тульская область;45_75_days;SputnikV;3856;2918;6774;804510;401385;1205895
2022.07_16-08-2022;Тульская область;75_90_days;AllVaccines;2709;1871;4580;804510;401385;1205895
2022.07_16-08-2022;Тульская область;75_90_days;CoviVac;92;51;143;804510;401385;1205895
2022.07_16-08-2022;Тульская область;75_90_days;EpiVacCorona;242;195;437;804510;401385;1205895
2022.07_16-08-2022;Тульская область;75_90_days;SputnikLite;40;21;61;804510;401385;1205895
2022.07_16-08-2022;Тульская область;75_90_days;SputnikV;2335;1604;3939;804510;401385;1205895
2022.07_16-08-2022;Тульская область;90_105_days;AllVaccines;4192;2326;6518;804510;401385;1205895
2022.07_16-08-2022;Тульская область;90_105_days;CoviVac;64;17;81;804510;401385;1205895
2022.07_16-08-2022;Тульская область;90_105_days;EpiVacCorona;466;226;692;804510;401385;1205895
2022.07_16-08-2022;Тульская область;90_105_days;SputnikLite;133;79;212;804510;401385;1205895
2022.07_16-08-2022;Тульская область;90_105_days;SputnikV;3529;2004;5533;804510;401385;1205895
2022.07_16-08-2022;Тюменская область;105_165_days;AllVaccines;49567;19850;69417;870789;301209;1171998
2022.07_16-08-2022;Тюменская область;105_165_days;CoviVac;408;114;522;870789;301209;1171998
2022.07_16-08-2022;Тюменская область;105_165_days;EpiVacCorona;1257;598;1855;870789;301209;1171998
2022.07_16-08-2022;Тюменская область;105_165_days;SputnikLite;26953;10074;37027;870789;301209;1171998
2022.07_16-08-2022;Тюменская область;105_165_days;SputnikV;20949;9064;30013;870789;301209;1171998
2022.07_16-08-2022;Тюменская область;165_195_days;AllVaccines;53513;22732;76245;870789;301209;1171998
2022.07_16-08-2022;Тюменская область;165_195_days;CoviVac;170;47;217;870789;301209;1171998
2022.07_16-08-2022;Тюменская область;165_195_days;EpiVacCorona;130;81;211;870789;301209;1171998
2022.07_16-08-2022;Тюменская область;165_195_days;SputnikLite;41722;18855;60577;870789;301209;1171998
2022.07_16-08-2022;Тюменская область;165_195_days;SputnikV;11491;3749;15240;870789;301209;1171998
2022.07_16-08-2022;Тюменская область;21_45_days;AllVaccines;4199;2658;6857;870789;301209;1171998
2022.07_16-08-2022;Тюменская область;21_45_days;CoviVac;60;25;85;870789;301209;1171998
2022.07_16-08-2022;Тюменская область;21_45_days;EpiVacCorona;159;91;250;870789;301209;1171998
2022.07_16-08-2022;Тюменская область;21_45_days;SputnikLite;145;57;202;870789;301209;1171998
2022.07_16-08-2022;Тюменская область;21_45_days;SputnikV;3835;2485;6320;870789;301209;1171998
2022.07_16-08-2022;Тюменская область;45_75_days;AllVaccines;4540;2693;7233;870789;301209;1171998
2022.07_16-08-2022;Тюменская область;45_75_days;CoviVac;129;50;179;870789;301209;1171998
2022.07_16-08-2022;Тюменская область;45_75_days;EpiVacCorona;182;76;258;870789;301209;1171998
2022.07_16-08-2022;Тюменская область;45_75_days;SputnikLite;351;112;463;870789;301209;1171998
2022.07_16-08-2022;Тюменская область;45_75_days;SputnikV;3878;2455;6333;870789;301209;1171998
2022.07_16-08-2022;Тюменская область;75_90_days;AllVaccines;3056;1605;4661;870789;301209;1171998
2022.07_16-08-2022;Тюменская область;75_90_days;CoviVac;229;66;295;870789;301209;1171998
2022.07_16-08-2022;Тюменская область;75_90_days;EpiVacCorona;266;87;353;870789;301209;1171998
2022.07_16-08-2022;Тюменская область;75_90_days;SputnikLite;417;84;501;870789;301209;1171998
2022.07_16-08-2022;Тюменская область;75_90_days;SputnikV;2144;1368;3512;870789;301209;1171998
2022.07_16-08-2022;Тюменская область;90_105_days;AllVaccines;3980;1839;5819;870789;301209;1171998
2022.07_16-08-2022;Тюменская область;90_105_days;CoviVac;170;51;221;870789;301209;1171998
2022.07_16-08-2022;Тюменская область;90_105_days;EpiVacCorona;334;110;444;870789;301209;1171998
2022.07_16-08-2022;Тюменская область;90_105_days;SputnikLite;819;285;1104;870789;301209;1171998
2022.07_16-08-2022;Тюменская область;90_105_days;SputnikV;2657;1393;4050;870789;301209;1171998
2022.07_16-08-2022;Удмуртская Республика;105_165_days;AllVaccines;36186;21170;57356;818861;336450;1155311
2022.07_16-08-2022;Удмуртская Республика;105_165_days;CoviVac;722;141;863;818861;336450;1155311
2022.07_16-08-2022;Удмуртская Республика;105_165_days;EpiVacCorona;2126;1667;3793;818861;336450;1155311
2022.07_16-08-2022;Удмуртская Республика;105_165_days;SputnikLite;13890;7942;21832;818861;336450;1155311
2022.07_16-08-2022;Удмуртская Республика;105_165_days;SputnikV;19448;11420;30868;818861;336450;1155311
2022.07_16-08-2022;Удмуртская Республика;165_195_days;AllVaccines;27536;16930;44466;818861;336450;1155311
2022.07_16-08-2022;Удмуртская Республика;165_195_days;CoviVac;421;85;506;818861;336450;1155311
2022.07_16-08-2022;Удмуртская Республика;165_195_days;EpiVacCorona;1063;899;1962;818861;336450;1155311
2022.07_16-08-2022;Удмуртская Республика;165_195_days;SputnikLite;16554;12178;28732;818861;336450;1155311
2022.07_16-08-2022;Удмуртская Республика;165_195_days;SputnikV;9498;3768;13266;818861;336450;1155311
2022.07_16-08-2022;Удмуртская Республика;21_45_days;AllVaccines;3995;3619;7614;818861;336450;1155311
2022.07_16-08-2022;Удмуртская Республика;21_45_days;CoviVac;293;59;352;818861;336450;1155311
2022.07_16-08-2022;Удмуртская Республика;21_45_days;EpiVacCorona;341;459;800;818861;336450;1155311
2022.07_16-08-2022;Удмуртская Республика;21_45_days;SputnikLite;105;63;168;818861;336450;1155311
2022.07_16-08-2022;Удмуртская Республика;21_45_days;SputnikV;3256;3038;6294;818861;336450;1155311
2022.07_16-08-2022;Удмуртская Республика;45_75_days;AllVaccines;3963;3120;7083;818861;336450;1155311
2022.07_16-08-2022;Удмуртская Республика;45_75_days;CoviVac;400;140;540;818861;336450;1155311
2022.07_16-08-2022;Удмуртская Республика;45_75_days;EpiVacCorona;568;413;981;818861;336450;1155311
2022.07_16-08-2022;Удмуртская Республика;45_75_days;SputnikLite;198;137;335;818861;336450;1155311
2022.07_16-08-2022;Удмуртская Республика;45_75_days;SputnikV;2797;2430;5227;818861;336450;1155311
2022.07_16-08-2022;Удмуртская Республика;75_90_days;AllVaccines;3041;2126;5167;818861;336450;1155311
2022.07_16-08-2022;Удмуртская Республика;75_90_days;CoviVac;689;172;861;818861;336450;1155311
2022.07_16-08-2022;Удмуртская Республика;75_90_days;EpiVacCorona;289;327;616;818861;336450;1155311
2022.07_16-08-2022;Удмуртская Республика;75_90_days;SputnikLite;226;123;349;818861;336450;1155311
2022.07_16-08-2022;Удмуртская Республика;75_90_days;SputnikV;1837;1504;3341;818861;336450;1155311
2022.07_16-08-2022;Удмуртская Республика;90_105_days;AllVaccines;3066;2218;5284;818861;336450;1155311
2022.07_16-08-2022;Удмуртская Республика;90_105_days;CoviVac;357;134;491;818861;336450;1155311
2022.07_16-08-2022;Удмуртская Республика;90_105_days;EpiVacCorona;306;251;557;818861;336450;1155311
2022.07_16-08-2022;Удмуртская Республика;90_105_days;SputnikLite;367;252;619;818861;336450;1155311
2022.07_16-08-2022;Удмуртская Республика;90_105_days;SputnikV;2036;1581;3617;818861;336450;1155311
2022.07_16-08-2022;Ульяновская область;105_165_days;AllVaccines;23897;12452;36349;672149;320065;992214
2022.07_16-08-2022;Ульяновская область;105_165_days;CoviVac;315;97;412;672149;320065;992214
2022.07_16-08-2022;Ульяновская область;105_165_days;EpiVacCorona;1511;891;2402;672149;320065;992214
2022.07_16-08-2022;Ульяновская область;105_165_days;SputnikLite;9843;4642;14485;672149;320065;992214
2022.07_16-08-2022;Ульяновская область;105_165_days;SputnikV;12228;6822;19050;672149;320065;992214
2022.07_16-08-2022;Ульяновская область;165_195_days;AllVaccines;24315;13087;37402;672149;320065;992214
2022.07_16-08-2022;Ульяновская область;165_195_days;CoviVac;194;52;246;672149;320065;992214
2022.07_16-08-2022;Ульяновская область;165_195_days;EpiVacCorona;695;430;1125;672149;320065;992214
2022.07_16-08-2022;Ульяновская область;165_195_days;SputnikLite;16400;9708;26108;672149;320065;992214
2022.07_16-08-2022;Ульяновская область;165_195_days;SputnikV;7026;2897;9923;672149;320065;992214
2022.07_16-08-2022;Ульяновская область;21_45_days;AllVaccines;2661;2311;4972;672149;320065;992214
2022.07_16-08-2022;Ульяновская область;21_45_days;CoviVac;194;175;369;672149;320065;992214
2022.07_16-08-2022;Ульяновская область;21_45_days;EpiVacCorona;198;172;370;672149;320065;992214
2022.07_16-08-2022;Ульяновская область;21_45_days;SputnikLite;193;90;283;672149;320065;992214
2022.07_16-08-2022;Ульяновская область;21_45_days;SputnikV;2076;1874;3950;672149;320065;992214
2022.07_16-08-2022;Ульяновская область;45_75_days;AllVaccines;3179;3004;6183;672149;320065;992214
2022.07_16-08-2022;Ульяновская область;45_75_days;CoviVac;214;181;395;672149;320065;992214
2022.07_16-08-2022;Ульяновская область;45_75_days;EpiVacCorona;408;331;739;672149;320065;992214
2022.07_16-08-2022;Ульяновская область;45_75_days;SputnikLite;230;114;344;672149;320065;992214
2022.07_16-08-2022;Ульяновская область;45_75_days;SputnikV;2327;2378;4705;672149;320065;992214
2022.07_16-08-2022;Ульяновская область;75_90_days;AllVaccines;2095;1412;3507;672149;320065;992214
2022.07_16-08-2022;Ульяновская область;75_90_days;CoviVac;53;10;63;672149;320065;992214
2022.07_16-08-2022;Ульяновская область;75_90_days;EpiVacCorona;92;62;154;672149;320065;992214
2022.07_16-08-2022;Ульяновская область;75_90_days;SputnikLite;170;105;275;672149;320065;992214
2022.07_16-08-2022;Ульяновская область;75_90_days;SputnikV;1780;1235;3015;672149;320065;992214
2022.07_16-08-2022;Ульяновская область;90_105_days;AllVaccines;2349;1534;3883;672149;320065;992214
2022.07_16-08-2022;Ульяновская область;90_105_days;CoviVac;92;31;123;672149;320065;992214
2022.07_16-08-2022;Ульяновская область;90_105_days;EpiVacCorona;123;73;196;672149;320065;992214
2022.07_16-08-2022;Ульяновская область;90_105_days;SputnikLite;238;168;406;672149;320065;992214
2022.07_16-08-2022;Ульяновская область;90_105_days;SputnikV;1896;1262;3158;672149;320065;992214
2022.07_16-08-2022;Хабаровский край;105_165_days;AllVaccines;34551;15980;50531;757169;265178;1022347
2022.07_16-08-2022;Хабаровский край;105_165_days;CoviVac;601;168;769;757169;265178;1022347
2022.07_16-08-2022;Хабаровский край;105_165_days;EpiVacCorona;2409;1082;3491;757169;265178;1022347
2022.07_16-08-2022;Хабаровский край;105_165_days;SputnikLite;14031;5676;19707;757169;265178;1022347
2022.07_16-08-2022;Хабаровский край;105_165_days;SputnikV;17510;9054;26564;757169;265178;1022347
2022.07_16-08-2022;Хабаровский край;165_195_days;AllVaccines;31285;14220;45505;757169;265178;1022347
2022.07_16-08-2022;Хабаровский край;165_195_days;CoviVac;438;79;517;757169;265178;1022347
2022.07_16-08-2022;Хабаровский край;165_195_days;EpiVacCorona;1959;762;2721;757169;265178;1022347
2022.07_16-08-2022;Хабаровский край;165_195_days;SputnikLite;15579;8382;23961;757169;265178;1022347
2022.07_16-08-2022;Хабаровский край;165_195_days;SputnikV;13309;4997;18306;757169;265178;1022347
2022.07_16-08-2022;Хабаровский край;21_45_days;AllVaccines;5139;3355;8494;757169;265178;1022347
2022.07_16-08-2022;Хабаровский край;21_45_days;CoviVac;250;60;310;757169;265178;1022347
2022.07_16-08-2022;Хабаровский край;21_45_days;EpiVacCorona;1301;978;2279;757169;265178;1022347
2022.07_16-08-2022;Хабаровский край;21_45_days;SputnikLite;291;143;434;757169;265178;1022347
2022.07_16-08-2022;Хабаровский край;21_45_days;SputnikV;3297;2174;5471;757169;265178;1022347
2022.07_16-08-2022;Хабаровский край;45_75_days;AllVaccines;4031;2555;6586;757169;265178;1022347
2022.07_16-08-2022;Хабаровский край;45_75_days;CoviVac;278;174;452;757169;265178;1022347
2022.07_16-08-2022;Хабаровский край;45_75_days;EpiVacCorona;876;626;1502;757169;265178;1022347
2022.07_16-08-2022;Хабаровский край;45_75_days;SputnikLite;500;254;754;757169;265178;1022347
2022.07_16-08-2022;Хабаровский край;45_75_days;SputnikV;2377;1501;3878;757169;265178;1022347
2022.07_16-08-2022;Хабаровский край;75_90_days;AllVaccines;2288;1521;3809;757169;265178;1022347
2022.07_16-08-2022;Хабаровский край;75_90_days;CoviVac;54;18;72;757169;265178;1022347
2022.07_16-08-2022;Хабаровский край;75_90_days;EpiVacCorona;248;265;513;757169;265178;1022347
2022.07_16-08-2022;Хабаровский край;75_90_days;SputnikLite;625;226;851;757169;265178;1022347
2022.07_16-08-2022;Хабаровский край;75_90_days;SputnikV;1361;1012;2373;757169;265178;1022347
2022.07_16-08-2022;Хабаровский край;90_105_days;AllVaccines;2494;1668;4162;757169;265178;1022347
2022.07_16-08-2022;Хабаровский край;90_105_days;CoviVac;54;26;80;757169;265178;1022347
2022.07_16-08-2022;Хабаровский край;90_105_days;EpiVacCorona;234;128;362;757169;265178;1022347
2022.07_16-08-2022;Хабаровский край;90_105_days;SputnikLite;402;176;578;757169;265178;1022347
2022.07_16-08-2022;Хабаровский край;90_105_days;SputnikV;1804;1338;3142;757169;265178;1022347
2022.07_16-08-2022;Ханты-Мансийский автономный округ - Югра;105_165_days;AllVaccines;63804;12452;76256;1019471;240107;1259578
2022.07_16-08-2022;Ханты-Мансийский автономный округ - Югра;105_165_days;CoviVac;515;88;603;1019471;240107;1259578
2022.07_16-08-2022;Ханты-Мансийский автономный округ - Югра;105_165_days;EpiVacCorona;834;219;1053;1019471;240107;1259578
2022.07_16-08-2022;Ханты-Мансийский автономный округ - Югра;105_165_days;SputnikLite;34530;6189;40719;1019471;240107;1259578
2022.07_16-08-2022;Ханты-Мансийский автономный округ - Югра;105_165_days;SputnikV;27925;5956;33881;1019471;240107;1259578
2022.07_16-08-2022;Ханты-Мансийский автономный округ - Югра;165_195_days;AllVaccines;52721;12858;65579;1019471;240107;1259578
2022.07_16-08-2022;Ханты-Мансийский автономный округ - Югра;165_195_days;CoviVac;245;59;304;1019471;240107;1259578
2022.07_16-08-2022;Ханты-Мансийский автономный округ - Югра;165_195_days;EpiVacCorona;642;199;841;1019471;240107;1259578
2022.07_16-08-2022;Ханты-Мансийский автономный округ - Югра;165_195_days;SputnikLite;38278;9677;47955;1019471;240107;1259578
2022.07_16-08-2022;Ханты-Мансийский автономный округ - Югра;165_195_days;SputnikV;13556;2923;16479;1019471;240107;1259578
2022.07_16-08-2022;Ханты-Мансийский автономный округ - Югра;21_45_days;AllVaccines;7419;1591;9010;1019471;240107;1259578
2022.07_16-08-2022;Ханты-Мансийский автономный округ - Югра;21_45_days;CoviVac;113;14;127;1019471;240107;1259578
2022.07_16-08-2022;Ханты-Мансийский автономный округ - Югра;21_45_days;EpiVacCorona;577;116;693;1019471;240107;1259578
2022.07_16-08-2022;Ханты-Мансийский автономный округ - Югра;21_45_days;SputnikLite;128;17;145;1019471;240107;1259578
2022.07_16-08-2022;Ханты-Мансийский автономный округ - Югра;21_45_days;SputnikV;6601;1444;8045;1019471;240107;1259578
2022.07_16-08-2022;Ханты-Мансийский автономный округ - Югра;45_75_days;AllVaccines;7709;1649;9358;1019471;240107;1259578
2022.07_16-08-2022;Ханты-Мансийский автономный округ - Югра;45_75_days;CoviVac;148;25;173;1019471;240107;1259578
2022.07_16-08-2022;Ханты-Мансийский автономный округ - Югра;45_75_days;EpiVacCorona;547;121;668;1019471;240107;1259578
2022.07_16-08-2022;Ханты-Мансийский автономный округ - Югра;45_75_days;SputnikLite;598;149;747;1019471;240107;1259578
2022.07_16-08-2022;Ханты-Мансийский автономный округ - Югра;45_75_days;SputnikV;6416;1354;7770;1019471;240107;1259578
2022.07_16-08-2022;Ханты-Мансийский автономный округ - Югра;75_90_days;AllVaccines;4645;913;5558;1019471;240107;1259578
2022.07_16-08-2022;Ханты-Мансийский автономный округ - Югра;75_90_days;CoviVac;202;14;216;1019471;240107;1259578
2022.07_16-08-2022;Ханты-Мансийский автономный округ - Югра;75_90_days;EpiVacCorona;328;103;431;1019471;240107;1259578
2022.07_16-08-2022;Ханты-Мансийский автономный округ - Югра;75_90_days;SputnikLite;423;84;507;1019471;240107;1259578
2022.07_16-08-2022;Ханты-Мансийский автономный округ - Югра;75_90_days;SputnikV;3692;712;4404;1019471;240107;1259578
2022.07_16-08-2022;Ханты-Мансийский автономный округ - Югра;90_105_days;AllVaccines;5637;1263;6900;1019471;240107;1259578
2022.07_16-08-2022;Ханты-Мансийский автономный округ - Югра;90_105_days;CoviVac;158;27;185;1019471;240107;1259578
2022.07_16-08-2022;Ханты-Мансийский автономный округ - Югра;90_105_days;EpiVacCorona;249;55;304;1019471;240107;1259578
2022.07_16-08-2022;Ханты-Мансийский автономный округ - Югра;90_105_days;SputnikLite;859;175;1034;1019471;240107;1259578
2022.07_16-08-2022;Ханты-Мансийский автономный округ - Югра;90_105_days;SputnikV;4371;1006;5377;1019471;240107;1259578
2022.07_16-08-2022;Челябинская область;105_165_days;AllVaccines;87529;45004;132533;1901705;795956;2697661
2022.07_16-08-2022;Челябинская область;105_165_days;CoviVac;724;161;885;1901705;795956;2697661
2022.07_16-08-2022;Челябинская область;105_165_days;EpiVacCorona;4990;4368;9358;1901705;795956;2697661
2022.07_16-08-2022;Челябинская область;105_165_days;SputnikLite;44428;19214;63642;1901705;795956;2697661
2022.07_16-08-2022;Челябинская область;105_165_days;SputnikV;37387;21261;58648;1901705;795956;2697661
2022.07_16-08-2022;Челябинская область;165_195_days;AllVaccines;72303;39431;111734;1901705;795956;2697661
2022.07_16-08-2022;Челябинская область;165_195_days;CoviVac;417;155;572;1901705;795956;2697661
2022.07_16-08-2022;Челябинская область;165_195_days;EpiVacCorona;1960;1545;3505;1901705;795956;2697661
2022.07_16-08-2022;Челябинская область;165_195_days;SputnikLite;50568;28435;79003;1901705;795956;2697661
2022.07_16-08-2022;Челябинская область;165_195_days;SputnikV;19358;9296;28654;1901705;795956;2697661
2022.07_16-08-2022;Челябинская область;21_45_days;AllVaccines;12446;9725;22171;1901705;795956;2697661
2022.07_16-08-2022;Челябинская область;21_45_days;CoviVac;618;170;788;1901705;795956;2697661
2022.07_16-08-2022;Челябинская область;21_45_days;EpiVacCorona;1181;778;1959;1901705;795956;2697661
2022.07_16-08-2022;Челябинская область;21_45_days;SputnikLite;1756;665;2421;1901705;795956;2697661
2022.07_16-08-2022;Челябинская область;21_45_days;SputnikV;8891;8112;17003;1901705;795956;2697661
2022.07_16-08-2022;Челябинская область;45_75_days;AllVaccines;14621;11158;25779;1901705;795956;2697661
2022.07_16-08-2022;Челябинская область;45_75_days;CoviVac;742;385;1127;1901705;795956;2697661
2022.07_16-08-2022;Челябинская область;45_75_days;EpiVacCorona;1287;798;2085;1901705;795956;2697661
2022.07_16-08-2022;Челябинская область;45_75_days;SputnikLite;4419;2329;6748;1901705;795956;2697661
2022.07_16-08-2022;Челябинская область;45_75_days;SputnikV;8173;7646;15819;1901705;795956;2697661
2022.07_16-08-2022;Челябинская область;75_90_days;AllVaccines;9059;6489;15548;1901705;795956;2697661
2022.07_16-08-2022;Челябинская область;75_90_days;CoviVac;375;163;538;1901705;795956;2697661
2022.07_16-08-2022;Челябинская область;75_90_days;EpiVacCorona;750;475;1225;1901705;795956;2697661
2022.07_16-08-2022;Челябинская область;75_90_days;SputnikLite;3293;1882;5175;1901705;795956;2697661
2022.07_16-08-2022;Челябинская область;75_90_days;SputnikV;4641;3969;8610;1901705;795956;2697661
2022.07_16-08-2022;Челябинская область;90_105_days;AllVaccines;10596;6795;17391;1901705;795956;2697661
2022.07_16-08-2022;Челябинская область;90_105_days;CoviVac;578;124;702;1901705;795956;2697661
2022.07_16-08-2022;Челябинская область;90_105_days;EpiVacCorona;705;526;1231;1901705;795956;2697661
2022.07_16-08-2022;Челябинская область;90_105_days;SputnikLite;4501;2742;7243;1901705;795956;2697661
2022.07_16-08-2022;Челябинская область;90_105_days;SputnikV;4812;3403;8215;1901705;795956;2697661
2022.07_16-08-2022;Чеченская Республика;105_165_days;AllVaccines;38491;5976;44467;809759;137234;946993
2022.07_16-08-2022;Чеченская Республика;105_165_days;CoviVac;3652;674;4326;809759;137234;946993
2022.07_16-08-2022;Чеченская Республика;105_165_days;EpiVacCorona;936;126;1062;809759;137234;946993
2022.07_16-08-2022;Чеченская Республика;105_165_days;SputnikLite;20845;2960;23805;809759;137234;946993
2022.07_16-08-2022;Чеченская Республика;105_165_days;SputnikV;13058;2216;15274;809759;137234;946993
2022.07_16-08-2022;Чеченская Республика;165_195_days;AllVaccines;17993;2479;20472;809759;137234;946993
2022.07_16-08-2022;Чеченская Республика;165_195_days;CoviVac;19;8;27;809759;137234;946993
2022.07_16-08-2022;Чеченская Республика;165_195_days;EpiVacCorona;494;104;598;809759;137234;946993
2022.07_16-08-2022;Чеченская Республика;165_195_days;SputnikLite;15861;2116;17977;809759;137234;946993
2022.07_16-08-2022;Чеченская Республика;165_195_days;SputnikV;1619;251;1870;809759;137234;946993
2022.07_16-08-2022;Чеченская Республика;21_45_days;AllVaccines;18323;3958;22281;809759;137234;946993
2022.07_16-08-2022;Чеченская Республика;21_45_days;CoviVac;83;19;102;809759;137234;946993
2022.07_16-08-2022;Чеченская Республика;21_45_days;EpiVacCorona;6;0;6;809759;137234;946993
2022.07_16-08-2022;Чеченская Республика;21_45_days;SputnikLite;466;39;505;809759;137234;946993
2022.07_16-08-2022;Чеченская Республика;21_45_days;SputnikV;17768;3900;21668;809759;137234;946993
2022.07_16-08-2022;Чеченская Республика;45_75_days;AllVaccines;7145;1357;8502;809759;137234;946993
2022.07_16-08-2022;Чеченская Республика;45_75_days;CoviVac;160;36;196;809759;137234;946993
2022.07_16-08-2022;Чеченская Республика;45_75_days;EpiVacCorona;3;0;3;809759;137234;946993
2022.07_16-08-2022;Чеченская Республика;45_75_days;SputnikLite;539;52;591;809759;137234;946993
2022.07_16-08-2022;Чеченская Республика;45_75_days;SputnikV;6443;1269;7712;809759;137234;946993
2022.07_16-08-2022;Чеченская Республика;75_90_days;AllVaccines;6266;963;7229;809759;137234;946993
2022.07_16-08-2022;Чеченская Республика;75_90_days;CoviVac;348;72;420;809759;137234;946993
2022.07_16-08-2022;Чеченская Республика;75_90_days;EpiVacCorona;24;0;24;809759;137234;946993
2022.07_16-08-2022;Чеченская Республика;75_90_days;SputnikLite;4205;552;4757;809759;137234;946993
2022.07_16-08-2022;Чеченская Республика;75_90_days;SputnikV;1689;339;2028;809759;137234;946993
2022.07_16-08-2022;Чеченская Республика;90_105_days;AllVaccines;5916;1015;6931;809759;137234;946993
2022.07_16-08-2022;Чеченская Республика;90_105_days;CoviVac;430;75;505;809759;137234;946993
2022.07_16-08-2022;Чеченская Республика;90_105_days;EpiVacCorona;16;2;18;809759;137234;946993
2022.07_16-08-2022;Чеченская Республика;90_105_days;SputnikLite;3775;647;4422;809759;137234;946993
2022.07_16-08-2022;Чеченская Республика;90_105_days;SputnikV;1695;291;1986;809759;137234;946993
2022.07_16-08-2022;Чувашская Республика;105_165_days;AllVaccines;36479;18447;54926;674689;275580;950269
2022.07_16-08-2022;Чувашская Республика;105_165_days;CoviVac;618;102;720;674689;275580;950269
2022.07_16-08-2022;Чувашская Республика;105_165_days;EpiVacCorona;2306;1250;3556;674689;275580;950269
2022.07_16-08-2022;Чувашская Республика;105_165_days;SputnikLite;16039;7436;23475;674689;275580;950269
2022.07_16-08-2022;Чувашская Республика;105_165_days;SputnikV;17516;9659;27175;674689;275580;950269
2022.07_16-08-2022;Чувашская Республика;165_195_days;AllVaccines;28299;12926;41225;674689;275580;950269
2022.07_16-08-2022;Чувашская Республика;165_195_days;CoviVac;450;85;535;674689;275580;950269
2022.07_16-08-2022;Чувашская Республика;165_195_days;EpiVacCorona;802;463;1265;674689;275580;950269
2022.07_16-08-2022;Чувашская Республика;165_195_days;SputnikLite;16394;8313;24707;674689;275580;950269
2022.07_16-08-2022;Чувашская Республика;165_195_days;SputnikV;10653;4065;14718;674689;275580;950269
2022.07_16-08-2022;Чувашская Республика;21_45_days;AllVaccines;6217;4456;10673;674689;275580;950269
2022.07_16-08-2022;Чувашская Республика;21_45_days;CoviVac;12;3;15;674689;275580;950269
2022.07_16-08-2022;Чувашская Республика;21_45_days;EpiVacCorona;3126;2192;5318;674689;275580;950269
2022.07_16-08-2022;Чувашская Республика;21_45_days;SputnikLite;160;63;223;674689;275580;950269
2022.07_16-08-2022;Чувашская Республика;21_45_days;SputnikV;2919;2198;5117;674689;275580;950269
2022.07_16-08-2022;Чувашская Республика;45_75_days;AllVaccines;5514;4790;10304;674689;275580;950269
2022.07_16-08-2022;Чувашская Республика;45_75_days;CoviVac;242;75;317;674689;275580;950269
2022.07_16-08-2022;Чувашская Республика;45_75_days;EpiVacCorona;912;607;1519;674689;275580;950269
2022.07_16-08-2022;Чувашская Республика;45_75_days;SputnikLite;1690;1347;3037;674689;275580;950269
2022.07_16-08-2022;Чувашская Республика;45_75_days;SputnikV;2670;2761;5431;674689;275580;950269
2022.07_16-08-2022;Чувашская Республика;75_90_days;AllVaccines;3312;2286;5598;674689;275580;950269
2022.07_16-08-2022;Чувашская Республика;75_90_days;CoviVac;747;275;1022;674689;275580;950269
2022.07_16-08-2022;Чувашская Республика;75_90_days;EpiVacCorona;175;193;368;674689;275580;950269
2022.07_16-08-2022;Чувашская Республика;75_90_days;SputnikLite;578;425;1003;674689;275580;950269
2022.07_16-08-2022;Чувашская Республика;75_90_days;SputnikV;1812;1393;3205;674689;275580;950269
2022.07_16-08-2022;Чувашская Республика;90_105_days;AllVaccines;3655;2252;5907;674689;275580;950269
2022.07_16-08-2022;Чувашская Республика;90_105_days;CoviVac;129;13;142;674689;275580;950269
2022.07_16-08-2022;Чувашская Республика;90_105_days;EpiVacCorona;206;96;302;674689;275580;950269
2022.07_16-08-2022;Чувашская Республика;90_105_days;SputnikLite;697;617;1314;674689;275580;950269
2022.07_16-08-2022;Чувашская Республика;90_105_days;SputnikV;2623;1526;4149;674689;275580;950269
2022.07_16-08-2022;Чукотский автономный округ;105_165_days;AllVaccines;2488;374;2862;30806;6299;37105
2022.07_16-08-2022;Чукотский автономный округ;105_165_days;CoviVac;79;7;86;30806;6299;37105
2022.07_16-08-2022;Чукотский автономный округ;105_165_days;EpiVacCorona;128;22;150;30806;6299;37105
2022.07_16-08-2022;Чукотский автономный округ;105_165_days;SputnikLite;1668;229;1897;30806;6299;37105
2022.07_16-08-2022;Чукотский автономный округ;105_165_days;SputnikV;613;116;729;30806;6299;37105
2022.07_16-08-2022;Чукотский автономный округ;165_195_days;AllVaccines;1649;239;1888;30806;6299;37105
2022.07_16-08-2022;Чукотский автономный округ;165_195_days;CoviVac;58;8;66;30806;6299;37105
2022.07_16-08-2022;Чукотский автономный округ;165_195_days;EpiVacCorona;82;10;92;30806;6299;37105
2022.07_16-08-2022;Чукотский автономный округ;165_195_days;SputnikLite;1339;189;1528;30806;6299;37105
2022.07_16-08-2022;Чукотский автономный округ;165_195_days;SputnikV;170;32;202;30806;6299;37105
2022.07_16-08-2022;Чукотский автономный округ;21_45_days;AllVaccines;204;46;250;30806;6299;37105
2022.07_16-08-2022;Чукотский автономный округ;21_45_days;CoviVac;6;7;13;30806;6299;37105
2022.07_16-08-2022;Чукотский автономный округ;21_45_days;EpiVacCorona;55;7;62;30806;6299;37105
2022.07_16-08-2022;Чукотский автономный округ;21_45_days;SputnikLite;48;10;58;30806;6299;37105
2022.07_16-08-2022;Чукотский автономный округ;21_45_days;SputnikV;95;22;117;30806;6299;37105
2022.07_16-08-2022;Чукотский автономный округ;45_75_days;AllVaccines;418;66;484;30806;6299;37105
2022.07_16-08-2022;Чукотский автономный округ;45_75_days;CoviVac;29;4;33;30806;6299;37105
2022.07_16-08-2022;Чукотский автономный округ;45_75_days;EpiVacCorona;77;10;87;30806;6299;37105
2022.07_16-08-2022;Чукотский автономный округ;45_75_days;SputnikLite;239;42;281;30806;6299;37105
2022.07_16-08-2022;Чукотский автономный округ;45_75_days;SputnikV;73;10;83;30806;6299;37105
2022.07_16-08-2022;Чукотский автономный округ;75_90_days;AllVaccines;164;46;210;30806;6299;37105
2022.07_16-08-2022;Чукотский автономный округ;75_90_days;CoviVac;12;3;15;30806;6299;37105
2022.07_16-08-2022;Чукотский автономный округ;75_90_days;EpiVacCorona;23;5;28;30806;6299;37105
2022.07_16-08-2022;Чукотский автономный округ;75_90_days;SputnikLite;95;33;128;30806;6299;37105
2022.07_16-08-2022;Чукотский автономный округ;75_90_days;SputnikV;34;5;39;30806;6299;37105
2022.07_16-08-2022;Чукотский автономный округ;90_105_days;AllVaccines;381;77;458;30806;6299;37105
2022.07_16-08-2022;Чукотский автономный округ;90_105_days;CoviVac;11;1;12;30806;6299;37105
2022.07_16-08-2022;Чукотский автономный округ;90_105_days;EpiVacCorona;3;2;5;30806;6299;37105
2022.07_16-08-2022;Чукотский автономный округ;90_105_days;SputnikLite;219;43;262;30806;6299;37105
2022.07_16-08-2022;Чукотский автономный округ;90_105_days;SputnikV;148;31;179;30806;6299;37105
2022.07_16-08-2022;Ямало-Ненецкий автономный округ;105_165_days;AllVaccines;20917;2621;23538;346064;56429;402493
2022.07_16-08-2022;Ямало-Ненецкий автономный округ;105_165_days;CoviVac;165;17;182;346064;56429;402493
2022.07_16-08-2022;Ямало-Ненецкий автономный округ;105_165_days;EpiVacCorona;419;60;479;346064;56429;402493
2022.07_16-08-2022;Ямало-Ненецкий автономный округ;105_165_days;SputnikLite;13440;1603;15043;346064;56429;402493
2022.07_16-08-2022;Ямало-Ненецкий автономный округ;105_165_days;SputnikV;6893;941;7834;346064;56429;402493
2022.07_16-08-2022;Ямало-Ненецкий автономный округ;165_195_days;AllVaccines;17825;2222;20047;346064;56429;402493
2022.07_16-08-2022;Ямало-Ненецкий автономный округ;165_195_days;CoviVac;138;26;164;346064;56429;402493
2022.07_16-08-2022;Ямало-Ненецкий автономный округ;165_195_days;EpiVacCorona;122;11;133;346064;56429;402493
2022.07_16-08-2022;Ямало-Ненецкий автономный округ;165_195_days;SputnikLite;13928;1794;15722;346064;56429;402493
2022.07_16-08-2022;Ямало-Ненецкий автономный округ;165_195_days;SputnikV;3637;391;4028;346064;56429;402493
2022.07_16-08-2022;Ямало-Ненецкий автономный округ;21_45_days;AllVaccines;3922;470;4392;346064;56429;402493
2022.07_16-08-2022;Ямало-Ненецкий автономный округ;21_45_days;CoviVac;69;4;73;346064;56429;402493
2022.07_16-08-2022;Ямало-Ненецкий автономный округ;21_45_days;EpiVacCorona;150;23;173;346064;56429;402493
2022.07_16-08-2022;Ямало-Ненецкий автономный округ;21_45_days;SputnikLite;1958;274;2232;346064;56429;402493
2022.07_16-08-2022;Ямало-Ненецкий автономный округ;21_45_days;SputnikV;1745;169;1914;346064;56429;402493
2022.07_16-08-2022;Ямало-Ненецкий автономный округ;45_75_days;AllVaccines;4218;654;4872;346064;56429;402493
2022.07_16-08-2022;Ямало-Ненецкий автономный округ;45_75_days;CoviVac;122;13;135;346064;56429;402493
2022.07_16-08-2022;Ямало-Ненецкий автономный округ;45_75_days;EpiVacCorona;74;17;91;346064;56429;402493
2022.07_16-08-2022;Ямало-Ненецкий автономный округ;45_75_days;SputnikLite;3072;492;3564;346064;56429;402493
2022.07_16-08-2022;Ямало-Ненецкий автономный округ;45_75_days;SputnikV;950;132;1082;346064;56429;402493
2022.07_16-08-2022;Ямало-Ненецкий автономный округ;75_90_days;AllVaccines;2525;331;2856;346064;56429;402493
2022.07_16-08-2022;Ямало-Ненецкий автономный округ;75_90_days;CoviVac;30;5;35;346064;56429;402493
2022.07_16-08-2022;Ямало-Ненецкий автономный округ;75_90_days;EpiVacCorona;49;4;53;346064;56429;402493
2022.07_16-08-2022;Ямало-Ненецкий автономный округ;75_90_days;SputnikLite;1921;261;2182;346064;56429;402493
2022.07_16-08-2022;Ямало-Ненецкий автономный округ;75_90_days;SputnikV;525;61;586;346064;56429;402493
2022.07_16-08-2022;Ямало-Ненецкий автономный округ;90_105_days;AllVaccines;2506;354;2860;346064;56429;402493
2022.07_16-08-2022;Ямало-Ненецкий автономный округ;90_105_days;CoviVac;34;4;38;346064;56429;402493
2022.07_16-08-2022;Ямало-Ненецкий автономный округ;90_105_days;EpiVacCorona;41;8;49;346064;56429;402493
2022.07_16-08-2022;Ямало-Ненецкий автономный округ;90_105_days;SputnikLite;1739;238;1977;346064;56429;402493
2022.07_16-08-2022;Ямало-Ненецкий автономный округ;90_105_days;SputnikV;692;104;796;346064;56429;402493
2022.07_16-08-2022;Ярославская область;105_165_days;AllVaccines;24309;12030;36339;682586;317712;1000298
2022.07_16-08-2022;Ярославская область;105_165_days;CoviVac;741;162;903;682586;317712;1000298
2022.07_16-08-2022;Ярославская область;105_165_days;EpiVacCorona;1073;451;1524;682586;317712;1000298
2022.07_16-08-2022;Ярославская область;105_165_days;SputnikLite;10266;4687;14953;682586;317712;1000298
2022.07_16-08-2022;Ярославская область;105_165_days;SputnikV;12229;6730;18959;682586;317712;1000298
2022.07_16-08-2022;Ярославская область;165_195_days;AllVaccines;24133;13612;37745;682586;317712;1000298
2022.07_16-08-2022;Ярославская область;165_195_days;CoviVac;439;132;571;682586;317712;1000298
2022.07_16-08-2022;Ярославская область;165_195_days;EpiVacCorona;473;226;699;682586;317712;1000298
2022.07_16-08-2022;Ярославская область;165_195_days;SputnikLite;15840;9603;25443;682586;317712;1000298
2022.07_16-08-2022;Ярославская область;165_195_days;SputnikV;7381;3651;11032;682586;317712;1000298
2022.07_16-08-2022;Ярославская область;21_45_days;AllVaccines;2343;1873;4216;682586;317712;1000298
2022.07_16-08-2022;Ярославская область;21_45_days;CoviVac;169;88;257;682586;317712;1000298
2022.07_16-08-2022;Ярославская область;21_45_days;EpiVacCorona;77;47;124;682586;317712;1000298
2022.07_16-08-2022;Ярославская область;21_45_days;SputnikLite;40;33;73;682586;317712;1000298
2022.07_16-08-2022;Ярославская область;21_45_days;SputnikV;2057;1705;3762;682586;317712;1000298
2022.07_16-08-2022;Ярославская область;45_75_days;AllVaccines;2285;1807;4092;682586;317712;1000298
2022.07_16-08-2022;Ярославская область;45_75_days;CoviVac;200;113;313;682586;317712;1000298
2022.07_16-08-2022;Ярославская область;45_75_days;EpiVacCorona;88;72;160;682586;317712;1000298
2022.07_16-08-2022;Ярославская область;45_75_days;SputnikLite;271;118;389;682586;317712;1000298
2022.07_16-08-2022;Ярославская область;45_75_days;SputnikV;1726;1504;3230;682586;317712;1000298
2022.07_16-08-2022;Ярославская область;75_90_days;AllVaccines;1758;1234;2992;682586;317712;1000298
2022.07_16-08-2022;Ярославская область;75_90_days;CoviVac;117;51;168;682586;317712;1000298
2022.07_16-08-2022;Ярославская область;75_90_days;EpiVacCorona;50;26;76;682586;317712;1000298
2022.07_16-08-2022;Ярославская область;75_90_days;SputnikLite;473;195;668;682586;317712;1000298
2022.07_16-08-2022;Ярославская область;75_90_days;SputnikV;1118;962;2080;682586;317712;1000298
2022.07_16-08-2022;Ярославская область;90_105_days;AllVaccines;2020;1559;3579;682586;317712;1000298
2022.07_16-08-2022;Ярославская область;90_105_days;CoviVac;84;38;122;682586;317712;1000298
2022.07_16-08-2022;Ярославская область;90_105_days;EpiVacCorona;101;63;164;682586;317712;1000298
2022.07_16-08-2022;Ярославская область;90_105_days;SputnikLite;521;288;809;682586;317712;1000298
2022.07_16-08-2022;Ярославская область;90_105_days;SputnikV;1314;1170;2484;682586;317712;1000298
2022.07_16-08-2022;г. Москва;105_165_days;AllVaccines;277461;108993;386454;7299088;3167729;10466817
2022.07_16-08-2022;г. Москва;105_165_days;CoviVac;5058;439;5497;7299088;3167729;10466817
2022.07_16-08-2022;г. Москва;105_165_days;EpiVacCorona;307;136;443;7299088;3167729;10466817
2022.07_16-08-2022;г. Москва;105_165_days;SputnikLite;129066;50009;179075;7299088;3167729;10466817
2022.07_16-08-2022;г. Москва;105_165_days;SputnikV;143030;58409;201439;7299088;3167729;10466817
2022.07_16-08-2022;г. Москва;165_195_days;AllVaccines;268393;109085;377478;7299088;3167729;10466817
2022.07_16-08-2022;г. Москва;165_195_days;CoviVac;3637;449;4086;7299088;3167729;10466817
2022.07_16-08-2022;г. Москва;165_195_days;EpiVacCorona;181;92;273;7299088;3167729;10466817
2022.07_16-08-2022;г. Москва;165_195_days;SputnikLite;194064;79312;273376;7299088;3167729;10466817
2022.07_16-08-2022;г. Москва;165_195_days;SputnikV;70511;29232;99743;7299088;3167729;10466817
2022.07_16-08-2022;г. Москва;21_45_days;AllVaccines;14556;8170;22726;7299088;3167729;10466817
2022.07_16-08-2022;г. Москва;21_45_days;CoviVac;533;30;563;7299088;3167729;10466817
2022.07_16-08-2022;г. Москва;21_45_days;EpiVacCorona;21;7;28;7299088;3167729;10466817
2022.07_16-08-2022;г. Москва;21_45_days;SputnikLite;1436;347;1783;7299088;3167729;10466817
2022.07_16-08-2022;г. Москва;21_45_days;SputnikV;12566;7786;20352;7299088;3167729;10466817
2022.07_16-08-2022;г. Москва;45_75_days;AllVaccines;14450;9638;24088;7299088;3167729;10466817
2022.07_16-08-2022;г. Москва;45_75_days;CoviVac;615;72;687;7299088;3167729;10466817
2022.07_16-08-2022;г. Москва;45_75_days;EpiVacCorona;22;12;34;7299088;3167729;10466817
2022.07_16-08-2022;г. Москва;45_75_days;SputnikLite;2097;741;2838;7299088;3167729;10466817
2022.07_16-08-2022;г. Москва;45_75_days;SputnikV;11716;8813;20529;7299088;3167729;10466817
2022.07_16-08-2022;г. Москва;75_90_days;AllVaccines;10459;6669;17128;7299088;3167729;10466817
2022.07_16-08-2022;г. Москва;75_90_days;CoviVac;484;45;529;7299088;3167729;10466817
2022.07_16-08-2022;г. Москва;75_90_days;EpiVacCorona;16;9;25;7299088;3167729;10466817
2022.07_16-08-2022;г. Москва;75_90_days;SputnikLite;2106;611;2717;7299088;3167729;10466817
2022.07_16-08-2022;г. Москва;75_90_days;SputnikV;7853;6004;13857;7299088;3167729;10466817
2022.07_16-08-2022;г. Москва;90_105_days;AllVaccines;13238;8213;21451;7299088;3167729;10466817
2022.07_16-08-2022;г. Москва;90_105_days;CoviVac;362;45;407;7299088;3167729;10466817
2022.07_16-08-2022;г. Москва;90_105_days;EpiVacCorona;9;5;14;7299088;3167729;10466817
2022.07_16-08-2022;г. Москва;90_105_days;SputnikLite;3151;861;4012;7299088;3167729;10466817
2022.07_16-08-2022;г. Москва;90_105_days;SputnikV;9716;7302;17018;7299088;3167729;10466817
2022.07_16-08-2022;г. Санкт-Петербург;105_165_days;AllVaccines;148354;54162;202516;3114778;1306302;4421080
2022.07_16-08-2022;г. Санкт-Петербург;105_165_days;CoviVac;2557;131;2688;3114778;1306302;4421080
2022.07_16-08-2022;г. Санкт-Петербург;105_165_days;EpiVacCorona;2596;1168;3764;3114778;1306302;4421080
2022.07_16-08-2022;г. Санкт-Петербург;105_165_days;SputnikLite;54126;24415;78541;3114778;1306302;4421080
2022.07_16-08-2022;г. Санкт-Петербург;105_165_days;SputnikV;89075;28448;117523;3114778;1306302;4421080
2022.07_16-08-2022;г. Санкт-Петербург;165_195_days;AllVaccines;162131;63809;225940;3114778;1306302;4421080
2022.07_16-08-2022;г. Санкт-Петербург;165_195_days;CoviVac;927;82;1009;3114778;1306302;4421080
2022.07_16-08-2022;г. Санкт-Петербург;165_195_days;EpiVacCorona;1408;619;2027;3114778;1306302;4421080
2022.07_16-08-2022;г. Санкт-Петербург;165_195_days;SputnikLite;86310;39965;126275;3114778;1306302;4421080
2022.07_16-08-2022;г. Санкт-Петербург;165_195_days;SputnikV;73486;23143;96629;3114778;1306302;4421080
2022.07_16-08-2022;г. Санкт-Петербург;21_45_days;AllVaccines;13173;5593;18766;3114778;1306302;4421080
2022.07_16-08-2022;г. Санкт-Петербург;21_45_days;CoviVac;637;65;702;3114778;1306302;4421080
2022.07_16-08-2022;г. Санкт-Петербург;21_45_days;EpiVacCorona;33;30;63;3114778;1306302;4421080
2022.07_16-08-2022;г. Санкт-Петербург;21_45_days;SputnikLite;3649;870;4519;3114778;1306302;4421080
2022.07_16-08-2022;г. Санкт-Петербург;21_45_days;SputnikV;8854;4628;13482;3114778;1306302;4421080
2022.07_16-08-2022;г. Санкт-Петербург;45_75_days;AllVaccines;13774;7184;20958;3114778;1306302;4421080
2022.07_16-08-2022;г. Санкт-Петербург;45_75_days;CoviVac;741;50;791;3114778;1306302;4421080
2022.07_16-08-2022;г. Санкт-Петербург;45_75_days;EpiVacCorona;305;89;394;3114778;1306302;4421080
2022.07_16-08-2022;г. Санкт-Петербург;45_75_days;SputnikLite;3275;791;4066;3114778;1306302;4421080
2022.07_16-08-2022;г. Санкт-Петербург;45_75_days;SputnikV;9453;6254;15707;3114778;1306302;4421080
2022.07_16-08-2022;г. Санкт-Петербург;75_90_days;AllVaccines;7617;4432;12049;3114778;1306302;4421080
2022.07_16-08-2022;г. Санкт-Петербург;75_90_days;CoviVac;377;42;419;3114778;1306302;4421080
2022.07_16-08-2022;г. Санкт-Петербург;75_90_days;EpiVacCorona;127;101;228;3114778;1306302;4421080
2022.07_16-08-2022;г. Санкт-Петербург;75_90_days;SputnikLite;2017;716;2733;3114778;1306302;4421080
2022.07_16-08-2022;г. Санкт-Петербург;75_90_days;SputnikV;5096;3573;8669;3114778;1306302;4421080
2022.07_16-08-2022;г. Санкт-Петербург;90_105_days;AllVaccines;9141;5066;14207;3114778;1306302;4421080
2022.07_16-08-2022;г. Санкт-Петербург;90_105_days;CoviVac;443;30;473;3114778;1306302;4421080
2022.07_16-08-2022;г. Санкт-Петербург;90_105_days;EpiVacCorona;257;101;358;3114778;1306302;4421080
2022.07_16-08-2022;г. Санкт-Петербург;90_105_days;SputnikLite;2621;1100;3721;3114778;1306302;4421080
2022.07_16-08-2022;г. Санкт-Петербург;90_105_days;SputnikV;5820;3835;9655;3114778;1306302;4421080
2022.07_16-08-2022;г. Севастополь;105_165_days;AllVaccines;9913;5462;15375;293051;116400;409451
2022.07_16-08-2022;г. Севастополь;105_165_days;CoviVac;129;53;182;293051;116400;409451
2022.07_16-08-2022;г. Севастополь;105_165_days;EpiVacCorona;116;170;286;293051;116400;409451
2022.07_16-08-2022;г. Севастополь;105_165_days;SputnikLite;5058;2930;7988;293051;116400;409451
2022.07_16-08-2022;г. Севастополь;105_165_days;SputnikV;4610;2309;6919;293051;116400;409451
2022.07_16-08-2022;г. Севастополь;165_195_days;AllVaccines;12547;6539;19086;293051;116400;409451
2022.07_16-08-2022;г. Севастополь;165_195_days;CoviVac;89;56;145;293051;116400;409451
2022.07_16-08-2022;г. Севастополь;165_195_days;EpiVacCorona;131;87;218;293051;116400;409451
2022.07_16-08-2022;г. Севастополь;165_195_days;SputnikLite;8411;5479;13890;293051;116400;409451
2022.07_16-08-2022;г. Севастополь;165_195_days;SputnikV;3916;917;4833;293051;116400;409451
2022.07_16-08-2022;г. Севастополь;21_45_days;AllVaccines;1945;2281;4226;293051;116400;409451
2022.07_16-08-2022;г. Севастополь;21_45_days;EpiVacCorona;24;24;48;293051;116400;409451
2022.07_16-08-2022;г. Севастополь;21_45_days;SputnikLite;369;202;571;293051;116400;409451
2022.07_16-08-2022;г. Севастополь;21_45_days;SputnikV;1552;2055;3607;293051;116400;409451
2022.07_16-08-2022;г. Севастополь;45_75_days;AllVaccines;2431;2625;5056;293051;116400;409451
2022.07_16-08-2022;г. Севастополь;45_75_days;CoviVac;2;0;2;293051;116400;409451
2022.07_16-08-2022;г. Севастополь;45_75_days;EpiVacCorona;18;20;38;293051;116400;409451
2022.07_16-08-2022;г. Севастополь;45_75_days;SputnikLite;1608;1105;2713;293051;116400;409451
2022.07_16-08-2022;г. Севастополь;45_75_days;SputnikV;803;1500;2303;293051;116400;409451
2022.07_16-08-2022;г. Севастополь;75_90_days;AllVaccines;1454;1238;2692;293051;116400;409451
2022.07_16-08-2022;г. Севастополь;75_90_days;CoviVac;11;5;16;293051;116400;409451
2022.07_16-08-2022;г. Севастополь;75_90_days;EpiVacCorona;7;9;16;293051;116400;409451
2022.07_16-08-2022;г. Севастополь;75_90_days;SputnikLite;1105;899;2004;293051;116400;409451
2022.07_16-08-2022;г. Севастополь;75_90_days;SputnikV;331;325;656;293051;116400;409451
2022.07_16-08-2022;г. Севастополь;90_105_days;AllVaccines;1597;1014;2611;293051;116400;409451
2022.07_16-08-2022;г. Севастополь;90_105_days;CoviVac;11;8;19;293051;116400;409451
2022.07_16-08-2022;г. Севастополь;90_105_days;EpiVacCorona;9;17;26;293051;116400;409451
2022.07_16-08-2022;г. Севастополь;90_105_days;SputnikLite;926;667;1593;293051;116400;409451
2022.07_16-08-2022;г. Севастополь;90_105_days;SputnikV;651;322;973;293051;116400;409451
2022.08_13-10-2022;Алтайский край;105_165_days;AllVaccines;13587;12107;25694;1240936;570412;1811348
2022.08_13-10-2022;Алтайский край;105_165_days;CoviVac;753;385;1138;1240936;570412;1811348
2022.08_13-10-2022;Алтайский край;105_165_days;EpiVacCorona;1550;1347;2897;1240936;570412;1811348
2022.08_13-10-2022;Алтайский край;105_165_days;SputnikLite;1510;800;2310;1240936;570412;1811348
2022.08_13-10-2022;Алтайский край;105_165_days;SputnikV;9774;9575;19349;1240936;570412;1811348
2022.08_13-10-2022;Алтайский край;165_195_days;AllVaccines;12290;6849;19139;1240936;570412;1811348
2022.08_13-10-2022;Алтайский край;165_195_days;CoviVac;832;318;1150;1240936;570412;1811348
2022.08_13-10-2022;Алтайский край;165_195_days;EpiVacCorona;1416;787;2203;1240936;570412;1811348
2022.08_13-10-2022;Алтайский край;165_195_days;SputnikLite;1704;791;2495;1240936;570412;1811348
2022.08_13-10-2022;Алтайский край;165_195_days;SputnikV;8338;4953;13291;1240936;570412;1811348
2022.08_13-10-2022;Алтайский край;21_45_days;AllVaccines;10431;9436;19867;1240936;570412;1811348
2022.08_13-10-2022;Алтайский край;21_45_days;CoviVac;10;0;10;1240936;570412;1811348
2022.08_13-10-2022;Алтайский край;21_45_days;EpiVacCorona;33;37;70;1240936;570412;1811348
2022.08_13-10-2022;Алтайский край;21_45_days;SputnikLite;869;721;1590;1240936;570412;1811348
2022.08_13-10-2022;Алтайский край;21_45_days;SputnikV;9519;8678;18197;1240936;570412;1811348
2022.08_13-10-2022;Алтайский край;45_75_days;AllVaccines;5584;5338;10922;1240936;570412;1811348
2022.08_13-10-2022;Алтайский край;45_75_days;CoviVac;34;33;67;1240936;570412;1811348
2022.08_13-10-2022;Алтайский край;45_75_days;EpiVacCorona;2048;1985;4033;1240936;570412;1811348
2022.08_13-10-2022;Алтайский край;45_75_days;SputnikLite;309;142;451;1240936;570412;1811348
2022.08_13-10-2022;Алтайский край;45_75_days;SputnikV;3193;3178;6371;1240936;570412;1811348
2022.08_13-10-2022;Алтайский край;75_90_days;AllVaccines;3922;5413;9335;1240936;570412;1811348
2022.08_13-10-2022;Алтайский край;75_90_days;CoviVac;85;27;112;1240936;570412;1811348
2022.08_13-10-2022;Алтайский край;75_90_days;EpiVacCorona;1486;2381;3867;1240936;570412;1811348
2022.08_13-10-2022;Алтайский край;75_90_days;SputnikLite;184;98;282;1240936;570412;1811348
2022.08_13-10-2022;Алтайский край;75_90_days;SputnikV;2167;2907;5074;1240936;570412;1811348
2022.08_13-10-2022;Алтайский край;90_105_days;AllVaccines;2866;3493;6359;1240936;570412;1811348
2022.08_13-10-2022;Алтайский край;90_105_days;CoviVac;115;118;233;1240936;570412;1811348
2022.08_13-10-2022;Алтайский край;90_105_days;EpiVacCorona;466;374;840;1240936;570412;1811348
2022.08_13-10-2022;Алтайский край;90_105_days;SputnikLite;198;115;313;1240936;570412;1811348
2022.08_13-10-2022;Алтайский край;90_105_days;SputnikV;2087;2886;4973;1240936;570412;1811348
2022.08_13-10-2022;Амурская область;105_165_days;AllVaccines;7596;3466;11062;444961;159780;604741
2022.08_13-10-2022;Амурская область;105_165_days;CoviVac;162;18;180;444961;159780;604741
2022.08_13-10-2022;Амурская область;105_165_days;EpiVacCorona;811;363;1174;444961;159780;604741
2022.08_13-10-2022;Амурская область;105_165_days;SputnikLite;3223;1119;4342;444961;159780;604741
2022.08_13-10-2022;Амурская область;105_165_days;SputnikV;3400;1966;5366;444961;159780;604741
2022.08_13-10-2022;Амурская область;165_195_days;AllVaccines;8740;2332;11072;444961;159780;604741
2022.08_13-10-2022;Амурская область;165_195_days;CoviVac;91;14;105;444961;159780;604741
2022.08_13-10-2022;Амурская область;165_195_days;EpiVacCorona;502;249;751;444961;159780;604741
2022.08_13-10-2022;Амурская область;165_195_days;SputnikLite;4858;1125;5983;444961;159780;604741
2022.08_13-10-2022;Амурская область;165_195_days;SputnikV;3289;944;4233;444961;159780;604741
2022.08_13-10-2022;Амурская область;21_45_days;AllVaccines;2416;1152;3568;444961;159780;604741
2022.08_13-10-2022;Амурская область;21_45_days;CoviVac;1;0;1;444961;159780;604741
2022.08_13-10-2022;Амурская область;21_45_days;EpiVacCorona;6;3;9;444961;159780;604741
2022.08_13-10-2022;Амурская область;21_45_days;SputnikLite;515;129;644;444961;159780;604741
2022.08_13-10-2022;Амурская область;21_45_days;SputnikV;1894;1020;2914;444961;159780;604741
2022.08_13-10-2022;Амурская область;45_75_days;AllVaccines;2223;967;3190;444961;159780;604741
2022.08_13-10-2022;Амурская область;45_75_days;EpiVacCorona;276;65;341;444961;159780;604741
2022.08_13-10-2022;Амурская область;45_75_days;SputnikLite;533;205;738;444961;159780;604741
2022.08_13-10-2022;Амурская область;45_75_days;SputnikV;1414;697;2111;444961;159780;604741
2022.08_13-10-2022;Амурская область;75_90_days;AllVaccines;1725;696;2421;444961;159780;604741
2022.08_13-10-2022;Амурская область;75_90_days;CoviVac;2;0;2;444961;159780;604741
2022.08_13-10-2022;Амурская область;75_90_days;EpiVacCorona;276;96;372;444961;159780;604741
2022.08_13-10-2022;Амурская область;75_90_days;SputnikLite;474;133;607;444961;159780;604741
2022.08_13-10-2022;Амурская область;75_90_days;SputnikV;973;467;1440;444961;159780;604741
2022.08_13-10-2022;Амурская область;90_105_days;AllVaccines;1766;1118;2884;444961;159780;604741
2022.08_13-10-2022;Амурская область;90_105_days;CoviVac;9;16;25;444961;159780;604741
2022.08_13-10-2022;Амурская область;90_105_days;EpiVacCorona;229;74;303;444961;159780;604741
2022.08_13-10-2022;Амурская область;90_105_days;SputnikLite;458;174;632;444961;159780;604741
2022.08_13-10-2022;Амурская область;90_105_days;SputnikV;1070;854;1924;444961;159780;604741
2022.08_13-10-2022;Архангельская область;105_165_days;AllVaccines;9004;7293;16297;595439;264499;859938
2022.08_13-10-2022;Архангельская область;105_165_days;CoviVac;501;344;845;595439;264499;859938
2022.08_13-10-2022;Архангельская область;105_165_days;EpiVacCorona;498;452;950;595439;264499;859938
2022.08_13-10-2022;Архангельская область;105_165_days;SputnikLite;1806;1015;2821;595439;264499;859938
2022.08_13-10-2022;Архангельская область;105_165_days;SputnikV;6199;5482;11681;595439;264499;859938
2022.08_13-10-2022;Архангельская область;165_195_days;AllVaccines;7347;5017;12364;595439;264499;859938
2022.08_13-10-2022;Архангельская область;165_195_days;CoviVac;166;37;203;595439;264499;859938
2022.08_13-10-2022;Архангельская область;165_195_days;EpiVacCorona;516;554;1070;595439;264499;859938
2022.08_13-10-2022;Архангельская область;165_195_days;SputnikLite;940;689;1629;595439;264499;859938
2022.08_13-10-2022;Архангельская область;165_195_days;SputnikV;5725;3737;9462;595439;264499;859938
2022.08_13-10-2022;Архангельская область;21_45_days;AllVaccines;4157;2071;6228;595439;264499;859938
2022.08_13-10-2022;Архангельская область;21_45_days;CoviVac;0;1;1;595439;264499;859938
2022.08_13-10-2022;Архангельская область;21_45_days;EpiVacCorona;245;65;310;595439;264499;859938
2022.08_13-10-2022;Архангельская область;21_45_days;SputnikLite;753;86;839;595439;264499;859938
2022.08_13-10-2022;Архангельская область;21_45_days;SputnikV;3159;1919;5078;595439;264499;859938
2022.08_13-10-2022;Архангельская область;45_75_days;AllVaccines;3098;1407;4505;595439;264499;859938
2022.08_13-10-2022;Архангельская область;45_75_days;CoviVac;10;3;13;595439;264499;859938
2022.08_13-10-2022;Архангельская область;45_75_days;EpiVacCorona;139;161;300;595439;264499;859938
2022.08_13-10-2022;Архангельская область;45_75_days;SputnikLite;923;148;1071;595439;264499;859938
2022.08_13-10-2022;Архангельская область;45_75_days;SputnikV;2026;1095;3121;595439;264499;859938
2022.08_13-10-2022;Архангельская область;75_90_days;AllVaccines;2021;1231;3252;595439;264499;859938
2022.08_13-10-2022;Архангельская область;75_90_days;CoviVac;66;8;74;595439;264499;859938
2022.08_13-10-2022;Архангельская область;75_90_days;EpiVacCorona;116;130;246;595439;264499;859938
2022.08_13-10-2022;Архангельская область;75_90_days;SputnikLite;329;88;417;595439;264499;859938
2022.08_13-10-2022;Архангельская область;75_90_days;SputnikV;1510;1005;2515;595439;264499;859938
2022.08_13-10-2022;Архангельская область;90_105_days;AllVaccines;2146;1624;3770;595439;264499;859938
2022.08_13-10-2022;Архангельская область;90_105_days;CoviVac;116;69;185;595439;264499;859938
2022.08_13-10-2022;Архангельская область;90_105_days;EpiVacCorona;102;82;184;595439;264499;859938
2022.08_13-10-2022;Архангельская область;90_105_days;SputnikLite;411;100;511;595439;264499;859938
2022.08_13-10-2022;Архангельская область;90_105_days;SputnikV;1517;1373;2890;595439;264499;859938
2022.08_13-10-2022;Астраханская область;105_165_days;AllVaccines;8822;5051;13873;550968;219749;770717
2022.08_13-10-2022;Астраханская область;105_165_days;CoviVac;142;19;161;550968;219749;770717
2022.08_13-10-2022;Астраханская область;105_165_days;EpiVacCorona;474;454;928;550968;219749;770717
2022.08_13-10-2022;Астраханская область;105_165_days;SputnikLite;3845;1839;5684;550968;219749;770717
2022.08_13-10-2022;Астраханская область;105_165_days;SputnikV;4361;2739;7100;550968;219749;770717
2022.08_13-10-2022;Астраханская область;165_195_days;AllVaccines;8959;3392;12351;550968;219749;770717
2022.08_13-10-2022;Астраханская область;165_195_days;CoviVac;114;30;144;550968;219749;770717
2022.08_13-10-2022;Астраханская область;165_195_days;EpiVacCorona;211;57;268;550968;219749;770717
2022.08_13-10-2022;Астраханская область;165_195_days;SputnikLite;4191;1692;5883;550968;219749;770717
2022.08_13-10-2022;Астраханская область;165_195_days;SputnikV;4443;1613;6056;550968;219749;770717
2022.08_13-10-2022;Астраханская область;21_45_days;AllVaccines;8840;3169;12009;550968;219749;770717
2022.08_13-10-2022;Астраханская область;21_45_days;CoviVac;1;0;1;550968;219749;770717
2022.08_13-10-2022;Астраханская область;21_45_days;EpiVacCorona;3;0;3;550968;219749;770717
2022.08_13-10-2022;Астраханская область;21_45_days;SputnikLite;304;44;348;550968;219749;770717
2022.08_13-10-2022;Астраханская область;21_45_days;SputnikV;8532;3125;11657;550968;219749;770717
2022.08_13-10-2022;Астраханская область;45_75_days;AllVaccines;4916;1599;6515;550968;219749;770717
2022.08_13-10-2022;Астраханская область;45_75_days;CoviVac;9;2;11;550968;219749;770717
2022.08_13-10-2022;Астраханская область;45_75_days;EpiVacCorona;267;66;333;550968;219749;770717
2022.08_13-10-2022;Астраханская область;45_75_days;SputnikLite;430;82;512;550968;219749;770717
2022.08_13-10-2022;Астраханская область;45_75_days;SputnikV;4210;1449;5659;550968;219749;770717
2022.08_13-10-2022;Астраханская область;75_90_days;AllVaccines;2955;1358;4313;550968;219749;770717
2022.08_13-10-2022;Астраханская область;75_90_days;CoviVac;1;0;1;550968;219749;770717
2022.08_13-10-2022;Астраханская область;75_90_days;EpiVacCorona;227;89;316;550968;219749;770717
2022.08_13-10-2022;Астраханская область;75_90_days;SputnikLite;220;34;254;550968;219749;770717
2022.08_13-10-2022;Астраханская область;75_90_days;SputnikV;2507;1235;3742;550968;219749;770717
2022.08_13-10-2022;Астраханская область;90_105_days;AllVaccines;3293;1523;4816;550968;219749;770717
2022.08_13-10-2022;Астраханская область;90_105_days;CoviVac;6;1;7;550968;219749;770717
2022.08_13-10-2022;Астраханская область;90_105_days;EpiVacCorona;386;183;569;550968;219749;770717
2022.08_13-10-2022;Астраханская область;90_105_days;SputnikLite;307;54;361;550968;219749;770717
2022.08_13-10-2022;Астраханская область;90_105_days;SputnikV;2594;1285;3879;550968;219749;770717
2022.08_13-10-2022;Белгородская область;105_165_days;AllVaccines;9022;6905;15927;867731;383871;1251602
2022.08_13-10-2022;Белгородская область;105_165_days;CoviVac;143;109;252;867731;383871;1251602
2022.08_13-10-2022;Белгородская область;105_165_days;EpiVacCorona;512;438;950;867731;383871;1251602
2022.08_13-10-2022;Белгородская область;105_165_days;SputnikLite;982;472;1454;867731;383871;1251602
2022.08_13-10-2022;Белгородская область;105_165_days;SputnikV;7385;5886;13271;867731;383871;1251602
2022.08_13-10-2022;Белгородская область;165_195_days;AllVaccines;7880;3692;11572;867731;383871;1251602
2022.08_13-10-2022;Белгородская область;165_195_days;CoviVac;188;65;253;867731;383871;1251602
2022.08_13-10-2022;Белгородская область;165_195_days;EpiVacCorona;384;206;590;867731;383871;1251602
2022.08_13-10-2022;Белгородская область;165_195_days;SputnikLite;3569;1735;5304;867731;383871;1251602
2022.08_13-10-2022;Белгородская область;165_195_days;SputnikV;3739;1686;5425;867731;383871;1251602
2022.08_13-10-2022;Белгородская область;21_45_days;AllVaccines;10208;4531;14739;867731;383871;1251602
2022.08_13-10-2022;Белгородская область;21_45_days;SputnikLite;224;20;244;867731;383871;1251602
2022.08_13-10-2022;Белгородская область;21_45_days;SputnikV;9984;4511;14495;867731;383871;1251602
2022.08_13-10-2022;Белгородская область;45_75_days;AllVaccines;6423;2965;9388;867731;383871;1251602
2022.08_13-10-2022;Белгородская область;45_75_days;EpiVacCorona;8;5;13;867731;383871;1251602
2022.08_13-10-2022;Белгородская область;45_75_days;SputnikLite;230;39;269;867731;383871;1251602
2022.08_13-10-2022;Белгородская область;45_75_days;SputnikV;6185;2921;9106;867731;383871;1251602
2022.08_13-10-2022;Белгородская область;75_90_days;AllVaccines;2993;1820;4813;867731;383871;1251602
2022.08_13-10-2022;Белгородская область;75_90_days;EpiVacCorona;86;63;149;867731;383871;1251602
2022.08_13-10-2022;Белгородская область;75_90_days;SputnikLite;134;17;151;867731;383871;1251602
2022.08_13-10-2022;Белгородская область;75_90_days;SputnikV;2773;1740;4513;867731;383871;1251602
2022.08_13-10-2022;Белгородская область;90_105_days;AllVaccines;2972;2578;5550;867731;383871;1251602
2022.08_13-10-2022;Белгородская область;90_105_days;CoviVac;5;44;49;867731;383871;1251602
2022.08_13-10-2022;Белгородская область;90_105_days;EpiVacCorona;122;183;305;867731;383871;1251602
2022.08_13-10-2022;Белгородская область;90_105_days;SputnikLite;84;11;95;867731;383871;1251602
2022.08_13-10-2022;Белгородская область;90_105_days;SputnikV;2761;2340;5101;867731;383871;1251602
2022.08_13-10-2022;Брянская область;105_165_days;AllVaccines;5318;5051;10369;659625;298625;958250
2022.08_13-10-2022;Брянская область;105_165_days;CoviVac;283;161;444;659625;298625;958250
2022.08_13-10-2022;Брянская область;105_165_days;EpiVacCorona;285;147;432;659625;298625;958250
2022.08_13-10-2022;Брянская область;105_165_days;SputnikLite;2165;2224;4389;659625;298625;958250
2022.08_13-10-2022;Брянская область;105_165_days;SputnikV;2585;2519;5104;659625;298625;958250
2022.08_13-10-2022;Брянская область;165_195_days;AllVaccines;4916;2930;7846;659625;298625;958250
2022.08_13-10-2022;Брянская область;165_195_days;CoviVac;125;35;160;659625;298625;958250
2022.08_13-10-2022;Брянская область;165_195_days;EpiVacCorona;157;92;249;659625;298625;958250
2022.08_13-10-2022;Брянская область;165_195_days;SputnikLite;1596;1161;2757;659625;298625;958250
2022.08_13-10-2022;Брянская область;165_195_days;SputnikV;3038;1642;4680;659625;298625;958250
2022.08_13-10-2022;Брянская область;21_45_days;AllVaccines;4856;3421;8277;659625;298625;958250
2022.08_13-10-2022;Брянская область;21_45_days;CoviVac;1;0;1;659625;298625;958250
2022.08_13-10-2022;Брянская область;21_45_days;EpiVacCorona;69;29;98;659625;298625;958250
2022.08_13-10-2022;Брянская область;21_45_days;SputnikLite;1849;1162;3011;659625;298625;958250
2022.08_13-10-2022;Брянская область;21_45_days;SputnikV;2937;2230;5167;659625;298625;958250
2022.08_13-10-2022;Брянская область;45_75_days;AllVaccines;2383;1925;4308;659625;298625;958250
2022.08_13-10-2022;Брянская область;45_75_days;CoviVac;17;0;17;659625;298625;958250
2022.08_13-10-2022;Брянская область;45_75_days;EpiVacCorona;112;84;196;659625;298625;958250
2022.08_13-10-2022;Брянская область;45_75_days;SputnikLite;1123;774;1897;659625;298625;958250
2022.08_13-10-2022;Брянская область;45_75_days;SputnikV;1131;1067;2198;659625;298625;958250
2022.08_13-10-2022;Брянская область;75_90_days;AllVaccines;1509;1529;3038;659625;298625;958250
2022.08_13-10-2022;Брянская область;75_90_days;CoviVac;69;3;72;659625;298625;958250
2022.08_13-10-2022;Брянская область;75_90_days;EpiVacCorona;55;38;93;659625;298625;958250
2022.08_13-10-2022;Брянская область;75_90_days;SputnikLite;449;423;872;659625;298625;958250
2022.08_13-10-2022;Брянская область;75_90_days;SputnikV;936;1065;2001;659625;298625;958250
2022.08_13-10-2022;Брянская область;90_105_days;AllVaccines;1497;1767;3264;659625;298625;958250
2022.08_13-10-2022;Брянская область;90_105_days;CoviVac;79;12;91;659625;298625;958250
2022.08_13-10-2022;Брянская область;90_105_days;EpiVacCorona;100;120;220;659625;298625;958250
2022.08_13-10-2022;Брянская область;90_105_days;SputnikLite;472;386;858;659625;298625;958250
2022.08_13-10-2022;Брянская область;90_105_days;SputnikV;846;1249;2095;659625;298625;958250
2022.08_13-10-2022;Владимирская область;105_165_days;AllVaccines;4192;4176;8368;739166;354521;1093687
2022.08_13-10-2022;Владимирская область;105_165_days;CoviVac;295;127;422;739166;354521;1093687
2022.08_13-10-2022;Владимирская область;105_165_days;EpiVacCorona;250;291;541;739166;354521;1093687
2022.08_13-10-2022;Владимирская область;105_165_days;SputnikLite;625;580;1205;739166;354521;1093687
2022.08_13-10-2022;Владимирская область;105_165_days;SputnikV;3022;3178;6200;739166;354521;1093687
2022.08_13-10-2022;Владимирская область;165_195_days;AllVaccines;4224;2659;6883;739166;354521;1093687
2022.08_13-10-2022;Владимирская область;165_195_days;CoviVac;133;70;203;739166;354521;1093687
2022.08_13-10-2022;Владимирская область;165_195_days;EpiVacCorona;229;171;400;739166;354521;1093687
2022.08_13-10-2022;Владимирская область;165_195_days;SputnikLite;1045;755;1800;739166;354521;1093687
2022.08_13-10-2022;Владимирская область;165_195_days;SputnikV;2817;1663;4480;739166;354521;1093687
2022.08_13-10-2022;Владимирская область;21_45_days;AllVaccines;4150;2523;6673;739166;354521;1093687
2022.08_13-10-2022;Владимирская область;21_45_days;CoviVac;1;0;1;739166;354521;1093687
2022.08_13-10-2022;Владимирская область;21_45_days;EpiVacCorona;103;59;162;739166;354521;1093687
2022.08_13-10-2022;Владимирская область;21_45_days;SputnikLite;845;375;1220;739166;354521;1093687
2022.08_13-10-2022;Владимирская область;21_45_days;SputnikV;3201;2089;5290;739166;354521;1093687
2022.08_13-10-2022;Владимирская область;45_75_days;AllVaccines;1876;1262;3138;739166;354521;1093687
2022.08_13-10-2022;Владимирская область;45_75_days;CoviVac;10;1;11;739166;354521;1093687
2022.08_13-10-2022;Владимирская область;45_75_days;EpiVacCorona;204;141;345;739166;354521;1093687
2022.08_13-10-2022;Владимирская область;45_75_days;SputnikLite;233;134;367;739166;354521;1093687
2022.08_13-10-2022;Владимирская область;45_75_days;SputnikV;1429;986;2415;739166;354521;1093687
2022.08_13-10-2022;Владимирская область;75_90_days;AllVaccines;1164;946;2110;739166;354521;1093687
2022.08_13-10-2022;Владимирская область;75_90_days;CoviVac;86;46;132;739166;354521;1093687
2022.08_13-10-2022;Владимирская область;75_90_days;EpiVacCorona;137;87;224;739166;354521;1093687
2022.08_13-10-2022;Владимирская область;75_90_days;SputnikLite;86;65;151;739166;354521;1093687
2022.08_13-10-2022;Владимирская область;75_90_days;SputnikV;855;748;1603;739166;354521;1093687
2022.08_13-10-2022;Владимирская область;90_105_days;AllVaccines;1279;1249;2528;739166;354521;1093687
2022.08_13-10-2022;Владимирская область;90_105_days;CoviVac;66;29;95;739166;354521;1093687
2022.08_13-10-2022;Владимирская область;90_105_days;EpiVacCorona;121;119;240;739166;354521;1093687
2022.08_13-10-2022;Владимирская область;90_105_days;SputnikLite;172;92;264;739166;354521;1093687
2022.08_13-10-2022;Владимирская область;90_105_days;SputnikV;920;1009;1929;739166;354521;1093687
2022.08_13-10-2022;Волгоградская область;105_165_days;AllVaccines;18931;14947;33878;1387837;615020;2002857
2022.08_13-10-2022;Волгоградская область;105_165_days;CoviVac;1702;762;2464;1387837;615020;2002857
2022.08_13-10-2022;Волгоградская область;105_165_days;EpiVacCorona;2179;1434;3613;1387837;615020;2002857
2022.08_13-10-2022;Волгоградская область;105_165_days;SputnikLite;3404;2481;5885;1387837;615020;2002857
2022.08_13-10-2022;Волгоградская область;105_165_days;SputnikV;11646;10270;21916;1387837;615020;2002857
2022.08_13-10-2022;Волгоградская область;165_195_days;AllVaccines;16475;9133;25608;1387837;615020;2002857
2022.08_13-10-2022;Волгоградская область;165_195_days;CoviVac;536;152;688;1387837;615020;2002857
2022.08_13-10-2022;Волгоградская область;165_195_days;EpiVacCorona;1583;725;2308;1387837;615020;2002857
2022.08_13-10-2022;Волгоградская область;165_195_days;SputnikLite;4939;2456;7395;1387837;615020;2002857
2022.08_13-10-2022;Волгоградская область;165_195_days;SputnikV;9417;5800;15217;1387837;615020;2002857
2022.08_13-10-2022;Волгоградская область;21_45_days;AllVaccines;15315;7516;22831;1387837;615020;2002857
2022.08_13-10-2022;Волгоградская область;21_45_days;EpiVacCorona;10;6;16;1387837;615020;2002857
2022.08_13-10-2022;Волгоградская область;21_45_days;SputnikLite;639;251;890;1387837;615020;2002857
2022.08_13-10-2022;Волгоградская область;21_45_days;SputnikV;14666;7259;21925;1387837;615020;2002857
2022.08_13-10-2022;Волгоградская область;45_75_days;AllVaccines;9690;5746;15436;1387837;615020;2002857
2022.08_13-10-2022;Волгоградская область;45_75_days;EpiVacCorona;2467;1483;3950;1387837;615020;2002857
2022.08_13-10-2022;Волгоградская область;45_75_days;SputnikLite;855;331;1186;1387837;615020;2002857
2022.08_13-10-2022;Волгоградская область;45_75_days;SputnikV;6368;3932;10300;1387837;615020;2002857
2022.08_13-10-2022;Волгоградская область;75_90_days;AllVaccines;6311;4534;10845;1387837;615020;2002857
2022.08_13-10-2022;Волгоградская область;75_90_days;CoviVac;3;0;3;1387837;615020;2002857
2022.08_13-10-2022;Волгоградская область;75_90_days;EpiVacCorona;1182;1062;2244;1387837;615020;2002857
2022.08_13-10-2022;Волгоградская область;75_90_days;SputnikLite;611;309;920;1387837;615020;2002857
2022.08_13-10-2022;Волгоградская область;75_90_days;SputnikV;4515;3163;7678;1387837;615020;2002857
2022.08_13-10-2022;Волгоградская область;90_105_days;AllVaccines;4784;4829;9613;1387837;615020;2002857
2022.08_13-10-2022;Волгоградская область;90_105_days;CoviVac;31;3;34;1387837;615020;2002857
2022.08_13-10-2022;Волгоградская область;90_105_days;EpiVacCorona;960;1104;2064;1387837;615020;2002857
2022.08_13-10-2022;Волгоградская область;90_105_days;SputnikLite;756;401;1157;1387837;615020;2002857
2022.08_13-10-2022;Волгоградская область;90_105_days;SputnikV;3037;3321;6358;1387837;615020;2002857
2022.08_13-10-2022;Вологодская область;105_165_days;AllVaccines;5992;4995;10987;628100;275171;903271
2022.08_13-10-2022;Вологодская область;105_165_days;CoviVac;235;47;282;628100;275171;903271
2022.08_13-10-2022;Вологодская область;105_165_days;EpiVacCorona;247;115;362;628100;275171;903271
2022.08_13-10-2022;Вологодская область;105_165_days;SputnikLite;469;368;837;628100;275171;903271
2022.08_13-10-2022;Вологодская область;105_165_days;SputnikV;5041;4465;9506;628100;275171;903271
2022.08_13-10-2022;Вологодская область;165_195_days;AllVaccines;5834;3406;9240;628100;275171;903271
2022.08_13-10-2022;Вологодская область;165_195_days;CoviVac;83;11;94;628100;275171;903271
2022.08_13-10-2022;Вологодская область;165_195_days;EpiVacCorona;216;135;351;628100;275171;903271
2022.08_13-10-2022;Вологодская область;165_195_days;SputnikLite;1338;479;1817;628100;275171;903271
2022.08_13-10-2022;Вологодская область;165_195_days;SputnikV;4197;2781;6978;628100;275171;903271
2022.08_13-10-2022;Вологодская область;21_45_days;AllVaccines;2354;2116;4470;628100;275171;903271
2022.08_13-10-2022;Вологодская область;21_45_days;CoviVac;16;10;26;628100;275171;903271
2022.08_13-10-2022;Вологодская область;21_45_days;EpiVacCorona;2;0;2;628100;275171;903271
2022.08_13-10-2022;Вологодская область;21_45_days;SputnikLite;214;39;253;628100;275171;903271
2022.08_13-10-2022;Вологодская область;21_45_days;SputnikV;2122;2067;4189;628100;275171;903271
2022.08_13-10-2022;Вологодская область;45_75_days;AllVaccines;1491;1267;2758;628100;275171;903271
2022.08_13-10-2022;Вологодская область;45_75_days;CoviVac;3;1;4;628100;275171;903271
2022.08_13-10-2022;Вологодская область;45_75_days;EpiVacCorona;89;50;139;628100;275171;903271
2022.08_13-10-2022;Вологодская область;45_75_days;SputnikLite;127;62;189;628100;275171;903271
2022.08_13-10-2022;Вологодская область;45_75_days;SputnikV;1272;1154;2426;628100;275171;903271
2022.08_13-10-2022;Вологодская область;75_90_days;AllVaccines;1161;888;2049;628100;275171;903271
2022.08_13-10-2022;Вологодская область;75_90_days;CoviVac;1;1;2;628100;275171;903271
2022.08_13-10-2022;Вологодская область;75_90_days;EpiVacCorona;125;90;215;628100;275171;903271
2022.08_13-10-2022;Вологодская область;75_90_days;SputnikLite;35;15;50;628100;275171;903271
2022.08_13-10-2022;Вологодская область;75_90_days;SputnikV;1000;782;1782;628100;275171;903271
2022.08_13-10-2022;Вологодская область;90_105_days;AllVaccines;1331;1344;2675;628100;275171;903271
2022.08_13-10-2022;Вологодская область;90_105_days;CoviVac;22;10;32;628100;275171;903271
2022.08_13-10-2022;Вологодская область;90_105_days;EpiVacCorona;64;44;108;628100;275171;903271
2022.08_13-10-2022;Вологодская область;90_105_days;SputnikLite;35;5;40;628100;275171;903271
2022.08_13-10-2022;Вологодская область;90_105_days;SputnikV;1210;1285;2495;628100;275171;903271
2022.08_13-10-2022;Воронежская область;105_165_days;AllVaccines;20019;15240;35259;1293123;602333;1895456
2022.08_13-10-2022;Воронежская область;105_165_days;CoviVac;785;321;1106;1293123;602333;1895456
2022.08_13-10-2022;Воронежская область;105_165_days;EpiVacCorona;1969;2090;4059;1293123;602333;1895456
2022.08_13-10-2022;Воронежская область;105_165_days;SputnikLite;3794;2918;6712;1293123;602333;1895456
2022.08_13-10-2022;Воронежская область;105_165_days;SputnikV;13471;9911;23382;1293123;602333;1895456
2022.08_13-10-2022;Воронежская область;165_195_days;AllVaccines;12917;9774;22691;1293123;602333;1895456
2022.08_13-10-2022;Воронежская область;165_195_days;CoviVac;389;224;613;1293123;602333;1895456
2022.08_13-10-2022;Воронежская область;165_195_days;EpiVacCorona;1132;976;2108;1293123;602333;1895456
2022.08_13-10-2022;Воронежская область;165_195_days;SputnikLite;3190;2302;5492;1293123;602333;1895456
2022.08_13-10-2022;Воронежская область;165_195_days;SputnikV;8206;6272;14478;1293123;602333;1895456
2022.08_13-10-2022;Воронежская область;21_45_days;AllVaccines;12065;7366;19431;1293123;602333;1895456
2022.08_13-10-2022;Воронежская область;21_45_days;CoviVac;46;19;65;1293123;602333;1895456
2022.08_13-10-2022;Воронежская область;21_45_days;EpiVacCorona;33;28;61;1293123;602333;1895456
2022.08_13-10-2022;Воронежская область;21_45_days;SputnikLite;1177;626;1803;1293123;602333;1895456
2022.08_13-10-2022;Воронежская область;21_45_days;SputnikV;10809;6693;17502;1293123;602333;1895456
2022.08_13-10-2022;Воронежская область;45_75_days;AllVaccines;7408;5393;12801;1293123;602333;1895456
2022.08_13-10-2022;Воронежская область;45_75_days;CoviVac;57;16;73;1293123;602333;1895456
2022.08_13-10-2022;Воронежская область;45_75_days;EpiVacCorona;390;249;639;1293123;602333;1895456
2022.08_13-10-2022;Воронежская область;45_75_days;SputnikLite;696;344;1040;1293123;602333;1895456
2022.08_13-10-2022;Воронежская область;45_75_days;SputnikV;6265;4784;11049;1293123;602333;1895456
2022.08_13-10-2022;Воронежская область;75_90_days;AllVaccines;6363;4450;10813;1293123;602333;1895456
2022.08_13-10-2022;Воронежская область;75_90_days;CoviVac;173;103;276;1293123;602333;1895456
2022.08_13-10-2022;Воронежская область;75_90_days;EpiVacCorona;394;357;751;1293123;602333;1895456
2022.08_13-10-2022;Воронежская область;75_90_days;SputnikLite;718;303;1021;1293123;602333;1895456
2022.08_13-10-2022;Воронежская область;75_90_days;SputnikV;5078;3687;8765;1293123;602333;1895456
2022.08_13-10-2022;Воронежская область;90_105_days;AllVaccines;5854;4356;10210;1293123;602333;1895456
2022.08_13-10-2022;Воронежская область;90_105_days;CoviVac;242;102;344;1293123;602333;1895456
2022.08_13-10-2022;Воронежская область;90_105_days;EpiVacCorona;351;238;589;1293123;602333;1895456
2022.08_13-10-2022;Воронежская область;90_105_days;SputnikLite;798;563;1361;1293123;602333;1895456
2022.08_13-10-2022;Воронежская область;90_105_days;SputnikV;4463;3453;7916;1293123;602333;1895456
2022.08_13-10-2022;Еврейская автономная область;105_165_days;AllVaccines;1278;611;1889;88207;31969;120176
2022.08_13-10-2022;Еврейская автономная область;105_165_days;CoviVac;157;82;239;88207;31969;120176
2022.08_13-10-2022;Еврейская автономная область;105_165_days;EpiVacCorona;278;100;378;88207;31969;120176
2022.08_13-10-2022;Еврейская автономная область;105_165_days;SputnikLite;1;0;1;88207;31969;120176
2022.08_13-10-2022;Еврейская автономная область;105_165_days;SputnikV;842;429;1271;88207;31969;120176
2022.08_13-10-2022;Еврейская автономная область;165_195_days;AllVaccines;770;251;1021;88207;31969;120176
2022.08_13-10-2022;Еврейская автономная область;165_195_days;CoviVac;76;9;85;88207;31969;120176
2022.08_13-10-2022;Еврейская автономная область;165_195_days;EpiVacCorona;283;92;375;88207;31969;120176
2022.08_13-10-2022;Еврейская автономная область;165_195_days;SputnikLite;84;48;132;88207;31969;120176
2022.08_13-10-2022;Еврейская автономная область;165_195_days;SputnikV;327;102;429;88207;31969;120176
2022.08_13-10-2022;Еврейская автономная область;21_45_days;AllVaccines;779;244;1023;88207;31969;120176
2022.08_13-10-2022;Еврейская автономная область;21_45_days;EpiVacCorona;7;0;7;88207;31969;120176
2022.08_13-10-2022;Еврейская автономная область;21_45_days;SputnikV;772;244;1016;88207;31969;120176
2022.08_13-10-2022;Еврейская автономная область;45_75_days;AllVaccines;1128;346;1474;88207;31969;120176
2022.08_13-10-2022;Еврейская автономная область;45_75_days;EpiVacCorona;53;10;63;88207;31969;120176
2022.08_13-10-2022;Еврейская автономная область;45_75_days;SputnikLite;2;0;2;88207;31969;120176
2022.08_13-10-2022;Еврейская автономная область;45_75_days;SputnikV;1073;336;1409;88207;31969;120176
2022.08_13-10-2022;Еврейская автономная область;75_90_days;AllVaccines;583;192;775;88207;31969;120176
2022.08_13-10-2022;Еврейская автономная область;75_90_days;EpiVacCorona;85;21;106;88207;31969;120176
2022.08_13-10-2022;Еврейская автономная область;75_90_days;SputnikV;498;171;669;88207;31969;120176
2022.08_13-10-2022;Еврейская автономная область;90_105_days;AllVaccines;599;148;747;88207;31969;120176
2022.08_13-10-2022;Еврейская автономная область;90_105_days;EpiVacCorona;91;16;107;88207;31969;120176
2022.08_13-10-2022;Еврейская автономная область;90_105_days;SputnikV;508;132;640;88207;31969;120176
2022.08_13-10-2022;Забайкальский край;105_165_days;AllVaccines;16161;7841;24002;596322;191826;788148
2022.08_13-10-2022;Забайкальский край;105_165_days;CoviVac;2893;767;3660;596322;191826;788148
2022.08_13-10-2022;Забайкальский край;105_165_days;EpiVacCorona;2197;1077;3274;596322;191826;788148
2022.08_13-10-2022;Забайкальский край;105_165_days;SputnikLite;1232;409;1641;596322;191826;788148
2022.08_13-10-2022;Забайкальский край;105_165_days;SputnikV;9839;5588;15427;596322;191826;788148
2022.08_13-10-2022;Забайкальский край;165_195_days;AllVaccines;14484;4510;18994;596322;191826;788148
2022.08_13-10-2022;Забайкальский край;165_195_days;CoviVac;627;84;711;596322;191826;788148
2022.08_13-10-2022;Забайкальский край;165_195_days;EpiVacCorona;2155;550;2705;596322;191826;788148
2022.08_13-10-2022;Забайкальский край;165_195_days;SputnikLite;1356;279;1635;596322;191826;788148
2022.08_13-10-2022;Забайкальский край;165_195_days;SputnikV;10346;3597;13943;596322;191826;788148
2022.08_13-10-2022;Забайкальский край;21_45_days;AllVaccines;2376;1088;3464;596322;191826;788148
2022.08_13-10-2022;Забайкальский край;21_45_days;CoviVac;19;1;20;596322;191826;788148
2022.08_13-10-2022;Забайкальский край;21_45_days;EpiVacCorona;17;8;25;596322;191826;788148
2022.08_13-10-2022;Забайкальский край;21_45_days;SputnikLite;292;3;295;596322;191826;788148
2022.08_13-10-2022;Забайкальский край;21_45_days;SputnikV;2048;1076;3124;596322;191826;788148
2022.08_13-10-2022;Забайкальский край;45_75_days;AllVaccines;2725;1481;4206;596322;191826;788148
2022.08_13-10-2022;Забайкальский край;45_75_days;CoviVac;97;18;115;596322;191826;788148
2022.08_13-10-2022;Забайкальский край;45_75_days;EpiVacCorona;61;59;120;596322;191826;788148
2022.08_13-10-2022;Забайкальский край;45_75_days;SputnikLite;64;7;71;596322;191826;788148
2022.08_13-10-2022;Забайкальский край;45_75_days;SputnikV;2503;1397;3900;596322;191826;788148
2022.08_13-10-2022;Забайкальский край;75_90_days;AllVaccines;3570;1708;5278;596322;191826;788148
2022.08_13-10-2022;Забайкальский край;75_90_days;CoviVac;548;140;688;596322;191826;788148
2022.08_13-10-2022;Забайкальский край;75_90_days;EpiVacCorona;313;224;537;596322;191826;788148
2022.08_13-10-2022;Забайкальский край;75_90_days;SputnikLite;201;8;209;596322;191826;788148
2022.08_13-10-2022;Забайкальский край;75_90_days;SputnikV;2508;1336;3844;596322;191826;788148
2022.08_13-10-2022;Забайкальский край;90_105_days;AllVaccines;3964;2159;6123;596322;191826;788148
2022.08_13-10-2022;Забайкальский край;90_105_days;CoviVac;752;233;985;596322;191826;788148
2022.08_13-10-2022;Забайкальский край;90_105_days;EpiVacCorona;605;338;943;596322;191826;788148
2022.08_13-10-2022;Забайкальский край;90_105_days;SputnikLite;244;5;249;596322;191826;788148
2022.08_13-10-2022;Забайкальский край;90_105_days;SputnikV;2363;1583;3946;596322;191826;788148
2022.08_13-10-2022;Ивановская область;105_165_days;AllVaccines;3679;4270;7949;549803;255947;805750
2022.08_13-10-2022;Ивановская область;105_165_days;CoviVac;125;65;190;549803;255947;805750
2022.08_13-10-2022;Ивановская область;105_165_days;EpiVacCorona;233;442;675;549803;255947;805750
2022.08_13-10-2022;Ивановская область;105_165_days;SputnikLite;1108;1512;2620;549803;255947;805750
2022.08_13-10-2022;Ивановская область;105_165_days;SputnikV;2213;2251;4464;549803;255947;805750
2022.08_13-10-2022;Ивановская область;165_195_days;AllVaccines;3817;2556;6373;549803;255947;805750
2022.08_13-10-2022;Ивановская область;165_195_days;CoviVac;114;13;127;549803;255947;805750
2022.08_13-10-2022;Ивановская область;165_195_days;EpiVacCorona;174;82;256;549803;255947;805750
2022.08_13-10-2022;Ивановская область;165_195_days;SputnikLite;1338;1135;2473;549803;255947;805750
2022.08_13-10-2022;Ивановская область;165_195_days;SputnikV;2191;1326;3517;549803;255947;805750
2022.08_13-10-2022;Ивановская область;21_45_days;AllVaccines;2801;1908;4709;549803;255947;805750
2022.08_13-10-2022;Ивановская область;21_45_days;CoviVac;4;2;6;549803;255947;805750
2022.08_13-10-2022;Ивановская область;21_45_days;SputnikLite;665;441;1106;549803;255947;805750
2022.08_13-10-2022;Ивановская область;21_45_days;SputnikV;2132;1465;3597;549803;255947;805750
2022.08_13-10-2022;Ивановская область;45_75_days;AllVaccines;1748;1195;2943;549803;255947;805750
2022.08_13-10-2022;Ивановская область;45_75_days;CoviVac;6;1;7;549803;255947;805750
2022.08_13-10-2022;Ивановская область;45_75_days;EpiVacCorona;2;2;4;549803;255947;805750
2022.08_13-10-2022;Ивановская область;45_75_days;SputnikLite;597;436;1033;549803;255947;805750
2022.08_13-10-2022;Ивановская область;45_75_days;SputnikV;1143;756;1899;549803;255947;805750
2022.08_13-10-2022;Ивановская область;75_90_days;AllVaccines;1055;1000;2055;549803;255947;805750
2022.08_13-10-2022;Ивановская область;75_90_days;CoviVac;27;6;33;549803;255947;805750
2022.08_13-10-2022;Ивановская область;75_90_days;EpiVacCorona;43;23;66;549803;255947;805750
2022.08_13-10-2022;Ивановская область;75_90_days;SputnikLite;290;259;549;549803;255947;805750
2022.08_13-10-2022;Ивановская область;75_90_days;SputnikV;695;712;1407;549803;255947;805750
2022.08_13-10-2022;Ивановская область;90_105_days;AllVaccines;1129;1229;2358;549803;255947;805750
2022.08_13-10-2022;Ивановская область;90_105_days;CoviVac;36;26;62;549803;255947;805750
2022.08_13-10-2022;Ивановская область;90_105_days;EpiVacCorona;32;56;88;549803;255947;805750
2022.08_13-10-2022;Ивановская область;90_105_days;SputnikLite;389;320;709;549803;255947;805750
2022.08_13-10-2022;Ивановская область;90_105_days;SputnikV;672;827;1499;549803;255947;805750
2022.08_13-10-2022;Иркутская область;105_165_days;AllVaccines;14666;8567;23233;1316761;480655;1797416
2022.08_13-10-2022;Иркутская область;105_165_days;CoviVac;970;280;1250;1316761;480655;1797416
2022.08_13-10-2022;Иркутская область;105_165_days;EpiVacCorona;1670;674;2344;1316761;480655;1797416
2022.08_13-10-2022;Иркутская область;105_165_days;SputnikLite;1305;530;1835;1316761;480655;1797416
2022.08_13-10-2022;Иркутская область;105_165_days;SputnikV;10721;7083;17804;1316761;480655;1797416
2022.08_13-10-2022;Иркутская область;165_195_days;AllVaccines;12669;4776;17445;1316761;480655;1797416
2022.08_13-10-2022;Иркутская область;165_195_days;CoviVac;314;67;381;1316761;480655;1797416
2022.08_13-10-2022;Иркутская область;165_195_days;EpiVacCorona;602;254;856;1316761;480655;1797416
2022.08_13-10-2022;Иркутская область;165_195_days;SputnikLite;1805;543;2348;1316761;480655;1797416
2022.08_13-10-2022;Иркутская область;165_195_days;SputnikV;9948;3912;13860;1316761;480655;1797416
2022.08_13-10-2022;Иркутская область;21_45_days;AllVaccines;10985;6684;17669;1316761;480655;1797416
2022.08_13-10-2022;Иркутская область;21_45_days;CoviVac;60;13;73;1316761;480655;1797416
2022.08_13-10-2022;Иркутская область;21_45_days;EpiVacCorona;120;43;163;1316761;480655;1797416
2022.08_13-10-2022;Иркутская область;21_45_days;SputnikLite;24;21;45;1316761;480655;1797416
2022.08_13-10-2022;Иркутская область;21_45_days;SputnikV;10781;6607;17388;1316761;480655;1797416
2022.08_13-10-2022;Иркутская область;45_75_days;AllVaccines;6250;3122;9372;1316761;480655;1797416
2022.08_13-10-2022;Иркутская область;45_75_days;CoviVac;59;32;91;1316761;480655;1797416
2022.08_13-10-2022;Иркутская область;45_75_days;EpiVacCorona;445;241;686;1316761;480655;1797416
2022.08_13-10-2022;Иркутская область;45_75_days;SputnikLite;30;18;48;1316761;480655;1797416
2022.08_13-10-2022;Иркутская область;45_75_days;SputnikV;5716;2831;8547;1316761;480655;1797416
2022.08_13-10-2022;Иркутская область;75_90_days;AllVaccines;3858;2036;5894;1316761;480655;1797416
2022.08_13-10-2022;Иркутская область;75_90_days;CoviVac;192;53;245;1316761;480655;1797416
2022.08_13-10-2022;Иркутская область;75_90_days;EpiVacCorona;437;271;708;1316761;480655;1797416
2022.08_13-10-2022;Иркутская область;75_90_days;SputnikLite;94;32;126;1316761;480655;1797416
2022.08_13-10-2022;Иркутская область;75_90_days;SputnikV;3135;1680;4815;1316761;480655;1797416
2022.08_13-10-2022;Иркутская область;90_105_days;AllVaccines;3643;2448;6091;1316761;480655;1797416
2022.08_13-10-2022;Иркутская область;90_105_days;CoviVac;190;108;298;1316761;480655;1797416
2022.08_13-10-2022;Иркутская область;90_105_days;EpiVacCorona;347;158;505;1316761;480655;1797416
2022.08_13-10-2022;Иркутская область;90_105_days;SputnikLite;142;45;187;1316761;480655;1797416
2022.08_13-10-2022;Иркутская область;90_105_days;SputnikV;2964;2137;5101;1316761;480655;1797416
2022.08_13-10-2022;Кабардино-Балкарская Республика;105_165_days;AllVaccines;4698;1831;6529;502388;159241;661629
2022.08_13-10-2022;Кабардино-Балкарская Республика;105_165_days;CoviVac;628;236;864;502388;159241;661629
2022.08_13-10-2022;Кабардино-Балкарская Республика;105_165_days;EpiVacCorona;354;61;415;502388;159241;661629
2022.08_13-10-2022;Кабардино-Балкарская Республика;105_165_days;SputnikLite;1077;250;1327;502388;159241;661629
2022.08_13-10-2022;Кабардино-Балкарская Республика;105_165_days;SputnikV;2639;1284;3923;502388;159241;661629
2022.08_13-10-2022;Кабардино-Балкарская Республика;165_195_days;AllVaccines;2616;1167;3783;502388;159241;661629
2022.08_13-10-2022;Кабардино-Балкарская Республика;165_195_days;CoviVac;65;10;75;502388;159241;661629
2022.08_13-10-2022;Кабардино-Балкарская Республика;165_195_days;EpiVacCorona;270;91;361;502388;159241;661629
2022.08_13-10-2022;Кабардино-Балкарская Республика;165_195_days;SputnikLite;643;253;896;502388;159241;661629
2022.08_13-10-2022;Кабардино-Балкарская Республика;165_195_days;SputnikV;1638;813;2451;502388;159241;661629
2022.08_13-10-2022;Кабардино-Балкарская Республика;21_45_days;AllVaccines;2963;856;3819;502388;159241;661629
2022.08_13-10-2022;Кабардино-Балкарская Республика;21_45_days;EpiVacCorona;10;9;19;502388;159241;661629
2022.08_13-10-2022;Кабардино-Балкарская Республика;21_45_days;SputnikLite;15;1;16;502388;159241;661629
2022.08_13-10-2022;Кабардино-Балкарская Республика;21_45_days;SputnikV;2938;846;3784;502388;159241;661629
2022.08_13-10-2022;Кабардино-Балкарская Республика;45_75_days;AllVaccines;1901;460;2361;502388;159241;661629
2022.08_13-10-2022;Кабардино-Балкарская Республика;45_75_days;CoviVac;35;0;35;502388;159241;661629
2022.08_13-10-2022;Кабардино-Балкарская Республика;45_75_days;EpiVacCorona;12;0;12;502388;159241;661629
2022.08_13-10-2022;Кабардино-Балкарская Республика;45_75_days;SputnikLite;47;2;49;502388;159241;661629
2022.08_13-10-2022;Кабардино-Балкарская Республика;45_75_days;SputnikV;1807;458;2265;502388;159241;661629
2022.08_13-10-2022;Кабардино-Балкарская Республика;75_90_days;AllVaccines;1217;392;1609;502388;159241;661629
2022.08_13-10-2022;Кабардино-Балкарская Республика;75_90_days;CoviVac;39;9;48;502388;159241;661629
2022.08_13-10-2022;Кабардино-Балкарская Республика;75_90_days;EpiVacCorona;95;19;114;502388;159241;661629
2022.08_13-10-2022;Кабардино-Балкарская Республика;75_90_days;SputnikLite;66;2;68;502388;159241;661629
2022.08_13-10-2022;Кабардино-Балкарская Республика;75_90_days;SputnikV;1017;362;1379;502388;159241;661629
2022.08_13-10-2022;Кабардино-Балкарская Республика;90_105_days;AllVaccines;1277;476;1753;502388;159241;661629
2022.08_13-10-2022;Кабардино-Балкарская Республика;90_105_days;CoviVac;91;19;110;502388;159241;661629
2022.08_13-10-2022;Кабардино-Балкарская Республика;90_105_days;EpiVacCorona;109;15;124;502388;159241;661629
2022.08_13-10-2022;Кабардино-Балкарская Республика;90_105_days;SputnikLite;134;4;138;502388;159241;661629
2022.08_13-10-2022;Кабардино-Балкарская Республика;90_105_days;SputnikV;943;438;1381;502388;159241;661629
2022.08_13-10-2022;Калининградская область;105_165_days;AllVaccines;6641;5882;12523;585700;231702;817402
2022.08_13-10-2022;Калининградская область;105_165_days;CoviVac;197;140;337;585700;231702;817402
2022.08_13-10-2022;Калининградская область;105_165_days;EpiVacCorona;199;97;296;585700;231702;817402
2022.08_13-10-2022;Калининградская область;105_165_days;SputnikLite;2294;2102;4396;585700;231702;817402
2022.08_13-10-2022;Калининградская область;105_165_days;SputnikV;3951;3543;7494;585700;231702;817402
2022.08_13-10-2022;Калининградская область;165_195_days;AllVaccines;5549;3486;9035;585700;231702;817402
2022.08_13-10-2022;Калининградская область;165_195_days;CoviVac;110;51;161;585700;231702;817402
2022.08_13-10-2022;Калининградская область;165_195_days;EpiVacCorona;142;95;237;585700;231702;817402
2022.08_13-10-2022;Калининградская область;165_195_days;SputnikLite;1057;829;1886;585700;231702;817402
2022.08_13-10-2022;Калининградская область;165_195_days;SputnikV;4240;2511;6751;585700;231702;817402
2022.08_13-10-2022;Калининградская область;21_45_days;AllVaccines;4209;3083;7292;585700;231702;817402
2022.08_13-10-2022;Калининградская область;21_45_days;EpiVacCorona;4;0;4;585700;231702;817402
2022.08_13-10-2022;Калининградская область;21_45_days;SputnikLite;516;220;736;585700;231702;817402
2022.08_13-10-2022;Калининградская область;21_45_days;SputnikV;3689;2863;6552;585700;231702;817402
2022.08_13-10-2022;Калининградская область;45_75_days;AllVaccines;2970;2108;5078;585700;231702;817402
2022.08_13-10-2022;Калининградская область;45_75_days;CoviVac;4;1;5;585700;231702;817402
2022.08_13-10-2022;Калининградская область;45_75_days;EpiVacCorona;19;5;24;585700;231702;817402
2022.08_13-10-2022;Калининградская область;45_75_days;SputnikLite;955;668;1623;585700;231702;817402
2022.08_13-10-2022;Калининградская область;45_75_days;SputnikV;1992;1434;3426;585700;231702;817402
2022.08_13-10-2022;Калининградская область;75_90_days;AllVaccines;1517;1255;2772;585700;231702;817402
2022.08_13-10-2022;Калининградская область;75_90_days;CoviVac;74;33;107;585700;231702;817402
2022.08_13-10-2022;Калининградская область;75_90_days;EpiVacCorona;75;59;134;585700;231702;817402
2022.08_13-10-2022;Калининградская область;75_90_days;SputnikLite;382;131;513;585700;231702;817402
2022.08_13-10-2022;Калининградская область;75_90_days;SputnikV;986;1032;2018;585700;231702;817402
2022.08_13-10-2022;Калининградская область;90_105_days;AllVaccines;2139;1691;3830;585700;231702;817402
2022.08_13-10-2022;Калининградская область;90_105_days;CoviVac;85;23;108;585700;231702;817402
2022.08_13-10-2022;Калининградская область;90_105_days;EpiVacCorona;104;78;182;585700;231702;817402
2022.08_13-10-2022;Калининградская область;90_105_days;SputnikLite;678;285;963;585700;231702;817402
2022.08_13-10-2022;Калининградская область;90_105_days;SputnikV;1272;1305;2577;585700;231702;817402
2022.08_13-10-2022;Калужская область;105_165_days;AllVaccines;6157;4951;11108;559789;253023;812812
2022.08_13-10-2022;Калужская область;105_165_days;CoviVac;298;256;554;559789;253023;812812
2022.08_13-10-2022;Калужская область;105_165_days;EpiVacCorona;450;227;677;559789;253023;812812
2022.08_13-10-2022;Калужская область;105_165_days;SputnikLite;544;415;959;559789;253023;812812
2022.08_13-10-2022;Калужская область;105_165_days;SputnikV;4865;4053;8918;559789;253023;812812
2022.08_13-10-2022;Калужская область;165_195_days;AllVaccines;5378;2873;8251;559789;253023;812812
2022.08_13-10-2022;Калужская область;165_195_days;CoviVac;168;52;220;559789;253023;812812
2022.08_13-10-2022;Калужская область;165_195_days;EpiVacCorona;356;168;524;559789;253023;812812
2022.08_13-10-2022;Калужская область;165_195_days;SputnikLite;1050;920;1970;559789;253023;812812
2022.08_13-10-2022;Калужская область;165_195_days;SputnikV;3804;1733;5537;559789;253023;812812
2022.08_13-10-2022;Калужская область;21_45_days;AllVaccines;3627;1917;5544;559789;253023;812812
2022.08_13-10-2022;Калужская область;21_45_days;CoviVac;0;1;1;559789;253023;812812
2022.08_13-10-2022;Калужская область;21_45_days;EpiVacCorona;0;1;1;559789;253023;812812
2022.08_13-10-2022;Калужская область;21_45_days;SputnikLite;613;341;954;559789;253023;812812
2022.08_13-10-2022;Калужская область;21_45_days;SputnikV;3014;1574;4588;559789;253023;812812
2022.08_13-10-2022;Калужская область;45_75_days;AllVaccines;5639;3359;8998;559789;253023;812812
2022.08_13-10-2022;Калужская область;45_75_days;CoviVac;6;14;20;559789;253023;812812
2022.08_13-10-2022;Калужская область;45_75_days;EpiVacCorona;17;17;34;559789;253023;812812
2022.08_13-10-2022;Калужская область;45_75_days;SputnikLite;3577;2183;5760;559789;253023;812812
2022.08_13-10-2022;Калужская область;45_75_days;SputnikV;2039;1145;3184;559789;253023;812812
2022.08_13-10-2022;Калужская область;75_90_days;AllVaccines;2118;1608;3726;559789;253023;812812
2022.08_13-10-2022;Калужская область;75_90_days;CoviVac;82;80;162;559789;253023;812812
2022.08_13-10-2022;Калужская область;75_90_days;EpiVacCorona;69;48;117;559789;253023;812812
2022.08_13-10-2022;Калужская область;75_90_days;SputnikLite;676;518;1194;559789;253023;812812
2022.08_13-10-2022;Калужская область;75_90_days;SputnikV;1291;962;2253;559789;253023;812812
2022.08_13-10-2022;Калужская область;90_105_days;AllVaccines;1481;1421;2902;559789;253023;812812
2022.08_13-10-2022;Калужская область;90_105_days;CoviVac;84;56;140;559789;253023;812812
2022.08_13-10-2022;Калужская область;90_105_days;EpiVacCorona;100;99;199;559789;253023;812812
2022.08_13-10-2022;Калужская область;90_105_days;SputnikLite;25;6;31;559789;253023;812812
2022.08_13-10-2022;Калужская область;90_105_days;SputnikV;1272;1260;2532;559789;253023;812812
2022.08_13-10-2022;Камчатский край;105_165_days;AllVaccines;3779;988;4767;189425;56856;246281
2022.08_13-10-2022;Камчатский край;105_165_days;CoviVac;43;15;58;189425;56856;246281
2022.08_13-10-2022;Камчатский край;105_165_days;EpiVacCorona;258;58;316;189425;56856;246281
2022.08_13-10-2022;Камчатский край;105_165_days;SputnikLite;958;206;1164;189425;56856;246281
2022.08_13-10-2022;Камчатский край;105_165_days;SputnikV;2520;709;3229;189425;56856;246281
2022.08_13-10-2022;Камчатский край;165_195_days;AllVaccines;2758;845;3603;189425;56856;246281
2022.08_13-10-2022;Камчатский край;165_195_days;CoviVac;44;9;53;189425;56856;246281
2022.08_13-10-2022;Камчатский край;165_195_days;EpiVacCorona;290;93;383;189425;56856;246281
2022.08_13-10-2022;Камчатский край;165_195_days;SputnikLite;473;157;630;189425;56856;246281
2022.08_13-10-2022;Камчатский край;165_195_days;SputnikV;1951;586;2537;189425;56856;246281
2022.08_13-10-2022;Камчатский край;21_45_days;AllVaccines;726;268;994;189425;56856;246281
2022.08_13-10-2022;Камчатский край;21_45_days;EpiVacCorona;18;11;29;189425;56856;246281
2022.08_13-10-2022;Камчатский край;21_45_days;SputnikLite;35;6;41;189425;56856;246281
2022.08_13-10-2022;Камчатский край;21_45_days;SputnikV;673;251;924;189425;56856;246281
2022.08_13-10-2022;Камчатский край;45_75_days;AllVaccines;726;188;914;189425;56856;246281
2022.08_13-10-2022;Камчатский край;45_75_days;EpiVacCorona;29;8;37;189425;56856;246281
2022.08_13-10-2022;Камчатский край;45_75_days;SputnikLite;105;5;110;189425;56856;246281
2022.08_13-10-2022;Камчатский край;45_75_days;SputnikV;592;175;767;189425;56856;246281
2022.08_13-10-2022;Камчатский край;75_90_days;AllVaccines;549;122;671;189425;56856;246281
2022.08_13-10-2022;Камчатский край;75_90_days;EpiVacCorona;72;17;89;189425;56856;246281
2022.08_13-10-2022;Камчатский край;75_90_days;SputnikLite;89;8;97;189425;56856;246281
2022.08_13-10-2022;Камчатский край;75_90_days;SputnikV;388;97;485;189425;56856;246281
2022.08_13-10-2022;Камчатский край;90_105_days;AllVaccines;570;231;801;189425;56856;246281
2022.08_13-10-2022;Камчатский край;90_105_days;EpiVacCorona;137;47;184;189425;56856;246281
2022.08_13-10-2022;Камчатский край;90_105_days;SputnikLite;100;27;127;189425;56856;246281
2022.08_13-10-2022;Камчатский край;90_105_days;SputnikV;333;157;490;189425;56856;246281
2022.08_13-10-2022;Карачаево-Черкесская Республика;105_165_days;AllVaccines;13794;6500;20294;266261;94005;360266
2022.08_13-10-2022;Карачаево-Черкесская Республика;105_165_days;CoviVac;1439;424;1863;266261;94005;360266
2022.08_13-10-2022;Карачаево-Черкесская Республика;105_165_days;EpiVacCorona;2499;1350;3849;266261;94005;360266
2022.08_13-10-2022;Карачаево-Черкесская Республика;105_165_days;SputnikLite;1710;816;2526;266261;94005;360266
2022.08_13-10-2022;Карачаево-Черкесская Республика;105_165_days;SputnikV;8146;3910;12056;266261;94005;360266
2022.08_13-10-2022;Карачаево-Черкесская Республика;165_195_days;AllVaccines;6101;2124;8225;266261;94005;360266
2022.08_13-10-2022;Карачаево-Черкесская Республика;165_195_days;CoviVac;335;114;449;266261;94005;360266
2022.08_13-10-2022;Карачаево-Черкесская Республика;165_195_days;EpiVacCorona;737;218;955;266261;94005;360266
2022.08_13-10-2022;Карачаево-Черкесская Республика;165_195_days;SputnikLite;1417;541;1958;266261;94005;360266
2022.08_13-10-2022;Карачаево-Черкесская Республика;165_195_days;SputnikV;3612;1251;4863;266261;94005;360266
2022.08_13-10-2022;Карачаево-Черкесская Республика;21_45_days;AllVaccines;2277;490;2767;266261;94005;360266
2022.08_13-10-2022;Карачаево-Черкесская Республика;21_45_days;SputnikLite;1219;266;1485;266261;94005;360266
2022.08_13-10-2022;Карачаево-Черкесская Республика;21_45_days;SputnikV;1058;224;1282;266261;94005;360266
2022.08_13-10-2022;Карачаево-Черкесская Республика;45_75_days;AllVaccines;1507;431;1938;266261;94005;360266
2022.08_13-10-2022;Карачаево-Черкесская Республика;45_75_days;CoviVac;17;2;19;266261;94005;360266
2022.08_13-10-2022;Карачаево-Черкесская Республика;45_75_days;SputnikLite;1142;356;1498;266261;94005;360266
2022.08_13-10-2022;Карачаево-Черкесская Республика;45_75_days;SputnikV;348;73;421;266261;94005;360266
2022.08_13-10-2022;Карачаево-Черкесская Республика;75_90_days;AllVaccines;3062;1448;4510;266261;94005;360266
2022.08_13-10-2022;Карачаево-Черкесская Республика;75_90_days;CoviVac;18;8;26;266261;94005;360266
2022.08_13-10-2022;Карачаево-Черкесская Республика;75_90_days;EpiVacCorona;1692;873;2565;266261;94005;360266
2022.08_13-10-2022;Карачаево-Черкесская Республика;75_90_days;SputnikLite;757;218;975;266261;94005;360266
2022.08_13-10-2022;Карачаево-Черкесская Республика;75_90_days;SputnikV;595;349;944;266261;94005;360266
2022.08_13-10-2022;Карачаево-Черкесская Республика;90_105_days;AllVaccines;2867;917;3784;266261;94005;360266
2022.08_13-10-2022;Карачаево-Черкесская Республика;90_105_days;CoviVac;2;0;2;266261;94005;360266
2022.08_13-10-2022;Карачаево-Черкесская Республика;90_105_days;EpiVacCorona;1613;463;2076;266261;94005;360266
2022.08_13-10-2022;Карачаево-Черкесская Республика;90_105_days;SputnikLite;548;205;753;266261;94005;360266
2022.08_13-10-2022;Карачаево-Черкесская Республика;90_105_days;SputnikV;704;249;953;266261;94005;360266
2022.08_13-10-2022;Кемеровская область;105_165_days;AllVaccines;14925;7965;22890;1453976;610256;2064232
2022.08_13-10-2022;Кемеровская область;105_165_days;CoviVac;890;326;1216;1453976;610256;2064232
2022.08_13-10-2022;Кемеровская область;105_165_days;EpiVacCorona;1726;887;2613;1453976;610256;2064232
2022.08_13-10-2022;Кемеровская область;105_165_days;SputnikLite;553;339;892;1453976;610256;2064232
2022.08_13-10-2022;Кемеровская область;105_165_days;SputnikV;11756;6413;18169;1453976;610256;2064232
2022.08_13-10-2022;Кемеровская область;165_195_days;AllVaccines;14411;5023;19434;1453976;610256;2064232
2022.08_13-10-2022;Кемеровская область;165_195_days;CoviVac;417;136;553;1453976;610256;2064232
2022.08_13-10-2022;Кемеровская область;165_195_days;EpiVacCorona;1015;460;1475;1453976;610256;2064232
2022.08_13-10-2022;Кемеровская область;165_195_days;SputnikLite;1944;603;2547;1453976;610256;2064232
2022.08_13-10-2022;Кемеровская область;165_195_days;SputnikV;11035;3824;14859;1453976;610256;2064232
2022.08_13-10-2022;Кемеровская область;21_45_days;AllVaccines;10610;5837;16447;1453976;610256;2064232
2022.08_13-10-2022;Кемеровская область;21_45_days;EpiVacCorona;385;135;520;1453976;610256;2064232
2022.08_13-10-2022;Кемеровская область;21_45_days;SputnikLite;72;23;95;1453976;610256;2064232
2022.08_13-10-2022;Кемеровская область;21_45_days;SputnikV;10153;5679;15832;1453976;610256;2064232
2022.08_13-10-2022;Кемеровская область;45_75_days;AllVaccines;7263;5129;12392;1453976;610256;2064232
2022.08_13-10-2022;Кемеровская область;45_75_days;CoviVac;27;4;31;1453976;610256;2064232
2022.08_13-10-2022;Кемеровская область;45_75_days;EpiVacCorona;918;699;1617;1453976;610256;2064232
2022.08_13-10-2022;Кемеровская область;45_75_days;SputnikLite;124;40;164;1453976;610256;2064232
2022.08_13-10-2022;Кемеровская область;45_75_days;SputnikV;6194;4386;10580;1453976;610256;2064232
2022.08_13-10-2022;Кемеровская область;75_90_days;AllVaccines;5245;3060;8305;1453976;610256;2064232
2022.08_13-10-2022;Кемеровская область;75_90_days;CoviVac;286;91;377;1453976;610256;2064232
2022.08_13-10-2022;Кемеровская область;75_90_days;EpiVacCorona;895;488;1383;1453976;610256;2064232
2022.08_13-10-2022;Кемеровская область;75_90_days;SputnikLite;45;1;46;1453976;610256;2064232
2022.08_13-10-2022;Кемеровская область;75_90_days;SputnikV;4019;2480;6499;1453976;610256;2064232
2022.08_13-10-2022;Кемеровская область;90_105_days;AllVaccines;4065;2684;6749;1453976;610256;2064232
2022.08_13-10-2022;Кемеровская область;90_105_days;CoviVac;156;37;193;1453976;610256;2064232
2022.08_13-10-2022;Кемеровская область;90_105_days;EpiVacCorona;411;239;650;1453976;610256;2064232
2022.08_13-10-2022;Кемеровская область;90_105_days;SputnikLite;100;76;176;1453976;610256;2064232
2022.08_13-10-2022;Кемеровская область;90_105_days;SputnikV;3398;2332;5730;1453976;610256;2064232
2022.08_13-10-2022;Кировская область;105_165_days;AllVaccines;8322;9078;17400;663621;334585;998206
2022.08_13-10-2022;Кировская область;105_165_days;CoviVac;158;42;200;663621;334585;998206
2022.08_13-10-2022;Кировская область;105_165_days;EpiVacCorona;567;318;885;663621;334585;998206
2022.08_13-10-2022;Кировская область;105_165_days;SputnikLite;2234;1110;3344;663621;334585;998206
2022.08_13-10-2022;Кировская область;105_165_days;SputnikV;5363;7608;12971;663621;334585;998206
2022.08_13-10-2022;Кировская область;165_195_days;AllVaccines;5730;5080;10810;663621;334585;998206
2022.08_13-10-2022;Кировская область;165_195_days;CoviVac;71;10;81;663621;334585;998206
2022.08_13-10-2022;Кировская область;165_195_days;EpiVacCorona;164;93;257;663621;334585;998206
2022.08_13-10-2022;Кировская область;165_195_days;SputnikLite;2661;2273;4934;663621;334585;998206
2022.08_13-10-2022;Кировская область;165_195_days;SputnikV;2834;2704;5538;663621;334585;998206
2022.08_13-10-2022;Кировская область;21_45_days;AllVaccines;2834;3529;6363;663621;334585;998206
2022.08_13-10-2022;Кировская область;21_45_days;EpiVacCorona;38;16;54;663621;334585;998206
2022.08_13-10-2022;Кировская область;21_45_days;SputnikLite;380;65;445;663621;334585;998206
2022.08_13-10-2022;Кировская область;21_45_days;SputnikV;2416;3448;5864;663621;334585;998206
2022.08_13-10-2022;Кировская область;45_75_days;AllVaccines;2000;1973;3973;663621;334585;998206
2022.08_13-10-2022;Кировская область;45_75_days;EpiVacCorona;43;42;85;663621;334585;998206
2022.08_13-10-2022;Кировская область;45_75_days;SputnikLite;483;37;520;663621;334585;998206
2022.08_13-10-2022;Кировская область;45_75_days;SputnikV;1474;1894;3368;663621;334585;998206
2022.08_13-10-2022;Кировская область;75_90_days;AllVaccines;1895;2345;4240;663621;334585;998206
2022.08_13-10-2022;Кировская область;75_90_days;EpiVacCorona;118;208;326;663621;334585;998206
2022.08_13-10-2022;Кировская область;75_90_days;SputnikLite;292;16;308;663621;334585;998206
2022.08_13-10-2022;Кировская область;75_90_days;SputnikV;1485;2121;3606;663621;334585;998206
2022.08_13-10-2022;Кировская область;90_105_days;AllVaccines;3196;3715;6911;663621;334585;998206
2022.08_13-10-2022;Кировская область;90_105_days;CoviVac;5;0;5;663621;334585;998206
2022.08_13-10-2022;Кировская область;90_105_days;EpiVacCorona;236;226;462;663621;334585;998206
2022.08_13-10-2022;Кировская область;90_105_days;SputnikLite;313;43;356;663621;334585;998206
2022.08_13-10-2022;Кировская область;90_105_days;SputnikV;2642;3446;6088;663621;334585;998206
2022.08_13-10-2022;Костромская область;105_165_days;AllVaccines;2273;2276;4549;339046;160543;499589
2022.08_13-10-2022;Костромская область;105_165_days;CoviVac;169;115;284;339046;160543;499589
2022.08_13-10-2022;Костромская область;105_165_days;EpiVacCorona;418;322;740;339046;160543;499589
2022.08_13-10-2022;Костромская область;105_165_days;SputnikLite;55;47;102;339046;160543;499589
2022.08_13-10-2022;Костромская область;105_165_days;SputnikV;1631;1792;3423;339046;160543;499589
2022.08_13-10-2022;Костромская область;165_195_days;AllVaccines;2832;1708;4540;339046;160543;499589
2022.08_13-10-2022;Костромская область;165_195_days;CoviVac;141;43;184;339046;160543;499589
2022.08_13-10-2022;Костромская область;165_195_days;EpiVacCorona;413;275;688;339046;160543;499589
2022.08_13-10-2022;Костромская область;165_195_days;SputnikLite;260;180;440;339046;160543;499589
2022.08_13-10-2022;Костромская область;165_195_days;SputnikV;2018;1210;3228;339046;160543;499589
2022.08_13-10-2022;Костромская область;21_45_days;AllVaccines;1793;1197;2990;339046;160543;499589
2022.08_13-10-2022;Костромская область;21_45_days;EpiVacCorona;62;45;107;339046;160543;499589
2022.08_13-10-2022;Костромская область;21_45_days;SputnikLite;94;33;127;339046;160543;499589
2022.08_13-10-2022;Костромская область;21_45_days;SputnikV;1637;1119;2756;339046;160543;499589
2022.08_13-10-2022;Костромская область;45_75_days;AllVaccines;1417;841;2258;339046;160543;499589
2022.08_13-10-2022;Костромская область;45_75_days;EpiVacCorona;146;57;203;339046;160543;499589
2022.08_13-10-2022;Костромская область;45_75_days;SputnikLite;398;222;620;339046;160543;499589
2022.08_13-10-2022;Костромская область;45_75_days;SputnikV;873;562;1435;339046;160543;499589
2022.08_13-10-2022;Костромская область;75_90_days;AllVaccines;599;428;1027;339046;160543;499589
2022.08_13-10-2022;Костромская область;75_90_days;EpiVacCorona;142;111;253;339046;160543;499589
2022.08_13-10-2022;Костромская область;75_90_days;SputnikLite;6;4;10;339046;160543;499589
2022.08_13-10-2022;Костромская область;75_90_days;SputnikV;451;313;764;339046;160543;499589
2022.08_13-10-2022;Костромская область;90_105_days;AllVaccines;477;475;952;339046;160543;499589
2022.08_13-10-2022;Костромская область;90_105_days;EpiVacCorona;86;97;183;339046;160543;499589
2022.08_13-10-2022;Костромская область;90_105_days;SputnikLite;5;3;8;339046;160543;499589
2022.08_13-10-2022;Костромская область;90_105_days;SputnikV;386;375;761;339046;160543;499589
2022.08_13-10-2022;Краснодарский край;105_165_days;AllVaccines;57764;55804;113568;3157155;1334085;4491240
2022.08_13-10-2022;Краснодарский край;105_165_days;CoviVac;3736;2176;5912;3157155;1334085;4491240
2022.08_13-10-2022;Краснодарский край;105_165_days;EpiVacCorona;2754;2948;5702;3157155;1334085;4491240
2022.08_13-10-2022;Краснодарский край;105_165_days;SputnikLite;2984;1343;4327;3157155;1334085;4491240
2022.08_13-10-2022;Краснодарский край;105_165_days;SputnikV;48290;49337;97627;3157155;1334085;4491240
2022.08_13-10-2022;Краснодарский край;165_195_days;AllVaccines;53398;58510;111908;3157155;1334085;4491240
2022.08_13-10-2022;Краснодарский край;165_195_days;CoviVac;406;161;567;3157155;1334085;4491240
2022.08_13-10-2022;Краснодарский край;165_195_days;EpiVacCorona;7531;7211;14742;3157155;1334085;4491240
2022.08_13-10-2022;Краснодарский край;165_195_days;SputnikLite;4556;4007;8563;3157155;1334085;4491240
2022.08_13-10-2022;Краснодарский край;165_195_days;SputnikV;40905;47131;88036;3157155;1334085;4491240
2022.08_13-10-2022;Краснодарский край;21_45_days;AllVaccines;27567;14912;42479;3157155;1334085;4491240
2022.08_13-10-2022;Краснодарский край;21_45_days;CoviVac;69;38;107;3157155;1334085;4491240
2022.08_13-10-2022;Краснодарский край;21_45_days;EpiVacCorona;81;22;103;3157155;1334085;4491240
2022.08_13-10-2022;Краснодарский край;21_45_days;SputnikLite;2191;445;2636;3157155;1334085;4491240
2022.08_13-10-2022;Краснодарский край;21_45_days;SputnikV;25226;14407;39633;3157155;1334085;4491240
2022.08_13-10-2022;Краснодарский край;45_75_days;AllVaccines;20540;13101;33641;3157155;1334085;4491240
2022.08_13-10-2022;Краснодарский край;45_75_days;CoviVac;498;141;639;3157155;1334085;4491240
2022.08_13-10-2022;Краснодарский край;45_75_days;EpiVacCorona;1372;480;1852;3157155;1334085;4491240
2022.08_13-10-2022;Краснодарский край;45_75_days;SputnikLite;1207;529;1736;3157155;1334085;4491240
2022.08_13-10-2022;Краснодарский край;45_75_days;SputnikV;17463;11951;29414;3157155;1334085;4491240
2022.08_13-10-2022;Краснодарский край;75_90_days;AllVaccines;18210;11683;29893;3157155;1334085;4491240
2022.08_13-10-2022;Краснодарский край;75_90_days;CoviVac;1014;560;1574;3157155;1334085;4491240
2022.08_13-10-2022;Краснодарский край;75_90_days;EpiVacCorona;3248;1386;4634;3157155;1334085;4491240
2022.08_13-10-2022;Краснодарский край;75_90_days;SputnikLite;664;261;925;3157155;1334085;4491240
2022.08_13-10-2022;Краснодарский край;75_90_days;SputnikV;13284;9476;22760;3157155;1334085;4491240
2022.08_13-10-2022;Краснодарский край;90_105_days;AllVaccines;17997;14796;32793;3157155;1334085;4491240
2022.08_13-10-2022;Краснодарский край;90_105_days;CoviVac;582;446;1028;3157155;1334085;4491240
2022.08_13-10-2022;Краснодарский край;90_105_days;EpiVacCorona;1451;1445;2896;3157155;1334085;4491240
2022.08_13-10-2022;Краснодарский край;90_105_days;SputnikLite;723;239;962;3157155;1334085;4491240
2022.08_13-10-2022;Краснодарский край;90_105_days;SputnikV;15241;12666;27907;3157155;1334085;4491240
2022.08_13-10-2022;Красноярский край;105_165_days;AllVaccines;28691;14537;43228;1637377;585822;2223199
2022.08_13-10-2022;Красноярский край;105_165_days;CoviVac;1521;566;2087;1637377;585822;2223199
2022.08_13-10-2022;Красноярский край;105_165_days;EpiVacCorona;2475;1621;4096;1637377;585822;2223199
2022.08_13-10-2022;Красноярский край;105_165_days;SputnikLite;5978;1011;6989;1637377;585822;2223199
2022.08_13-10-2022;Красноярский край;105_165_days;SputnikV;18717;11339;30056;1637377;585822;2223199
2022.08_13-10-2022;Красноярский край;165_195_days;AllVaccines;24073;8664;32737;1637377;585822;2223199
2022.08_13-10-2022;Красноярский край;165_195_days;CoviVac;575;342;917;1637377;585822;2223199
2022.08_13-10-2022;Красноярский край;165_195_days;EpiVacCorona;1271;628;1899;1637377;585822;2223199
2022.08_13-10-2022;Красноярский край;165_195_days;SputnikLite;4420;772;5192;1637377;585822;2223199
2022.08_13-10-2022;Красноярский край;165_195_days;SputnikV;17807;6922;24729;1637377;585822;2223199
2022.08_13-10-2022;Красноярский край;21_45_days;AllVaccines;15225;10199;25424;1637377;585822;2223199
2022.08_13-10-2022;Красноярский край;21_45_days;CoviVac;2;1;3;1637377;585822;2223199
2022.08_13-10-2022;Красноярский край;21_45_days;EpiVacCorona;79;43;122;1637377;585822;2223199
2022.08_13-10-2022;Красноярский край;21_45_days;SputnikLite;354;74;428;1637377;585822;2223199
2022.08_13-10-2022;Красноярский край;21_45_days;SputnikV;14790;10081;24871;1637377;585822;2223199
2022.08_13-10-2022;Красноярский край;45_75_days;AllVaccines;8857;5574;14431;1637377;585822;2223199
2022.08_13-10-2022;Красноярский край;45_75_days;CoviVac;20;0;20;1637377;585822;2223199
2022.08_13-10-2022;Красноярский край;45_75_days;EpiVacCorona;701;408;1109;1637377;585822;2223199
2022.08_13-10-2022;Красноярский край;45_75_days;SputnikLite;412;128;540;1637377;585822;2223199
2022.08_13-10-2022;Красноярский край;45_75_days;SputnikV;7724;5038;12762;1637377;585822;2223199
2022.08_13-10-2022;Красноярский край;75_90_days;AllVaccines;5444;3539;8983;1637377;585822;2223199
2022.08_13-10-2022;Красноярский край;75_90_days;CoviVac;307;119;426;1637377;585822;2223199
2022.08_13-10-2022;Красноярский край;75_90_days;EpiVacCorona;739;495;1234;1637377;585822;2223199
2022.08_13-10-2022;Красноярский край;75_90_days;SputnikLite;277;22;299;1637377;585822;2223199
2022.08_13-10-2022;Красноярский край;75_90_days;SputnikV;4121;2903;7024;1637377;585822;2223199
2022.08_13-10-2022;Красноярский край;90_105_days;AllVaccines;5858;3429;9287;1637377;585822;2223199
2022.08_13-10-2022;Красноярский край;90_105_days;CoviVac;312;90;402;1637377;585822;2223199
2022.08_13-10-2022;Красноярский край;90_105_days;EpiVacCorona;828;493;1321;1637377;585822;2223199
2022.08_13-10-2022;Красноярский край;90_105_days;SputnikLite;732;105;837;1637377;585822;2223199
2022.08_13-10-2022;Красноярский край;90_105_days;SputnikV;3986;2741;6727;1637377;585822;2223199
2022.08_13-10-2022;Курганская область;105_165_days;AllVaccines;6490;6244;12734;425081;217502;642583
2022.08_13-10-2022;Курганская область;105_165_days;CoviVac;147;224;371;425081;217502;642583
2022.08_13-10-2022;Курганская область;105_165_days;EpiVacCorona;947;847;1794;425081;217502;642583
2022.08_13-10-2022;Курганская область;105_165_days;SputnikLite;1381;736;2117;425081;217502;642583
2022.08_13-10-2022;Курганская область;105_165_days;SputnikV;4015;4437;8452;425081;217502;642583
2022.08_13-10-2022;Курганская область;165_195_days;AllVaccines;5370;3565;8935;425081;217502;642583
2022.08_13-10-2022;Курганская область;165_195_days;CoviVac;72;15;87;425081;217502;642583
2022.08_13-10-2022;Курганская область;165_195_days;EpiVacCorona;712;502;1214;425081;217502;642583
2022.08_13-10-2022;Курганская область;165_195_days;SputnikLite;2284;1399;3683;425081;217502;642583
2022.08_13-10-2022;Курганская область;165_195_days;SputnikV;2302;1649;3951;425081;217502;642583
2022.08_13-10-2022;Курганская область;21_45_days;AllVaccines;5417;4373;9790;425081;217502;642583
2022.08_13-10-2022;Курганская область;21_45_days;CoviVac;68;35;103;425081;217502;642583
2022.08_13-10-2022;Курганская область;21_45_days;EpiVacCorona;822;794;1616;425081;217502;642583
2022.08_13-10-2022;Курганская область;21_45_days;SputnikLite;254;186;440;425081;217502;642583
2022.08_13-10-2022;Курганская область;21_45_days;SputnikV;4273;3358;7631;425081;217502;642583
2022.08_13-10-2022;Курганская область;45_75_days;AllVaccines;3374;3065;6439;425081;217502;642583
2022.08_13-10-2022;Курганская область;45_75_days;CoviVac;51;23;74;425081;217502;642583
2022.08_13-10-2022;Курганская область;45_75_days;EpiVacCorona;612;585;1197;425081;217502;642583
2022.08_13-10-2022;Курганская область;45_75_days;SputnikLite;151;100;251;425081;217502;642583
2022.08_13-10-2022;Курганская область;45_75_days;SputnikV;2560;2357;4917;425081;217502;642583
2022.08_13-10-2022;Курганская область;75_90_days;AllVaccines;2744;2636;5380;425081;217502;642583
2022.08_13-10-2022;Курганская область;75_90_days;CoviVac;59;49;108;425081;217502;642583
2022.08_13-10-2022;Курганская область;75_90_days;EpiVacCorona;607;608;1215;425081;217502;642583
2022.08_13-10-2022;Курганская область;75_90_days;SputnikLite;45;19;64;425081;217502;642583
2022.08_13-10-2022;Курганская область;75_90_days;SputnikV;2033;1960;3993;425081;217502;642583
2022.08_13-10-2022;Курганская область;90_105_days;AllVaccines;2344;2930;5274;425081;217502;642583
2022.08_13-10-2022;Курганская область;90_105_days;CoviVac;157;215;372;425081;217502;642583
2022.08_13-10-2022;Курганская область;90_105_days;EpiVacCorona;492;499;991;425081;217502;642583
2022.08_13-10-2022;Курганская область;90_105_days;SputnikLite;93;72;165;425081;217502;642583
2022.08_13-10-2022;Курганская область;90_105_days;SputnikV;1602;2144;3746;425081;217502;642583
2022.08_13-10-2022;Курская область;105_165_days;AllVaccines;11274;6952;18226;604409;285634;890043
2022.08_13-10-2022;Курская область;105_165_days;CoviVac;202;24;226;604409;285634;890043
2022.08_13-10-2022;Курская область;105_165_days;EpiVacCorona;722;376;1098;604409;285634;890043
2022.08_13-10-2022;Курская область;105_165_days;SputnikLite;3395;1302;4697;604409;285634;890043
2022.08_13-10-2022;Курская область;105_165_days;SputnikV;6955;5250;12205;604409;285634;890043
2022.08_13-10-2022;Курская область;165_195_days;AllVaccines;9493;3414;12907;604409;285634;890043
2022.08_13-10-2022;Курская область;165_195_days;CoviVac;489;103;592;604409;285634;890043
2022.08_13-10-2022;Курская область;165_195_days;EpiVacCorona;538;216;754;604409;285634;890043
2022.08_13-10-2022;Курская область;165_195_days;SputnikLite;2272;527;2799;604409;285634;890043
2022.08_13-10-2022;Курская область;165_195_days;SputnikV;6194;2568;8762;604409;285634;890043
2022.08_13-10-2022;Курская область;21_45_days;AllVaccines;7208;3238;10446;604409;285634;890043
2022.08_13-10-2022;Курская область;21_45_days;EpiVacCorona;1;0;1;604409;285634;890043
2022.08_13-10-2022;Курская область;21_45_days;SputnikLite;176;59;235;604409;285634;890043
2022.08_13-10-2022;Курская область;21_45_days;SputnikV;7031;3179;10210;604409;285634;890043
2022.08_13-10-2022;Курская область;45_75_days;AllVaccines;3034;1646;4680;604409;285634;890043
2022.08_13-10-2022;Курская область;45_75_days;CoviVac;1;0;1;604409;285634;890043
2022.08_13-10-2022;Курская область;45_75_days;EpiVacCorona;105;61;166;604409;285634;890043
2022.08_13-10-2022;Курская область;45_75_days;SputnikLite;649;304;953;604409;285634;890043
2022.08_13-10-2022;Курская область;45_75_days;SputnikV;2279;1281;3560;604409;285634;890043
2022.08_13-10-2022;Курская область;75_90_days;AllVaccines;1967;1333;3300;604409;285634;890043
2022.08_13-10-2022;Курская область;75_90_days;EpiVacCorona;180;115;295;604409;285634;890043
2022.08_13-10-2022;Курская область;75_90_days;SputnikLite;593;356;949;604409;285634;890043
2022.08_13-10-2022;Курская область;75_90_days;SputnikV;1194;862;2056;604409;285634;890043
2022.08_13-10-2022;Курская область;90_105_days;AllVaccines;3360;2817;6177;604409;285634;890043
2022.08_13-10-2022;Курская область;90_105_days;EpiVacCorona;161;124;285;604409;285634;890043
2022.08_13-10-2022;Курская область;90_105_days;SputnikLite;1477;1005;2482;604409;285634;890043
2022.08_13-10-2022;Курская область;90_105_days;SputnikV;1722;1688;3410;604409;285634;890043
2022.08_13-10-2022;Ленинградская область;105_165_days;AllVaccines;9325;7373;16698;1100343;462742;1563085
2022.08_13-10-2022;Ленинградская область;105_165_days;CoviVac;392;167;559;1100343;462742;1563085
2022.08_13-10-2022;Ленинградская область;105_165_days;EpiVacCorona;226;85;311;1100343;462742;1563085
2022.08_13-10-2022;Ленинградская область;105_165_days;SputnikLite;1876;1374;3250;1100343;462742;1563085
2022.08_13-10-2022;Ленинградская область;105_165_days;SputnikV;6831;5747;12578;1100343;462742;1563085
2022.08_13-10-2022;Ленинградская область;165_195_days;AllVaccines;8927;4819;13746;1100343;462742;1563085
2022.08_13-10-2022;Ленинградская область;165_195_days;CoviVac;214;25;239;1100343;462742;1563085
2022.08_13-10-2022;Ленинградская область;165_195_days;EpiVacCorona;168;69;237;1100343;462742;1563085
2022.08_13-10-2022;Ленинградская область;165_195_days;SputnikLite;1937;1369;3306;1100343;462742;1563085
2022.08_13-10-2022;Ленинградская область;165_195_days;SputnikV;6608;3356;9964;1100343;462742;1563085
2022.08_13-10-2022;Ленинградская область;21_45_days;AllVaccines;7543;4544;12087;1100343;462742;1563085
2022.08_13-10-2022;Ленинградская область;21_45_days;CoviVac;33;0;33;1100343;462742;1563085
2022.08_13-10-2022;Ленинградская область;21_45_days;EpiVacCorona;97;65;162;1100343;462742;1563085
2022.08_13-10-2022;Ленинградская область;21_45_days;SputnikLite;615;265;880;1100343;462742;1563085
2022.08_13-10-2022;Ленинградская область;21_45_days;SputnikV;6798;4214;11012;1100343;462742;1563085
2022.08_13-10-2022;Ленинградская область;45_75_days;AllVaccines;4378;2206;6584;1100343;462742;1563085
2022.08_13-10-2022;Ленинградская область;45_75_days;CoviVac;29;9;38;1100343;462742;1563085
2022.08_13-10-2022;Ленинградская область;45_75_days;EpiVacCorona;105;88;193;1100343;462742;1563085
2022.08_13-10-2022;Ленинградская область;45_75_days;SputnikLite;752;390;1142;1100343;462742;1563085
2022.08_13-10-2022;Ленинградская область;45_75_days;SputnikV;3492;1719;5211;1100343;462742;1563085
2022.08_13-10-2022;Ленинградская область;75_90_days;AllVaccines;2426;1425;3851;1100343;462742;1563085
2022.08_13-10-2022;Ленинградская область;75_90_days;CoviVac;28;5;33;1100343;462742;1563085
2022.08_13-10-2022;Ленинградская область;75_90_days;EpiVacCorona;47;34;81;1100343;462742;1563085
2022.08_13-10-2022;Ленинградская область;75_90_days;SputnikLite;383;134;517;1100343;462742;1563085
2022.08_13-10-2022;Ленинградская область;75_90_days;SputnikV;1968;1252;3220;1100343;462742;1563085
2022.08_13-10-2022;Ленинградская область;90_105_days;AllVaccines;2091;1605;3696;1100343;462742;1563085
2022.08_13-10-2022;Ленинградская область;90_105_days;CoviVac;27;19;46;1100343;462742;1563085
2022.08_13-10-2022;Ленинградская область;90_105_days;EpiVacCorona;57;43;100;1100343;462742;1563085
2022.08_13-10-2022;Ленинградская область;90_105_days;SputnikLite;244;99;343;1100343;462742;1563085
2022.08_13-10-2022;Ленинградская область;90_105_days;SputnikV;1763;1444;3207;1100343;462742;1563085
2022.08_13-10-2022;Липецкая область;105_165_days;AllVaccines;17074;12306;29380;621641;290878;912519
2022.08_13-10-2022;Липецкая область;105_165_days;CoviVac;932;134;1066;621641;290878;912519
2022.08_13-10-2022;Липецкая область;105_165_days;EpiVacCorona;1838;2112;3950;621641;290878;912519
2022.08_13-10-2022;Липецкая область;105_165_days;SputnikLite;668;343;1011;621641;290878;912519
2022.08_13-10-2022;Липецкая область;105_165_days;SputnikV;13636;9717;23353;621641;290878;912519
2022.08_13-10-2022;Липецкая область;165_195_days;AllVaccines;12258;5189;17447;621641;290878;912519
2022.08_13-10-2022;Липецкая область;165_195_days;CoviVac;723;56;779;621641;290878;912519
2022.08_13-10-2022;Липецкая область;165_195_days;EpiVacCorona;885;687;1572;621641;290878;912519
2022.08_13-10-2022;Липецкая область;165_195_days;SputnikLite;2073;947;3020;621641;290878;912519
2022.08_13-10-2022;Липецкая область;165_195_days;SputnikV;8577;3499;12076;621641;290878;912519
2022.08_13-10-2022;Липецкая область;21_45_days;AllVaccines;7970;3999;11969;621641;290878;912519
2022.08_13-10-2022;Липецкая область;21_45_days;EpiVacCorona;85;5;90;621641;290878;912519
2022.08_13-10-2022;Липецкая область;21_45_days;SputnikLite;63;9;72;621641;290878;912519
2022.08_13-10-2022;Липецкая область;21_45_days;SputnikV;7822;3985;11807;621641;290878;912519
2022.08_13-10-2022;Липецкая область;45_75_days;AllVaccines;7314;3234;10548;621641;290878;912519
2022.08_13-10-2022;Липецкая область;45_75_days;EpiVacCorona;1580;486;2066;621641;290878;912519
2022.08_13-10-2022;Липецкая область;45_75_days;SputnikLite;208;15;223;621641;290878;912519
2022.08_13-10-2022;Липецкая область;45_75_days;SputnikV;5526;2733;8259;621641;290878;912519
2022.08_13-10-2022;Липецкая область;75_90_days;AllVaccines;6208;2965;9173;621641;290878;912519
2022.08_13-10-2022;Липецкая область;75_90_days;CoviVac;237;30;267;621641;290878;912519
2022.08_13-10-2022;Липецкая область;75_90_days;EpiVacCorona;1509;501;2010;621641;290878;912519
2022.08_13-10-2022;Липецкая область;75_90_days;SputnikLite;85;4;89;621641;290878;912519
2022.08_13-10-2022;Липецкая область;75_90_days;SputnikV;4377;2430;6807;621641;290878;912519
2022.08_13-10-2022;Липецкая область;90_105_days;AllVaccines;5457;3820;9277;621641;290878;912519
2022.08_13-10-2022;Липецкая область;90_105_days;CoviVac;87;20;107;621641;290878;912519
2022.08_13-10-2022;Липецкая область;90_105_days;EpiVacCorona;592;212;804;621641;290878;912519
2022.08_13-10-2022;Липецкая область;90_105_days;SputnikLite;35;5;40;621641;290878;912519
2022.08_13-10-2022;Липецкая область;90_105_days;SputnikV;4743;3583;8326;621641;290878;912519
2022.08_13-10-2022;Магаданская область;105_165_days;AllVaccines;2588;759;3347;83196;26810;110006
2022.08_13-10-2022;Магаданская область;105_165_days;CoviVac;1;0;1;83196;26810;110006
2022.08_13-10-2022;Магаданская область;105_165_days;EpiVacCorona;65;18;83;83196;26810;110006
2022.08_13-10-2022;Магаданская область;105_165_days;SputnikLite;2017;603;2620;83196;26810;110006
2022.08_13-10-2022;Магаданская область;105_165_days;SputnikV;505;138;643;83196;26810;110006
2022.08_13-10-2022;Магаданская область;165_195_days;AllVaccines;1554;484;2038;83196;26810;110006
2022.08_13-10-2022;Магаданская область;165_195_days;CoviVac;7;4;11;83196;26810;110006
2022.08_13-10-2022;Магаданская область;165_195_days;EpiVacCorona;74;15;89;83196;26810;110006
2022.08_13-10-2022;Магаданская область;165_195_days;SputnikLite;922;300;1222;83196;26810;110006
2022.08_13-10-2022;Магаданская область;165_195_days;SputnikV;551;165;716;83196;26810;110006
2022.08_13-10-2022;Магаданская область;21_45_days;AllVaccines;876;355;1231;83196;26810;110006
2022.08_13-10-2022;Магаданская область;21_45_days;SputnikLite;14;12;26;83196;26810;110006
2022.08_13-10-2022;Магаданская область;21_45_days;SputnikV;862;343;1205;83196;26810;110006
2022.08_13-10-2022;Магаданская область;45_75_days;AllVaccines;625;205;830;83196;26810;110006
2022.08_13-10-2022;Магаданская область;45_75_days;EpiVacCorona;10;0;10;83196;26810;110006
2022.08_13-10-2022;Магаданская область;45_75_days;SputnikLite;154;58;212;83196;26810;110006
2022.08_13-10-2022;Магаданская область;45_75_days;SputnikV;461;147;608;83196;26810;110006
2022.08_13-10-2022;Магаданская область;75_90_days;AllVaccines;547;143;690;83196;26810;110006
2022.08_13-10-2022;Магаданская область;75_90_days;EpiVacCorona;45;9;54;83196;26810;110006
2022.08_13-10-2022;Магаданская область;75_90_days;SputnikLite;222;60;282;83196;26810;110006
2022.08_13-10-2022;Магаданская область;75_90_days;SputnikV;280;74;354;83196;26810;110006
2022.08_13-10-2022;Магаданская область;90_105_days;AllVaccines;321;70;391;83196;26810;110006
2022.08_13-10-2022;Магаданская область;90_105_days;EpiVacCorona;39;2;41;83196;26810;110006
2022.08_13-10-2022;Магаданская область;90_105_days;SputnikLite;190;38;228;83196;26810;110006
2022.08_13-10-2022;Магаданская область;90_105_days;SputnikV;92;30;122;83196;26810;110006
2022.08_13-10-2022;Московская область;105_165_days;AllVaccines;69485;39202;108687;4485323;1674471;6159794
2022.08_13-10-2022;Московская область;105_165_days;CoviVac;692;270;962;4485323;1674471;6159794
2022.08_13-10-2022;Московская область;105_165_days;EpiVacCorona;3292;2218;5510;4485323;1674471;6159794
2022.08_13-10-2022;Московская область;105_165_days;SputnikLite;26496;18678;45174;4485323;1674471;6159794
2022.08_13-10-2022;Московская область;105_165_days;SputnikV;39005;18036;57041;4485323;1674471;6159794
2022.08_13-10-2022;Московская область;165_195_days;AllVaccines;62710;25626;88336;4485323;1674471;6159794
2022.08_13-10-2022;Московская область;165_195_days;CoviVac;690;203;893;4485323;1674471;6159794
2022.08_13-10-2022;Московская область;165_195_days;EpiVacCorona;1523;1097;2620;4485323;1674471;6159794
2022.08_13-10-2022;Московская область;165_195_days;SputnikLite;21835;12560;34395;4485323;1674471;6159794
2022.08_13-10-2022;Московская область;165_195_days;SputnikV;38662;11766;50428;4485323;1674471;6159794
2022.08_13-10-2022;Московская область;21_45_days;AllVaccines;70407;20176;90583;4485323;1674471;6159794
2022.08_13-10-2022;Московская область;21_45_days;CoviVac;154;56;210;4485323;1674471;6159794
2022.08_13-10-2022;Московская область;21_45_days;EpiVacCorona;659;170;829;4485323;1674471;6159794
2022.08_13-10-2022;Московская область;21_45_days;SputnikLite;4819;1440;6259;4485323;1674471;6159794
2022.08_13-10-2022;Московская область;21_45_days;SputnikV;64775;18510;83285;4485323;1674471;6159794
2022.08_13-10-2022;Московская область;45_75_days;AllVaccines;39997;13024;53021;4485323;1674471;6159794
2022.08_13-10-2022;Московская область;45_75_days;CoviVac;118;21;139;4485323;1674471;6159794
2022.08_13-10-2022;Московская область;45_75_days;EpiVacCorona;1091;639;1730;4485323;1674471;6159794
2022.08_13-10-2022;Московская область;45_75_days;SputnikLite;9292;3578;12870;4485323;1674471;6159794
2022.08_13-10-2022;Московская область;45_75_days;SputnikV;29496;8786;38282;4485323;1674471;6159794
2022.08_13-10-2022;Московская область;75_90_days;AllVaccines;21667;8094;29761;4485323;1674471;6159794
2022.08_13-10-2022;Московская область;75_90_days;CoviVac;231;46;277;4485323;1674471;6159794
2022.08_13-10-2022;Московская область;75_90_days;EpiVacCorona;1828;1121;2949;4485323;1674471;6159794
2022.08_13-10-2022;Московская область;75_90_days;SputnikLite;4533;1813;6346;4485323;1674471;6159794
2022.08_13-10-2022;Московская область;75_90_days;SputnikV;15075;5114;20189;4485323;1674471;6159794
2022.08_13-10-2022;Московская область;90_105_days;AllVaccines;20557;9115;29672;4485323;1674471;6159794
2022.08_13-10-2022;Московская область;90_105_days;CoviVac;168;53;221;4485323;1674471;6159794
2022.08_13-10-2022;Московская область;90_105_days;EpiVacCorona;1360;641;2001;4485323;1674471;6159794
2022.08_13-10-2022;Московская область;90_105_days;SputnikLite;4559;2194;6753;4485323;1674471;6159794
2022.08_13-10-2022;Московская область;90_105_days;SputnikV;14470;6227;20697;4485323;1674471;6159794
2022.08_13-10-2022;Мурманская область;105_165_days;AllVaccines;8828;3856;12684;436555;144366;580921
2022.08_13-10-2022;Мурманская область;105_165_days;CoviVac;218;64;282;436555;144366;580921
2022.08_13-10-2022;Мурманская область;105_165_days;EpiVacCorona;137;65;202;436555;144366;580921
2022.08_13-10-2022;Мурманская область;105_165_days;SputnikLite;4292;1801;6093;436555;144366;580921
2022.08_13-10-2022;Мурманская область;105_165_days;SputnikV;4181;1926;6107;436555;144366;580921
2022.08_13-10-2022;Мурманская область;165_195_days;AllVaccines;6992;2717;9709;436555;144366;580921
2022.08_13-10-2022;Мурманская область;165_195_days;CoviVac;200;36;236;436555;144366;580921
2022.08_13-10-2022;Мурманская область;165_195_days;EpiVacCorona;35;17;52;436555;144366;580921
2022.08_13-10-2022;Мурманская область;165_195_days;SputnikLite;3705;1697;5402;436555;144366;580921
2022.08_13-10-2022;Мурманская область;165_195_days;SputnikV;3052;967;4019;436555;144366;580921
2022.08_13-10-2022;Мурманская область;21_45_days;AllVaccines;3679;1164;4843;436555;144366;580921
2022.08_13-10-2022;Мурманская область;21_45_days;EpiVacCorona;1;0;1;436555;144366;580921
2022.08_13-10-2022;Мурманская область;21_45_days;SputnikLite;37;6;43;436555;144366;580921
2022.08_13-10-2022;Мурманская область;21_45_days;SputnikV;3641;1158;4799;436555;144366;580921
2022.08_13-10-2022;Мурманская область;45_75_days;AllVaccines;3391;1038;4429;436555;144366;580921
2022.08_13-10-2022;Мурманская область;45_75_days;EpiVacCorona;11;2;13;436555;144366;580921
2022.08_13-10-2022;Мурманская область;45_75_days;SputnikLite;160;45;205;436555;144366;580921
2022.08_13-10-2022;Мурманская область;45_75_days;SputnikV;3220;991;4211;436555;144366;580921
2022.08_13-10-2022;Мурманская область;75_90_days;AllVaccines;2208;660;2868;436555;144366;580921
2022.08_13-10-2022;Мурманская область;75_90_days;EpiVacCorona;55;36;91;436555;144366;580921
2022.08_13-10-2022;Мурманская область;75_90_days;SputnikLite;210;43;253;436555;144366;580921
2022.08_13-10-2022;Мурманская область;75_90_days;SputnikV;1943;581;2524;436555;144366;580921
2022.08_13-10-2022;Мурманская область;90_105_days;AllVaccines;1885;1028;2913;436555;144366;580921
2022.08_13-10-2022;Мурманская область;90_105_days;EpiVacCorona;86;39;125;436555;144366;580921
2022.08_13-10-2022;Мурманская область;90_105_days;SputnikLite;285;92;377;436555;144366;580921
2022.08_13-10-2022;Мурманская область;90_105_days;SputnikV;1514;897;2411;436555;144366;580921
2022.08_13-10-2022;Ненецкий автономный округ;105_165_days;AllVaccines;587;251;838;24931;7449;32380
2022.08_13-10-2022;Ненецкий автономный округ;105_165_days;EpiVacCorona;4;0;4;24931;7449;32380
2022.08_13-10-2022;Ненецкий автономный округ;105_165_days;SputnikLite;544;235;779;24931;7449;32380
2022.08_13-10-2022;Ненецкий автономный округ;105_165_days;SputnikV;39;16;55;24931;7449;32380
2022.08_13-10-2022;Ненецкий автономный округ;165_195_days;AllVaccines;260;143;403;24931;7449;32380
2022.08_13-10-2022;Ненецкий автономный округ;165_195_days;EpiVacCorona;3;0;3;24931;7449;32380
2022.08_13-10-2022;Ненецкий автономный округ;165_195_days;SputnikLite;232;122;354;24931;7449;32380
2022.08_13-10-2022;Ненецкий автономный округ;165_195_days;SputnikV;25;21;46;24931;7449;32380
2022.08_13-10-2022;Ненецкий автономный округ;21_45_days;AllVaccines;310;159;469;24931;7449;32380
2022.08_13-10-2022;Ненецкий автономный округ;21_45_days;SputnikLite;301;152;453;24931;7449;32380
2022.08_13-10-2022;Ненецкий автономный округ;21_45_days;SputnikV;9;7;16;24931;7449;32380
2022.08_13-10-2022;Ненецкий автономный округ;45_75_days;AllVaccines;181;122;303;24931;7449;32380
2022.08_13-10-2022;Ненецкий автономный округ;45_75_days;SputnikLite;173;117;290;24931;7449;32380
2022.08_13-10-2022;Ненецкий автономный округ;45_75_days;SputnikV;8;5;13;24931;7449;32380
2022.08_13-10-2022;Ненецкий автономный округ;75_90_days;AllVaccines;132;33;165;24931;7449;32380
2022.08_13-10-2022;Ненецкий автономный округ;75_90_days;SputnikLite;118;32;150;24931;7449;32380
2022.08_13-10-2022;Ненецкий автономный округ;75_90_days;SputnikV;14;1;15;24931;7449;32380
2022.08_13-10-2022;Ненецкий автономный округ;90_105_days;AllVaccines;149;52;201;24931;7449;32380
2022.08_13-10-2022;Ненецкий автономный округ;90_105_days;SputnikLite;130;50;180;24931;7449;32380
2022.08_13-10-2022;Ненецкий автономный округ;90_105_days;SputnikV;19;2;21;24931;7449;32380
2022.08_13-10-2022;Нижегородская область;105_165_days;AllVaccines;15902;14814;30716;1769909;800663;2570572
2022.08_13-10-2022;Нижегородская область;105_165_days;CoviVac;446;141;587;1769909;800663;2570572
2022.08_13-10-2022;Нижегородская область;105_165_days;EpiVacCorona;1250;853;2103;1769909;800663;2570572
2022.08_13-10-2022;Нижегородская область;105_165_days;SputnikLite;2097;1530;3627;1769909;800663;2570572
2022.08_13-10-2022;Нижегородская область;105_165_days;SputnikV;12109;12290;24399;1769909;800663;2570572
2022.08_13-10-2022;Нижегородская область;165_195_days;AllVaccines;14029;7278;21307;1769909;800663;2570572
2022.08_13-10-2022;Нижегородская область;165_195_days;CoviVac;388;141;529;1769909;800663;2570572
2022.08_13-10-2022;Нижегородская область;165_195_days;EpiVacCorona;1062;953;2015;1769909;800663;2570572
2022.08_13-10-2022;Нижегородская область;165_195_days;SputnikLite;2239;1355;3594;1769909;800663;2570572
2022.08_13-10-2022;Нижегородская область;165_195_days;SputnikV;10340;4829;15169;1769909;800663;2570572
2022.08_13-10-2022;Нижегородская область;21_45_days;AllVaccines;10161;6475;16636;1769909;800663;2570572
2022.08_13-10-2022;Нижегородская область;21_45_days;CoviVac;7;1;8;1769909;800663;2570572
2022.08_13-10-2022;Нижегородская область;21_45_days;EpiVacCorona;21;9;30;1769909;800663;2570572
2022.08_13-10-2022;Нижегородская область;21_45_days;SputnikLite;866;388;1254;1769909;800663;2570572
2022.08_13-10-2022;Нижегородская область;21_45_days;SputnikV;9267;6077;15344;1769909;800663;2570572
2022.08_13-10-2022;Нижегородская область;45_75_days;AllVaccines;6051;4279;10330;1769909;800663;2570572
2022.08_13-10-2022;Нижегородская область;45_75_days;CoviVac;33;6;39;1769909;800663;2570572
2022.08_13-10-2022;Нижегородская область;45_75_days;EpiVacCorona;380;270;650;1769909;800663;2570572
2022.08_13-10-2022;Нижегородская область;45_75_days;SputnikLite;2078;1178;3256;1769909;800663;2570572
2022.08_13-10-2022;Нижегородская область;45_75_days;SputnikV;3560;2825;6385;1769909;800663;2570572
2022.08_13-10-2022;Нижегородская область;75_90_days;AllVaccines;5127;4256;9383;1769909;800663;2570572
2022.08_13-10-2022;Нижегородская область;75_90_days;CoviVac;128;39;167;1769909;800663;2570572
2022.08_13-10-2022;Нижегородская область;75_90_days;EpiVacCorona;299;258;557;1769909;800663;2570572
2022.08_13-10-2022;Нижегородская область;75_90_days;SputnikLite;2201;1669;3870;1769909;800663;2570572
2022.08_13-10-2022;Нижегородская область;75_90_days;SputnikV;2499;2290;4789;1769909;800663;2570572
2022.08_13-10-2022;Нижегородская область;90_105_days;AllVaccines;6174;6366;12540;1769909;800663;2570572
2022.08_13-10-2022;Нижегородская область;90_105_days;CoviVac;34;5;39;1769909;800663;2570572
2022.08_13-10-2022;Нижегородская область;90_105_days;EpiVacCorona;291;222;513;1769909;800663;2570572
2022.08_13-10-2022;Нижегородская область;90_105_days;SputnikLite;2690;2561;5251;1769909;800663;2570572
2022.08_13-10-2022;Нижегородская область;90_105_days;SputnikV;3159;3578;6737;1769909;800663;2570572
2022.08_13-10-2022;Новгородская область;105_165_days;AllVaccines;2828;2692;5520;317276;158308;475584
2022.08_13-10-2022;Новгородская область;105_165_days;CoviVac;210;81;291;317276;158308;475584
2022.08_13-10-2022;Новгородская область;105_165_days;EpiVacCorona;90;136;226;317276;158308;475584
2022.08_13-10-2022;Новгородская область;105_165_days;SputnikLite;863;805;1668;317276;158308;475584
2022.08_13-10-2022;Новгородская область;105_165_days;SputnikV;1665;1670;3335;317276;158308;475584
2022.08_13-10-2022;Новгородская область;165_195_days;AllVaccines;2494;1911;4405;317276;158308;475584
2022.08_13-10-2022;Новгородская область;165_195_days;CoviVac;173;51;224;317276;158308;475584
2022.08_13-10-2022;Новгородская область;165_195_days;EpiVacCorona;139;137;276;317276;158308;475584
2022.08_13-10-2022;Новгородская область;165_195_days;SputnikLite;446;474;920;317276;158308;475584
2022.08_13-10-2022;Новгородская область;165_195_days;SputnikV;1736;1249;2985;317276;158308;475584
2022.08_13-10-2022;Новгородская область;21_45_days;AllVaccines;2096;1450;3546;317276;158308;475584
2022.08_13-10-2022;Новгородская область;21_45_days;SputnikLite;879;428;1307;317276;158308;475584
2022.08_13-10-2022;Новгородская область;21_45_days;SputnikV;1217;1022;2239;317276;158308;475584
2022.08_13-10-2022;Новгородская область;45_75_days;AllVaccines;1025;883;1908;317276;158308;475584
2022.08_13-10-2022;Новгородская область;45_75_days;CoviVac;1;1;2;317276;158308;475584
2022.08_13-10-2022;Новгородская область;45_75_days;EpiVacCorona;139;124;263;317276;158308;475584
2022.08_13-10-2022;Новгородская область;45_75_days;SputnikLite;400;375;775;317276;158308;475584
2022.08_13-10-2022;Новгородская область;45_75_days;SputnikV;485;383;868;317276;158308;475584
2022.08_13-10-2022;Новгородская область;75_90_days;AllVaccines;548;517;1065;317276;158308;475584
2022.08_13-10-2022;Новгородская область;75_90_days;CoviVac;18;5;23;317276;158308;475584
2022.08_13-10-2022;Новгородская область;75_90_days;EpiVacCorona;40;26;66;317276;158308;475584
2022.08_13-10-2022;Новгородская область;75_90_days;SputnikLite;162;165;327;317276;158308;475584
2022.08_13-10-2022;Новгородская область;75_90_days;SputnikV;328;321;649;317276;158308;475584
2022.08_13-10-2022;Новгородская область;90_105_days;AllVaccines;730;673;1403;317276;158308;475584
2022.08_13-10-2022;Новгородская область;90_105_days;CoviVac;35;9;44;317276;158308;475584
2022.08_13-10-2022;Новгородская область;90_105_days;EpiVacCorona;33;22;55;317276;158308;475584
2022.08_13-10-2022;Новгородская область;90_105_days;SputnikLite;137;149;286;317276;158308;475584
2022.08_13-10-2022;Новгородская область;90_105_days;SputnikV;525;493;1018;317276;158308;475584
2022.08_13-10-2022;Новосибирская область;105_165_days;AllVaccines;15924;13040;28964;1571829;624100;2195929
2022.08_13-10-2022;Новосибирская область;105_165_days;CoviVac;1289;347;1636;1571829;624100;2195929
2022.08_13-10-2022;Новосибирская область;105_165_days;EpiVacCorona;1541;1490;3031;1571829;624100;2195929
2022.08_13-10-2022;Новосибирская область;105_165_days;SputnikLite;977;537;1514;1571829;624100;2195929
2022.08_13-10-2022;Новосибирская область;105_165_days;SputnikV;12117;10666;22783;1571829;624100;2195929
2022.08_13-10-2022;Новосибирская область;165_195_days;AllVaccines;12638;6889;19527;1571829;624100;2195929
2022.08_13-10-2022;Новосибирская область;165_195_days;CoviVac;615;184;799;1571829;624100;2195929
2022.08_13-10-2022;Новосибирская область;165_195_days;EpiVacCorona;525;274;799;1571829;624100;2195929
2022.08_13-10-2022;Новосибирская область;165_195_days;SputnikLite;794;477;1271;1571829;624100;2195929
2022.08_13-10-2022;Новосибирская область;165_195_days;SputnikV;10704;5954;16658;1571829;624100;2195929
2022.08_13-10-2022;Новосибирская область;21_45_days;AllVaccines;9539;10257;19796;1571829;624100;2195929
2022.08_13-10-2022;Новосибирская область;21_45_days;CoviVac;1;0;1;1571829;624100;2195929
2022.08_13-10-2022;Новосибирская область;21_45_days;EpiVacCorona;41;27;68;1571829;624100;2195929
2022.08_13-10-2022;Новосибирская область;21_45_days;SputnikLite;274;76;350;1571829;624100;2195929
2022.08_13-10-2022;Новосибирская область;21_45_days;SputnikV;9223;10154;19377;1571829;624100;2195929
2022.08_13-10-2022;Новосибирская область;45_75_days;AllVaccines;6053;6975;13028;1571829;624100;2195929
2022.08_13-10-2022;Новосибирская область;45_75_days;CoviVac;2;0;2;1571829;624100;2195929
2022.08_13-10-2022;Новосибирская область;45_75_days;EpiVacCorona;489;498;987;1571829;624100;2195929
2022.08_13-10-2022;Новосибирская область;45_75_days;SputnikLite;47;8;55;1571829;624100;2195929
2022.08_13-10-2022;Новосибирская область;45_75_days;SputnikV;5515;6469;11984;1571829;624100;2195929
2022.08_13-10-2022;Новосибирская область;75_90_days;AllVaccines;3780;4016;7796;1571829;624100;2195929
2022.08_13-10-2022;Новосибирская область;75_90_days;CoviVac;17;6;23;1571829;624100;2195929
2022.08_13-10-2022;Новосибирская область;75_90_days;EpiVacCorona;616;544;1160;1571829;624100;2195929
2022.08_13-10-2022;Новосибирская область;75_90_days;SputnikLite;26;15;41;1571829;624100;2195929
2022.08_13-10-2022;Новосибирская область;75_90_days;SputnikV;3121;3451;6572;1571829;624100;2195929
2022.08_13-10-2022;Новосибирская область;90_105_days;AllVaccines;3059;3264;6323;1571829;624100;2195929
2022.08_13-10-2022;Новосибирская область;90_105_days;CoviVac;61;36;97;1571829;624100;2195929
2022.08_13-10-2022;Новосибирская область;90_105_days;EpiVacCorona;425;480;905;1571829;624100;2195929
2022.08_13-10-2022;Новосибирская область;90_105_days;SputnikLite;61;40;101;1571829;624100;2195929
2022.08_13-10-2022;Новосибирская область;90_105_days;SputnikV;2512;2708;5220;1571829;624100;2195929
2022.08_13-10-2022;Омская область;105_165_days;AllVaccines;17689;8868;26557;1058291;431046;1489337
2022.08_13-10-2022;Омская область;105_165_days;CoviVac;913;226;1139;1058291;431046;1489337
2022.08_13-10-2022;Омская область;105_165_days;EpiVacCorona;2217;995;3212;1058291;431046;1489337
2022.08_13-10-2022;Омская область;105_165_days;SputnikLite;2104;987;3091;1058291;431046;1489337
2022.08_13-10-2022;Омская область;105_165_days;SputnikV;12455;6660;19115;1058291;431046;1489337
2022.08_13-10-2022;Омская область;165_195_days;AllVaccines;17119;6208;23327;1058291;431046;1489337
2022.08_13-10-2022;Омская область;165_195_days;CoviVac;394;89;483;1058291;431046;1489337
2022.08_13-10-2022;Омская область;165_195_days;EpiVacCorona;1086;457;1543;1058291;431046;1489337
2022.08_13-10-2022;Омская область;165_195_days;SputnikLite;5039;1707;6746;1058291;431046;1489337
2022.08_13-10-2022;Омская область;165_195_days;SputnikV;10600;3955;14555;1058291;431046;1489337
2022.08_13-10-2022;Омская область;21_45_days;AllVaccines;11859;5269;17128;1058291;431046;1489337
2022.08_13-10-2022;Омская область;21_45_days;CoviVac;63;6;69;1058291;431046;1489337
2022.08_13-10-2022;Омская область;21_45_days;EpiVacCorona;370;133;503;1058291;431046;1489337
2022.08_13-10-2022;Омская область;21_45_days;SputnikLite;295;133;428;1058291;431046;1489337
2022.08_13-10-2022;Омская область;21_45_days;SputnikV;11131;4997;16128;1058291;431046;1489337
2022.08_13-10-2022;Омская область;45_75_days;AllVaccines;8616;4010;12626;1058291;431046;1489337
2022.08_13-10-2022;Омская область;45_75_days;CoviVac;36;3;39;1058291;431046;1489337
2022.08_13-10-2022;Омская область;45_75_days;EpiVacCorona;1781;695;2476;1058291;431046;1489337
2022.08_13-10-2022;Омская область;45_75_days;SputnikLite;468;111;579;1058291;431046;1489337
2022.08_13-10-2022;Омская область;45_75_days;SputnikV;6331;3201;9532;1058291;431046;1489337
2022.08_13-10-2022;Омская область;75_90_days;AllVaccines;6326;3186;9512;1058291;431046;1489337
2022.08_13-10-2022;Омская область;75_90_days;CoviVac;39;9;48;1058291;431046;1489337
2022.08_13-10-2022;Омская область;75_90_days;EpiVacCorona;1544;793;2337;1058291;431046;1489337
2022.08_13-10-2022;Омская область;75_90_days;SputnikLite;148;66;214;1058291;431046;1489337
2022.08_13-10-2022;Омская область;75_90_days;SputnikV;4595;2318;6913;1058291;431046;1489337
2022.08_13-10-2022;Омская область;90_105_days;AllVaccines;5103;3224;8327;1058291;431046;1489337
2022.08_13-10-2022;Омская область;90_105_days;CoviVac;60;20;80;1058291;431046;1489337
2022.08_13-10-2022;Омская область;90_105_days;EpiVacCorona;943;409;1352;1058291;431046;1489337
2022.08_13-10-2022;Омская область;90_105_days;SputnikLite;158;102;260;1058291;431046;1489337
2022.08_13-10-2022;Омская область;90_105_days;SputnikV;3942;2693;6635;1058291;431046;1489337
2022.08_13-10-2022;Оренбургская область;105_165_days;AllVaccines;17351;9498;26849;1068899;440686;1509585
2022.08_13-10-2022;Оренбургская область;105_165_days;CoviVac;1297;99;1396;1068899;440686;1509585
2022.08_13-10-2022;Оренбургская область;105_165_days;EpiVacCorona;898;486;1384;1068899;440686;1509585
2022.08_13-10-2022;Оренбургская область;105_165_days;SputnikLite;289;121;410;1068899;440686;1509585
2022.08_13-10-2022;Оренбургская область;105_165_days;SputnikV;14867;8792;23659;1068899;440686;1509585
2022.08_13-10-2022;Оренбургская область;165_195_days;AllVaccines;11875;4199;16074;1068899;440686;1509585
2022.08_13-10-2022;Оренбургская область;165_195_days;CoviVac;619;55;674;1068899;440686;1509585
2022.08_13-10-2022;Оренбургская область;165_195_days;EpiVacCorona;645;228;873;1068899;440686;1509585
2022.08_13-10-2022;Оренбургская область;165_195_days;SputnikLite;625;161;786;1068899;440686;1509585
2022.08_13-10-2022;Оренбургская область;165_195_days;SputnikV;9986;3755;13741;1068899;440686;1509585
2022.08_13-10-2022;Оренбургская область;21_45_days;AllVaccines;7554;3969;11523;1068899;440686;1509585
2022.08_13-10-2022;Оренбургская область;21_45_days;CoviVac;5;2;7;1068899;440686;1509585
2022.08_13-10-2022;Оренбургская область;21_45_days;EpiVacCorona;26;29;55;1068899;440686;1509585
2022.08_13-10-2022;Оренбургская область;21_45_days;SputnikLite;524;146;670;1068899;440686;1509585
2022.08_13-10-2022;Оренбургская область;21_45_days;SputnikV;6999;3792;10791;1068899;440686;1509585
2022.08_13-10-2022;Оренбургская область;45_75_days;AllVaccines;3812;1891;5703;1068899;440686;1509585
2022.08_13-10-2022;Оренбургская область;45_75_days;CoviVac;13;0;13;1068899;440686;1509585
2022.08_13-10-2022;Оренбургская область;45_75_days;EpiVacCorona;175;77;252;1068899;440686;1509585
2022.08_13-10-2022;Оренбургская область;45_75_days;SputnikLite;84;34;118;1068899;440686;1509585
2022.08_13-10-2022;Оренбургская область;45_75_days;SputnikV;3540;1780;5320;1068899;440686;1509585
2022.08_13-10-2022;Оренбургская область;75_90_days;AllVaccines;3767;2271;6038;1068899;440686;1509585
2022.08_13-10-2022;Оренбургская область;75_90_days;CoviVac;193;24;217;1068899;440686;1509585
2022.08_13-10-2022;Оренбургская область;75_90_days;EpiVacCorona;331;187;518;1068899;440686;1509585
2022.08_13-10-2022;Оренбургская область;75_90_days;SputnikLite;31;12;43;1068899;440686;1509585
2022.08_13-10-2022;Оренбургская область;75_90_days;SputnikV;3212;2048;5260;1068899;440686;1509585
2022.08_13-10-2022;Оренбургская область;90_105_days;AllVaccines;4304;3255;7559;1068899;440686;1509585
2022.08_13-10-2022;Оренбургская область;90_105_days;CoviVac;145;8;153;1068899;440686;1509585
2022.08_13-10-2022;Оренбургская область;90_105_days;EpiVacCorona;155;102;257;1068899;440686;1509585
2022.08_13-10-2022;Оренбургская область;90_105_days;SputnikLite;54;27;81;1068899;440686;1509585
2022.08_13-10-2022;Оренбургская область;90_105_days;SputnikV;3950;3118;7068;1068899;440686;1509585
2022.08_13-10-2022;Орловская область;105_165_days;AllVaccines;4007;2810;6817;398663;193123;591786
2022.08_13-10-2022;Орловская область;105_165_days;CoviVac;106;9;115;398663;193123;591786
2022.08_13-10-2022;Орловская область;105_165_days;EpiVacCorona;411;100;511;398663;193123;591786
2022.08_13-10-2022;Орловская область;105_165_days;SputnikLite;248;157;405;398663;193123;591786
2022.08_13-10-2022;Орловская область;105_165_days;SputnikV;3242;2544;5786;398663;193123;591786
2022.08_13-10-2022;Орловская область;165_195_days;AllVaccines;3475;1533;5008;398663;193123;591786
2022.08_13-10-2022;Орловская область;165_195_days;CoviVac;136;18;154;398663;193123;591786
2022.08_13-10-2022;Орловская область;165_195_days;EpiVacCorona;338;106;444;398663;193123;591786
2022.08_13-10-2022;Орловская область;165_195_days;SputnikLite;305;147;452;398663;193123;591786
2022.08_13-10-2022;Орловская область;165_195_days;SputnikV;2696;1262;3958;398663;193123;591786
2022.08_13-10-2022;Орловская область;21_45_days;AllVaccines;3091;1317;4408;398663;193123;591786
2022.08_13-10-2022;Орловская область;21_45_days;EpiVacCorona;3;3;6;398663;193123;591786
2022.08_13-10-2022;Орловская область;21_45_days;SputnikLite;69;12;81;398663;193123;591786
2022.08_13-10-2022;Орловская область;21_45_days;SputnikV;3019;1302;4321;398663;193123;591786
2022.08_13-10-2022;Орловская область;45_75_days;AllVaccines;2338;945;3283;398663;193123;591786
2022.08_13-10-2022;Орловская область;45_75_days;EpiVacCorona;124;55;179;398663;193123;591786
2022.08_13-10-2022;Орловская область;45_75_days;SputnikLite;18;7;25;398663;193123;591786
2022.08_13-10-2022;Орловская область;45_75_days;SputnikV;2196;883;3079;398663;193123;591786
2022.08_13-10-2022;Орловская область;75_90_days;AllVaccines;1795;727;2522;398663;193123;591786
2022.08_13-10-2022;Орловская область;75_90_days;CoviVac;1;0;1;398663;193123;591786
2022.08_13-10-2022;Орловская область;75_90_days;EpiVacCorona;88;21;109;398663;193123;591786
2022.08_13-10-2022;Орловская область;75_90_days;SputnikLite;26;11;37;398663;193123;591786
2022.08_13-10-2022;Орловская область;75_90_days;SputnikV;1680;695;2375;398663;193123;591786
2022.08_13-10-2022;Орловская область;90_105_days;AllVaccines;1579;897;2476;398663;193123;591786
2022.08_13-10-2022;Орловская область;90_105_days;EpiVacCorona;41;36;77;398663;193123;591786
2022.08_13-10-2022;Орловская область;90_105_days;SputnikLite;47;18;65;398663;193123;591786
2022.08_13-10-2022;Орловская область;90_105_days;SputnikV;1491;843;2334;398663;193123;591786
2022.08_13-10-2022;Пензенская область;105_165_days;AllVaccines;34501;47091;81592;710438;350687;1061125
2022.08_13-10-2022;Пензенская область;105_165_days;CoviVac;398;172;570;710438;350687;1061125
2022.08_13-10-2022;Пензенская область;105_165_days;EpiVacCorona;3093;4012;7105;710438;350687;1061125
2022.08_13-10-2022;Пензенская область;105_165_days;SputnikLite;1024;781;1805;710438;350687;1061125
2022.08_13-10-2022;Пензенская область;105_165_days;SputnikV;29986;42126;72112;710438;350687;1061125
2022.08_13-10-2022;Пензенская область;165_195_days;AllVaccines;20713;33397;54110;710438;350687;1061125
2022.08_13-10-2022;Пензенская область;165_195_days;CoviVac;1090;652;1742;710438;350687;1061125
2022.08_13-10-2022;Пензенская область;165_195_days;EpiVacCorona;1682;4428;6110;710438;350687;1061125
2022.08_13-10-2022;Пензенская область;165_195_days;SputnikLite;4250;2603;6853;710438;350687;1061125
2022.08_13-10-2022;Пензенская область;165_195_days;SputnikV;13691;25714;39405;710438;350687;1061125
2022.08_13-10-2022;Пензенская область;21_45_days;AllVaccines;29842;27083;56925;710438;350687;1061125
2022.08_13-10-2022;Пензенская область;21_45_days;CoviVac;1;0;1;710438;350687;1061125
2022.08_13-10-2022;Пензенская область;21_45_days;EpiVacCorona;6;19;25;710438;350687;1061125
2022.08_13-10-2022;Пензенская область;21_45_days;SputnikLite;300;23;323;710438;350687;1061125
2022.08_13-10-2022;Пензенская область;21_45_days;SputnikV;29535;27041;56576;710438;350687;1061125
2022.08_13-10-2022;Пензенская область;45_75_days;AllVaccines;26127;29133;55260;710438;350687;1061125
2022.08_13-10-2022;Пензенская область;45_75_days;CoviVac;0;1;1;710438;350687;1061125
2022.08_13-10-2022;Пензенская область;45_75_days;EpiVacCorona;26;11;37;710438;350687;1061125
2022.08_13-10-2022;Пензенская область;45_75_days;SputnikLite;90;24;114;710438;350687;1061125
2022.08_13-10-2022;Пензенская область;45_75_days;SputnikV;26011;29097;55108;710438;350687;1061125
2022.08_13-10-2022;Пензенская область;75_90_days;AllVaccines;11585;13399;24984;710438;350687;1061125
2022.08_13-10-2022;Пензенская область;75_90_days;CoviVac;1;0;1;710438;350687;1061125
2022.08_13-10-2022;Пензенская область;75_90_days;EpiVacCorona;139;198;337;710438;350687;1061125
2022.08_13-10-2022;Пензенская область;75_90_days;SputnikLite;80;41;121;710438;350687;1061125
2022.08_13-10-2022;Пензенская область;75_90_days;SputnikV;11365;13160;24525;710438;350687;1061125
2022.08_13-10-2022;Пензенская область;90_105_days;AllVaccines;8852;8957;17809;710438;350687;1061125
2022.08_13-10-2022;Пензенская область;90_105_days;EpiVacCorona;354;368;722;710438;350687;1061125
2022.08_13-10-2022;Пензенская область;90_105_days;SputnikLite;217;162;379;710438;350687;1061125
2022.08_13-10-2022;Пензенская область;90_105_days;SputnikV;8281;8427;16708;710438;350687;1061125
2022.08_13-10-2022;Пермский край;105_165_days;AllVaccines;11035;10118;21153;1423011;574038;1997049
2022.08_13-10-2022;Пермский край;105_165_days;CoviVac;391;240;631;1423011;574038;1997049
2022.08_13-10-2022;Пермский край;105_165_days;EpiVacCorona;673;741;1414;1423011;574038;1997049
2022.08_13-10-2022;Пермский край;105_165_days;SputnikLite;1849;966;2815;1423011;574038;1997049
2022.08_13-10-2022;Пермский край;105_165_days;SputnikV;8122;8171;16293;1423011;574038;1997049
2022.08_13-10-2022;Пермский край;165_195_days;AllVaccines;11208;5970;17178;1423011;574038;1997049
2022.08_13-10-2022;Пермский край;165_195_days;CoviVac;357;71;428;1423011;574038;1997049
2022.08_13-10-2022;Пермский край;165_195_days;EpiVacCorona;554;316;870;1423011;574038;1997049
2022.08_13-10-2022;Пермский край;165_195_days;SputnikLite;2282;1140;3422;1423011;574038;1997049
2022.08_13-10-2022;Пермский край;165_195_days;SputnikV;8015;4443;12458;1423011;574038;1997049
2022.08_13-10-2022;Пермский край;21_45_days;AllVaccines;4822;3764;8586;1423011;574038;1997049
2022.08_13-10-2022;Пермский край;21_45_days;CoviVac;1;0;1;1423011;574038;1997049
2022.08_13-10-2022;Пермский край;21_45_days;EpiVacCorona;2;1;3;1423011;574038;1997049
2022.08_13-10-2022;Пермский край;21_45_days;SputnikLite;34;9;43;1423011;574038;1997049
2022.08_13-10-2022;Пермский край;21_45_days;SputnikV;4785;3754;8539;1423011;574038;1997049
2022.08_13-10-2022;Пермский край;45_75_days;AllVaccines;3588;2858;6446;1423011;574038;1997049
2022.08_13-10-2022;Пермский край;45_75_days;CoviVac;1;0;1;1423011;574038;1997049
2022.08_13-10-2022;Пермский край;45_75_days;EpiVacCorona;87;42;129;1423011;574038;1997049
2022.08_13-10-2022;Пермский край;45_75_days;SputnikLite;45;18;63;1423011;574038;1997049
2022.08_13-10-2022;Пермский край;45_75_days;SputnikV;3455;2798;6253;1423011;574038;1997049
2022.08_13-10-2022;Пермский край;75_90_days;AllVaccines;2502;1997;4499;1423011;574038;1997049
2022.08_13-10-2022;Пермский край;75_90_days;CoviVac;1;0;1;1423011;574038;1997049
2022.08_13-10-2022;Пермский край;75_90_days;EpiVacCorona;357;161;518;1423011;574038;1997049
2022.08_13-10-2022;Пермский край;75_90_days;SputnikLite;27;20;47;1423011;574038;1997049
2022.08_13-10-2022;Пермский край;75_90_days;SputnikV;2117;1816;3933;1423011;574038;1997049
2022.08_13-10-2022;Пермский край;90_105_days;AllVaccines;2350;2377;4727;1423011;574038;1997049
2022.08_13-10-2022;Пермский край;90_105_days;CoviVac;1;4;5;1423011;574038;1997049
2022.08_13-10-2022;Пермский край;90_105_days;EpiVacCorona;250;185;435;1423011;574038;1997049
2022.08_13-10-2022;Пермский край;90_105_days;SputnikLite;129;57;186;1423011;574038;1997049
2022.08_13-10-2022;Пермский край;90_105_days;SputnikV;1970;2131;4101;1423011;574038;1997049
2022.08_13-10-2022;Приморский край;105_165_days;AllVaccines;14397;8627;23024;1086430;416518;1502948
2022.08_13-10-2022;Приморский край;105_165_days;CoviVac;737;170;907;1086430;416518;1502948
2022.08_13-10-2022;Приморский край;105_165_days;EpiVacCorona;1245;1116;2361;1086430;416518;1502948
2022.08_13-10-2022;Приморский край;105_165_days;SputnikLite;7002;4272;11274;1086430;416518;1502948
2022.08_13-10-2022;Приморский край;105_165_days;SputnikV;5413;3069;8482;1086430;416518;1502948
2022.08_13-10-2022;Приморский край;165_195_days;AllVaccines;13885;5859;19744;1086430;416518;1502948
2022.08_13-10-2022;Приморский край;165_195_days;CoviVac;216;17;233;1086430;416518;1502948
2022.08_13-10-2022;Приморский край;165_195_days;EpiVacCorona;1245;718;1963;1086430;416518;1502948
2022.08_13-10-2022;Приморский край;165_195_days;SputnikLite;7307;3579;10886;1086430;416518;1502948
2022.08_13-10-2022;Приморский край;165_195_days;SputnikV;5117;1545;6662;1086430;416518;1502948
2022.08_13-10-2022;Приморский край;21_45_days;AllVaccines;7386;3928;11314;1086430;416518;1502948
2022.08_13-10-2022;Приморский край;21_45_days;CoviVac;1;0;1;1086430;416518;1502948
2022.08_13-10-2022;Приморский край;21_45_days;EpiVacCorona;5;2;7;1086430;416518;1502948
2022.08_13-10-2022;Приморский край;21_45_days;SputnikLite;831;148;979;1086430;416518;1502948
2022.08_13-10-2022;Приморский край;21_45_days;SputnikV;6549;3778;10327;1086430;416518;1502948
2022.08_13-10-2022;Приморский край;45_75_days;AllVaccines;3653;2071;5724;1086430;416518;1502948
2022.08_13-10-2022;Приморский край;45_75_days;CoviVac;19;10;29;1086430;416518;1502948
2022.08_13-10-2022;Приморский край;45_75_days;EpiVacCorona;247;110;357;1086430;416518;1502948
2022.08_13-10-2022;Приморский край;45_75_days;SputnikLite;668;289;957;1086430;416518;1502948
2022.08_13-10-2022;Приморский край;45_75_days;SputnikV;2719;1662;4381;1086430;416518;1502948
2022.08_13-10-2022;Приморский край;75_90_days;AllVaccines;3547;2412;5959;1086430;416518;1502948
2022.08_13-10-2022;Приморский край;75_90_days;CoviVac;137;15;152;1086430;416518;1502948
2022.08_13-10-2022;Приморский край;75_90_days;EpiVacCorona;1327;1032;2359;1086430;416518;1502948
2022.08_13-10-2022;Приморский край;75_90_days;SputnikLite;631;395;1026;1086430;416518;1502948
2022.08_13-10-2022;Приморский край;75_90_days;SputnikV;1452;970;2422;1086430;416518;1502948
2022.08_13-10-2022;Приморский край;90_105_days;AllVaccines;2894;1863;4757;1086430;416518;1502948
2022.08_13-10-2022;Приморский край;90_105_days;CoviVac;102;16;118;1086430;416518;1502948
2022.08_13-10-2022;Приморский край;90_105_days;EpiVacCorona;640;510;1150;1086430;416518;1502948
2022.08_13-10-2022;Приморский край;90_105_days;SputnikLite;781;520;1301;1086430;416518;1502948
2022.08_13-10-2022;Приморский край;90_105_days;SputnikV;1371;817;2188;1086430;416518;1502948
2022.08_13-10-2022;Псковская область;105_165_days;AllVaccines;3474;4448;7922;337881;166663;504544
2022.08_13-10-2022;Псковская область;105_165_days;CoviVac;156;58;214;337881;166663;504544
2022.08_13-10-2022;Псковская область;105_165_days;EpiVacCorona;332;207;539;337881;166663;504544
2022.08_13-10-2022;Псковская область;105_165_days;SputnikLite;224;39;263;337881;166663;504544
2022.08_13-10-2022;Псковская область;105_165_days;SputnikV;2762;4144;6906;337881;166663;504544
2022.08_13-10-2022;Псковская область;165_195_days;AllVaccines;3104;1490;4594;337881;166663;504544
2022.08_13-10-2022;Псковская область;165_195_days;CoviVac;96;6;102;337881;166663;504544
2022.08_13-10-2022;Псковская область;165_195_days;EpiVacCorona;188;100;288;337881;166663;504544
2022.08_13-10-2022;Псковская область;165_195_days;SputnikLite;83;39;122;337881;166663;504544
2022.08_13-10-2022;Псковская область;165_195_days;SputnikV;2737;1345;4082;337881;166663;504544
2022.08_13-10-2022;Псковская область;21_45_days;AllVaccines;1470;917;2387;337881;166663;504544
2022.08_13-10-2022;Псковская область;21_45_days;EpiVacCorona;1;0;1;337881;166663;504544
2022.08_13-10-2022;Псковская область;21_45_days;SputnikV;1469;917;2386;337881;166663;504544
2022.08_13-10-2022;Псковская область;45_75_days;AllVaccines;771;523;1294;337881;166663;504544
2022.08_13-10-2022;Псковская область;45_75_days;EpiVacCorona;38;15;53;337881;166663;504544
2022.08_13-10-2022;Псковская область;45_75_days;SputnikLite;8;2;10;337881;166663;504544
2022.08_13-10-2022;Псковская область;45_75_days;SputnikV;725;506;1231;337881;166663;504544
2022.08_13-10-2022;Псковская область;75_90_days;AllVaccines;661;442;1103;337881;166663;504544
2022.08_13-10-2022;Псковская область;75_90_days;CoviVac;6;0;6;337881;166663;504544
2022.08_13-10-2022;Псковская область;75_90_days;EpiVacCorona;109;41;150;337881;166663;504544
2022.08_13-10-2022;Псковская область;75_90_days;SputnikLite;98;3;101;337881;166663;504544
2022.08_13-10-2022;Псковская область;75_90_days;SputnikV;448;398;846;337881;166663;504544
2022.08_13-10-2022;Псковская область;90_105_days;AllVaccines;715;578;1293;337881;166663;504544
2022.08_13-10-2022;Псковская область;90_105_days;CoviVac;6;2;8;337881;166663;504544
2022.08_13-10-2022;Псковская область;90_105_days;EpiVacCorona;85;14;99;337881;166663;504544
2022.08_13-10-2022;Псковская область;90_105_days;SputnikLite;103;9;112;337881;166663;504544
2022.08_13-10-2022;Псковская область;90_105_days;SputnikV;521;553;1074;337881;166663;504544
2022.08_13-10-2022;РФ;105_165_days;AllVaccines;1377825;892361;2270186;82332898;33454776;115787674
2022.08_13-10-2022;РФ;105_165_days;CoviVac;70602;25624;96226;82332898;33454776;115787674
2022.08_13-10-2022;РФ;105_165_days;EpiVacCorona;101315;71770;173085;82332898;33454776;115787674
2022.08_13-10-2022;РФ;105_165_days;SputnikLite;243828;126839;370667;82332898;33454776;115787674
2022.08_13-10-2022;РФ;105_165_days;SputnikV;962080;668128;1630208;82332898;33454776;115787674
2022.08_13-10-2022;РФ;165_195_days;AllVaccines;1102261;569143;1671404;82332898;33454776;115787674
2022.08_13-10-2022;РФ;165_195_days;CoviVac;32328;9469;41797;82332898;33454776;115787674
2022.08_13-10-2022;РФ;165_195_days;EpiVacCorona;79904;49991;129895;82332898;33454776;115787674
2022.08_13-10-2022;РФ;165_195_days;SputnikLite;260322;120972;381294;82332898;33454776;115787674
2022.08_13-10-2022;РФ;165_195_days;SputnikV;729707;388711;1118418;82332898;33454776;115787674
2022.08_13-10-2022;РФ;21_45_days;AllVaccines;781817;401306;1183123;82332898;33454776;115787674
2022.08_13-10-2022;РФ;21_45_days;CoviVac;1383;363;1746;82332898;33454776;115787674
2022.08_13-10-2022;РФ;21_45_days;EpiVacCorona;5939;3055;8994;82332898;33454776;115787674
2022.08_13-10-2022;РФ;21_45_days;SputnikLite;49357;14646;64003;82332898;33454776;115787674
2022.08_13-10-2022;РФ;21_45_days;SputnikV;725138;383242;1108380;82332898;33454776;115787674
2022.08_13-10-2022;РФ;45_75_days;AllVaccines;533479;293612;827091;82332898;33454776;115787674
2022.08_13-10-2022;РФ;45_75_days;CoviVac;2559;699;3258;82332898;33454776;115787674
2022.08_13-10-2022;РФ;45_75_days;EpiVacCorona;33836;19912;53748;82332898;33454776;115787674
2022.08_13-10-2022;РФ;45_75_days;SputnikLite;53738;18934;72672;82332898;33454776;115787674
2022.08_13-10-2022;РФ;45_75_days;SputnikV;443346;254067;697413;82332898;33454776;115787674
2022.08_13-10-2022;РФ;75_90_days;AllVaccines;384017;231275;615292;82332898;33454776;115787674
2022.08_13-10-2022;РФ;75_90_days;CoviVac;10319;3628;13947;82332898;33454776;115787674
2022.08_13-10-2022;РФ;75_90_days;EpiVacCorona;45993;32168;78161;82332898;33454776;115787674
2022.08_13-10-2022;РФ;75_90_days;SputnikLite;29074;11331;40405;82332898;33454776;115787674
2022.08_13-10-2022;РФ;75_90_days;SputnikV;298631;184148;482779;82332898;33454776;115787674
2022.08_13-10-2022;РФ;90_105_days;AllVaccines;368181;254056;622237;82332898;33454776;115787674
2022.08_13-10-2022;РФ;90_105_days;CoviVac;9005;3621;12626;82332898;33454776;115787674
2022.08_13-10-2022;РФ;90_105_days;EpiVacCorona;32449;24231;56680;82332898;33454776;115787674
2022.08_13-10-2022;РФ;90_105_days;SputnikLite;34431;15497;49928;82332898;33454776;115787674
2022.08_13-10-2022;РФ;90_105_days;SputnikV;292296;210707;503003;82332898;33454776;115787674
2022.08_13-10-2022;Республика Адыгея;105_165_days;AllVaccines;1847;1634;3481;256368;104563;360931
2022.08_13-10-2022;Республика Адыгея;105_165_days;CoviVac;8;0;8;256368;104563;360931
2022.08_13-10-2022;Республика Адыгея;105_165_days;EpiVacCorona;34;124;158;256368;104563;360931
2022.08_13-10-2022;Республика Адыгея;105_165_days;SputnikLite;1068;730;1798;256368;104563;360931
2022.08_13-10-2022;Республика Адыгея;105_165_days;SputnikV;737;780;1517;256368;104563;360931
2022.08_13-10-2022;Республика Адыгея;165_195_days;AllVaccines;1854;1265;3119;256368;104563;360931
2022.08_13-10-2022;Республика Адыгея;165_195_days;CoviVac;11;2;13;256368;104563;360931
2022.08_13-10-2022;Республика Адыгея;165_195_days;EpiVacCorona;7;6;13;256368;104563;360931
2022.08_13-10-2022;Республика Адыгея;165_195_days;SputnikLite;1121;791;1912;256368;104563;360931
2022.08_13-10-2022;Республика Адыгея;165_195_days;SputnikV;715;466;1181;256368;104563;360931
2022.08_13-10-2022;Республика Адыгея;21_45_days;AllVaccines;1404;803;2207;256368;104563;360931
2022.08_13-10-2022;Республика Адыгея;21_45_days;EpiVacCorona;0;1;1;256368;104563;360931
2022.08_13-10-2022;Республика Адыгея;21_45_days;SputnikLite;214;20;234;256368;104563;360931
2022.08_13-10-2022;Республика Адыгея;21_45_days;SputnikV;1190;782;1972;256368;104563;360931
2022.08_13-10-2022;Республика Адыгея;45_75_days;AllVaccines;1126;506;1632;256368;104563;360931
2022.08_13-10-2022;Республика Адыгея;45_75_days;EpiVacCorona;11;1;12;256368;104563;360931
2022.08_13-10-2022;Республика Адыгея;45_75_days;SputnikLite;272;77;349;256368;104563;360931
2022.08_13-10-2022;Республика Адыгея;45_75_days;SputnikV;843;428;1271;256368;104563;360931
2022.08_13-10-2022;Республика Адыгея;75_90_days;AllVaccines;572;339;911;256368;104563;360931
2022.08_13-10-2022;Республика Адыгея;75_90_days;EpiVacCorona;35;25;60;256368;104563;360931
2022.08_13-10-2022;Республика Адыгея;75_90_days;SputnikLite;172;60;232;256368;104563;360931
2022.08_13-10-2022;Республика Адыгея;75_90_days;SputnikV;365;254;619;256368;104563;360931
2022.08_13-10-2022;Республика Адыгея;90_105_days;AllVaccines;472;401;873;256368;104563;360931
2022.08_13-10-2022;Республика Адыгея;90_105_days;EpiVacCorona;18;6;24;256368;104563;360931
2022.08_13-10-2022;Республика Адыгея;90_105_days;SputnikLite;86;55;141;256368;104563;360931
2022.08_13-10-2022;Республика Адыгея;90_105_days;SputnikV;368;340;708;256368;104563;360931
2022.08_13-10-2022;Республика Алтай;105_165_days;AllVaccines;2561;1740;4301;117210;36468;153678
2022.08_13-10-2022;Республика Алтай;105_165_days;CoviVac;267;160;427;117210;36468;153678
2022.08_13-10-2022;Республика Алтай;105_165_days;EpiVacCorona;306;116;422;117210;36468;153678
2022.08_13-10-2022;Республика Алтай;105_165_days;SputnikLite;543;250;793;117210;36468;153678
2022.08_13-10-2022;Республика Алтай;105_165_days;SputnikV;1445;1214;2659;117210;36468;153678
2022.08_13-10-2022;Республика Алтай;165_195_days;AllVaccines;2377;905;3282;117210;36468;153678
2022.08_13-10-2022;Республика Алтай;165_195_days;CoviVac;127;28;155;117210;36468;153678
2022.08_13-10-2022;Республика Алтай;165_195_days;EpiVacCorona;218;53;271;117210;36468;153678
2022.08_13-10-2022;Республика Алтай;165_195_days;SputnikLite;907;312;1219;117210;36468;153678
2022.08_13-10-2022;Республика Алтай;165_195_days;SputnikV;1125;512;1637;117210;36468;153678
2022.08_13-10-2022;Республика Алтай;21_45_days;AllVaccines;1045;642;1687;117210;36468;153678
2022.08_13-10-2022;Республика Алтай;21_45_days;EpiVacCorona;4;1;5;117210;36468;153678
2022.08_13-10-2022;Республика Алтай;21_45_days;SputnikLite;5;0;5;117210;36468;153678
2022.08_13-10-2022;Республика Алтай;21_45_days;SputnikV;1036;641;1677;117210;36468;153678
2022.08_13-10-2022;Республика Алтай;45_75_days;AllVaccines;749;331;1080;117210;36468;153678
2022.08_13-10-2022;Республика Алтай;45_75_days;CoviVac;1;0;1;117210;36468;153678
2022.08_13-10-2022;Республика Алтай;45_75_days;EpiVacCorona;88;19;107;117210;36468;153678
2022.08_13-10-2022;Республика Алтай;45_75_days;SputnikLite;42;12;54;117210;36468;153678
2022.08_13-10-2022;Республика Алтай;45_75_days;SputnikV;618;300;918;117210;36468;153678
2022.08_13-10-2022;Республика Алтай;75_90_days;AllVaccines;706;418;1124;117210;36468;153678
2022.08_13-10-2022;Республика Алтай;75_90_days;EpiVacCorona;67;49;116;117210;36468;153678
2022.08_13-10-2022;Республика Алтай;75_90_days;SputnikLite;78;1;79;117210;36468;153678
2022.08_13-10-2022;Республика Алтай;75_90_days;SputnikV;561;368;929;117210;36468;153678
2022.08_13-10-2022;Республика Алтай;90_105_days;AllVaccines;547;384;931;117210;36468;153678
2022.08_13-10-2022;Республика Алтай;90_105_days;CoviVac;4;2;6;117210;36468;153678
2022.08_13-10-2022;Республика Алтай;90_105_days;EpiVacCorona;32;18;50;117210;36468;153678
2022.08_13-10-2022;Республика Алтай;90_105_days;SputnikLite;120;14;134;117210;36468;153678
2022.08_13-10-2022;Республика Алтай;90_105_days;SputnikV;391;350;741;117210;36468;153678
2022.08_13-10-2022;Республика Башкортостан;105_165_days;AllVaccines;76392;53092;129484;2235962;869874;3105836
2022.08_13-10-2022;Республика Башкортостан;105_165_days;CoviVac;8959;4381;13340;2235962;869874;3105836
2022.08_13-10-2022;Республика Башкортостан;105_165_days;EpiVacCorona;6100;4582;10682;2235962;869874;3105836
2022.08_13-10-2022;Республика Башкортостан;105_165_days;SputnikLite;12137;2943;15080;2235962;869874;3105836
2022.08_13-10-2022;Республика Башкортостан;105_165_days;SputnikV;49196;41186;90382;2235962;869874;3105836
2022.08_13-10-2022;Республика Башкортостан;165_195_days;AllVaccines;48592;26715;75307;2235962;869874;3105836
2022.08_13-10-2022;Республика Башкортостан;165_195_days;CoviVac;1124;369;1493;2235962;869874;3105836
2022.08_13-10-2022;Республика Башкортостан;165_195_days;EpiVacCorona;5553;4383;9936;2235962;869874;3105836
2022.08_13-10-2022;Республика Башкортостан;165_195_days;SputnikLite;13109;4396;17505;2235962;869874;3105836
2022.08_13-10-2022;Республика Башкортостан;165_195_days;SputnikV;28806;17567;46373;2235962;869874;3105836
2022.08_13-10-2022;Республика Башкортостан;21_45_days;AllVaccines;73519;33229;106748;2235962;869874;3105836
2022.08_13-10-2022;Республика Башкортостан;21_45_days;CoviVac;2;0;2;2235962;869874;3105836
2022.08_13-10-2022;Республика Башкортостан;21_45_days;EpiVacCorona;67;18;85;2235962;869874;3105836
2022.08_13-10-2022;Республика Башкортостан;21_45_days;SputnikLite;1311;98;1409;2235962;869874;3105836
2022.08_13-10-2022;Республика Башкортостан;21_45_days;SputnikV;72139;33113;105252;2235962;869874;3105836
2022.08_13-10-2022;Республика Башкортостан;45_75_days;AllVaccines;49978;27867;77845;2235962;869874;3105836
2022.08_13-10-2022;Республика Башкортостан;45_75_days;CoviVac;133;47;180;2235962;869874;3105836
2022.08_13-10-2022;Республика Башкортостан;45_75_days;EpiVacCorona;808;303;1111;2235962;869874;3105836
2022.08_13-10-2022;Республика Башкортостан;45_75_days;SputnikLite;2416;236;2652;2235962;869874;3105836
2022.08_13-10-2022;Республика Башкортостан;45_75_days;SputnikV;46621;27281;73902;2235962;869874;3105836
2022.08_13-10-2022;Республика Башкортостан;75_90_days;AllVaccines;45875;32903;78778;2235962;869874;3105836
2022.08_13-10-2022;Республика Башкортостан;75_90_days;CoviVac;353;107;460;2235962;869874;3105836
2022.08_13-10-2022;Республика Башкортостан;75_90_days;EpiVacCorona;5059;5320;10379;2235962;869874;3105836
2022.08_13-10-2022;Республика Башкортостан;75_90_days;SputnikLite;1463;179;1642;2235962;869874;3105836
2022.08_13-10-2022;Республика Башкортостан;75_90_days;SputnikV;39000;27297;66297;2235962;869874;3105836
2022.08_13-10-2022;Республика Башкортостан;90_105_days;AllVaccines;47889;34395;82284;2235962;869874;3105836
2022.08_13-10-2022;Республика Башкортостан;90_105_days;CoviVac;384;112;496;2235962;869874;3105836
2022.08_13-10-2022;Республика Башкортостан;90_105_days;EpiVacCorona;2853;2962;5815;2235962;869874;3105836
2022.08_13-10-2022;Республика Башкортостан;90_105_days;SputnikLite;1825;292;2117;2235962;869874;3105836
2022.08_13-10-2022;Республика Башкортостан;90_105_days;SputnikV;42827;31029;73856;2235962;869874;3105836
2022.08_13-10-2022;Республика Бурятия;105_165_days;AllVaccines;9960;5206;15166;542372;176777;719149
2022.08_13-10-2022;Республика Бурятия;105_165_days;CoviVac;954;388;1342;542372;176777;719149
2022.08_13-10-2022;Республика Бурятия;105_165_days;EpiVacCorona;1552;918;2470;542372;176777;719149
2022.08_13-10-2022;Республика Бурятия;105_165_days;SputnikLite;683;197;880;542372;176777;719149
2022.08_13-10-2022;Республика Бурятия;105_165_days;SputnikV;6771;3703;10474;542372;176777;719149
2022.08_13-10-2022;Республика Бурятия;165_195_days;AllVaccines;10917;4150;15067;542372;176777;719149
2022.08_13-10-2022;Республика Бурятия;165_195_days;CoviVac;300;124;424;542372;176777;719149
2022.08_13-10-2022;Республика Бурятия;165_195_days;EpiVacCorona;970;466;1436;542372;176777;719149
2022.08_13-10-2022;Республика Бурятия;165_195_days;SputnikLite;2598;948;3546;542372;176777;719149
2022.08_13-10-2022;Республика Бурятия;165_195_days;SputnikV;7049;2612;9661;542372;176777;719149
2022.08_13-10-2022;Республика Бурятия;21_45_days;AllVaccines;5269;2889;8158;542372;176777;719149
2022.08_13-10-2022;Республика Бурятия;21_45_days;CoviVac;0;1;1;542372;176777;719149
2022.08_13-10-2022;Республика Бурятия;21_45_days;EpiVacCorona;29;5;34;542372;176777;719149
2022.08_13-10-2022;Республика Бурятия;21_45_days;SputnikLite;1078;424;1502;542372;176777;719149
2022.08_13-10-2022;Республика Бурятия;21_45_days;SputnikV;4162;2459;6621;542372;176777;719149
2022.08_13-10-2022;Республика Бурятия;45_75_days;AllVaccines;3087;1968;5055;542372;176777;719149
2022.08_13-10-2022;Республика Бурятия;45_75_days;CoviVac;29;4;33;542372;176777;719149
2022.08_13-10-2022;Республика Бурятия;45_75_days;EpiVacCorona;485;292;777;542372;176777;719149
2022.08_13-10-2022;Республика Бурятия;45_75_days;SputnikLite;189;36;225;542372;176777;719149
2022.08_13-10-2022;Республика Бурятия;45_75_days;SputnikV;2384;1636;4020;542372;176777;719149
2022.08_13-10-2022;Республика Бурятия;75_90_days;AllVaccines;2753;1669;4422;542372;176777;719149
2022.08_13-10-2022;Республика Бурятия;75_90_days;CoviVac;283;44;327;542372;176777;719149
2022.08_13-10-2022;Республика Бурятия;75_90_days;EpiVacCorona;602;292;894;542372;176777;719149
2022.08_13-10-2022;Республика Бурятия;75_90_days;SputnikLite;64;15;79;542372;176777;719149
2022.08_13-10-2022;Республика Бурятия;75_90_days;SputnikV;1804;1318;3122;542372;176777;719149
2022.08_13-10-2022;Республика Бурятия;90_105_days;AllVaccines;2386;1492;3878;542372;176777;719149
2022.08_13-10-2022;Республика Бурятия;90_105_days;CoviVac;166;83;249;542372;176777;719149
2022.08_13-10-2022;Республика Бурятия;90_105_days;EpiVacCorona;322;126;448;542372;176777;719149
2022.08_13-10-2022;Республика Бурятия;90_105_days;SputnikLite;30;4;34;542372;176777;719149
2022.08_13-10-2022;Республика Бурятия;90_105_days;SputnikV;1868;1279;3147;542372;176777;719149
2022.08_13-10-2022;Республика Дагестан;105_165_days;AllVaccines;141382;42411;183793;1856109;394621;2250730
2022.08_13-10-2022;Республика Дагестан;105_165_days;CoviVac;2722;818;3540;1856109;394621;2250730
2022.08_13-10-2022;Республика Дагестан;105_165_days;EpiVacCorona;4673;2421;7094;1856109;394621;2250730
2022.08_13-10-2022;Республика Дагестан;105_165_days;SputnikLite;939;135;1074;1856109;394621;2250730
2022.08_13-10-2022;Республика Дагестан;105_165_days;SputnikV;133048;39037;172085;1856109;394621;2250730
2022.08_13-10-2022;Республика Дагестан;165_195_days;AllVaccines;94135;27111;121246;1856109;394621;2250730
2022.08_13-10-2022;Республика Дагестан;165_195_days;CoviVac;4174;1452;5626;1856109;394621;2250730
2022.08_13-10-2022;Республика Дагестан;165_195_days;EpiVacCorona;13261;4316;17577;1856109;394621;2250730
2022.08_13-10-2022;Республика Дагестан;165_195_days;SputnikLite;4078;977;5055;1856109;394621;2250730
2022.08_13-10-2022;Республика Дагестан;165_195_days;SputnikV;72622;20366;92988;1856109;394621;2250730
2022.08_13-10-2022;Республика Дагестан;21_45_days;AllVaccines;19450;3887;23337;1856109;394621;2250730
2022.08_13-10-2022;Республика Дагестан;21_45_days;CoviVac;1;0;1;1856109;394621;2250730
2022.08_13-10-2022;Республика Дагестан;21_45_days;EpiVacCorona;7;0;7;1856109;394621;2250730
2022.08_13-10-2022;Республика Дагестан;21_45_days;SputnikLite;81;3;84;1856109;394621;2250730
2022.08_13-10-2022;Республика Дагестан;21_45_days;SputnikV;19361;3884;23245;1856109;394621;2250730
2022.08_13-10-2022;Республика Дагестан;45_75_days;AllVaccines;19920;4699;24619;1856109;394621;2250730
2022.08_13-10-2022;Республика Дагестан;45_75_days;CoviVac;35;15;50;1856109;394621;2250730
2022.08_13-10-2022;Республика Дагестан;45_75_days;EpiVacCorona;86;15;101;1856109;394621;2250730
2022.08_13-10-2022;Республика Дагестан;45_75_days;SputnikLite;99;11;110;1856109;394621;2250730
2022.08_13-10-2022;Республика Дагестан;45_75_days;SputnikV;19700;4658;24358;1856109;394621;2250730
2022.08_13-10-2022;Республика Дагестан;75_90_days;AllVaccines;18808;4320;23128;1856109;394621;2250730
2022.08_13-10-2022;Республика Дагестан;75_90_days;CoviVac;99;18;117;1856109;394621;2250730
2022.08_13-10-2022;Республика Дагестан;75_90_days;EpiVacCorona;177;101;278;1856109;394621;2250730
2022.08_13-10-2022;Республика Дагестан;75_90_days;SputnikLite;58;4;62;1856109;394621;2250730
2022.08_13-10-2022;Республика Дагестан;75_90_days;SputnikV;18474;4197;22671;1856109;394621;2250730
2022.08_13-10-2022;Республика Дагестан;90_105_days;AllVaccines;21755;5997;27752;1856109;394621;2250730
2022.08_13-10-2022;Республика Дагестан;90_105_days;CoviVac;119;38;157;1856109;394621;2250730
2022.08_13-10-2022;Республика Дагестан;90_105_days;EpiVacCorona;181;76;257;1856109;394621;2250730
2022.08_13-10-2022;Республика Дагестан;90_105_days;SputnikLite;75;6;81;1856109;394621;2250730
2022.08_13-10-2022;Республика Дагестан;90_105_days;SputnikV;21380;5877;27257;1856109;394621;2250730
2022.08_13-10-2022;Республика Ингушетия;105_165_days;AllVaccines;22725;3269;25994;295583;61477;357060
2022.08_13-10-2022;Республика Ингушетия;105_165_days;CoviVac;1809;204;2013;295583;61477;357060
2022.08_13-10-2022;Республика Ингушетия;105_165_days;EpiVacCorona;4627;789;5416;295583;61477;357060
2022.08_13-10-2022;Республика Ингушетия;105_165_days;SputnikLite;11;1;12;295583;61477;357060
2022.08_13-10-2022;Республика Ингушетия;105_165_days;SputnikV;16278;2275;18553;295583;61477;357060
2022.08_13-10-2022;Республика Ингушетия;165_195_days;AllVaccines;8071;1295;9366;295583;61477;357060
2022.08_13-10-2022;Республика Ингушетия;165_195_days;CoviVac;156;13;169;295583;61477;357060
2022.08_13-10-2022;Республика Ингушетия;165_195_days;EpiVacCorona;3217;565;3782;295583;61477;357060
2022.08_13-10-2022;Республика Ингушетия;165_195_days;SputnikLite;1757;261;2018;295583;61477;357060
2022.08_13-10-2022;Республика Ингушетия;165_195_days;SputnikV;2941;456;3397;295583;61477;357060
2022.08_13-10-2022;Республика Ингушетия;21_45_days;AllVaccines;3147;589;3736;295583;61477;357060
2022.08_13-10-2022;Республика Ингушетия;21_45_days;CoviVac;8;0;8;295583;61477;357060
2022.08_13-10-2022;Республика Ингушетия;21_45_days;EpiVacCorona;9;1;10;295583;61477;357060
2022.08_13-10-2022;Республика Ингушетия;21_45_days;SputnikLite;2;0;2;295583;61477;357060
2022.08_13-10-2022;Республика Ингушетия;21_45_days;SputnikV;3128;588;3716;295583;61477;357060
2022.08_13-10-2022;Республика Ингушетия;45_75_days;AllVaccines;2626;630;3256;295583;61477;357060
2022.08_13-10-2022;Республика Ингушетия;45_75_days;CoviVac;120;12;132;295583;61477;357060
2022.08_13-10-2022;Республика Ингушетия;45_75_days;EpiVacCorona;74;3;77;295583;61477;357060
2022.08_13-10-2022;Республика Ингушетия;45_75_days;SputnikV;2432;615;3047;295583;61477;357060
2022.08_13-10-2022;Республика Ингушетия;75_90_days;AllVaccines;1197;255;1452;295583;61477;357060
2022.08_13-10-2022;Республика Ингушетия;75_90_days;CoviVac;28;0;28;295583;61477;357060
2022.08_13-10-2022;Республика Ингушетия;75_90_days;EpiVacCorona;22;5;27;295583;61477;357060
2022.08_13-10-2022;Республика Ингушетия;75_90_days;SputnikV;1147;250;1397;295583;61477;357060
2022.08_13-10-2022;Республика Ингушетия;90_105_days;AllVaccines;2301;431;2732;295583;61477;357060
2022.08_13-10-2022;Республика Ингушетия;90_105_days;CoviVac;140;26;166;295583;61477;357060
2022.08_13-10-2022;Республика Ингушетия;90_105_days;EpiVacCorona;1;0;1;295583;61477;357060
2022.08_13-10-2022;Республика Ингушетия;90_105_days;SputnikV;2160;405;2565;295583;61477;357060
2022.08_13-10-2022;Республика Калмыкия;105_165_days;AllVaccines;2939;2302;5241;150440;54890;205330
2022.08_13-10-2022;Республика Калмыкия;105_165_days;CoviVac;5;4;9;150440;54890;205330
2022.08_13-10-2022;Республика Калмыкия;105_165_days;EpiVacCorona;190;85;275;150440;54890;205330
2022.08_13-10-2022;Республика Калмыкия;105_165_days;SputnikLite;2181;1734;3915;150440;54890;205330
2022.08_13-10-2022;Республика Калмыкия;105_165_days;SputnikV;563;479;1042;150440;54890;205330
2022.08_13-10-2022;Республика Калмыкия;165_195_days;AllVaccines;1439;885;2324;150440;54890;205330
2022.08_13-10-2022;Республика Калмыкия;165_195_days;CoviVac;5;1;6;150440;54890;205330
2022.08_13-10-2022;Республика Калмыкия;165_195_days;EpiVacCorona;52;34;86;150440;54890;205330
2022.08_13-10-2022;Республика Калмыкия;165_195_days;SputnikLite;1027;666;1693;150440;54890;205330
2022.08_13-10-2022;Республика Калмыкия;165_195_days;SputnikV;355;184;539;150440;54890;205330
2022.08_13-10-2022;Республика Калмыкия;21_45_days;AllVaccines;1045;454;1499;150440;54890;205330
2022.08_13-10-2022;Республика Калмыкия;21_45_days;EpiVacCorona;1;0;1;150440;54890;205330
2022.08_13-10-2022;Республика Калмыкия;21_45_days;SputnikLite;35;15;50;150440;54890;205330
2022.08_13-10-2022;Республика Калмыкия;21_45_days;SputnikV;1009;439;1448;150440;54890;205330
2022.08_13-10-2022;Республика Калмыкия;45_75_days;AllVaccines;516;169;685;150440;54890;205330
2022.08_13-10-2022;Республика Калмыкия;45_75_days;CoviVac;1;0;1;150440;54890;205330
2022.08_13-10-2022;Республика Калмыкия;45_75_days;EpiVacCorona;50;13;63;150440;54890;205330
2022.08_13-10-2022;Республика Калмыкия;45_75_days;SputnikLite;186;45;231;150440;54890;205330
2022.08_13-10-2022;Республика Калмыкия;45_75_days;SputnikV;279;111;390;150440;54890;205330
2022.08_13-10-2022;Республика Калмыкия;75_90_days;AllVaccines;349;205;554;150440;54890;205330
2022.08_13-10-2022;Республика Калмыкия;75_90_days;CoviVac;2;0;2;150440;54890;205330
2022.08_13-10-2022;Республика Калмыкия;75_90_days;EpiVacCorona;50;25;75;150440;54890;205330
2022.08_13-10-2022;Республика Калмыкия;75_90_days;SputnikLite;68;29;97;150440;54890;205330
2022.08_13-10-2022;Республика Калмыкия;75_90_days;SputnikV;229;151;380;150440;54890;205330
2022.08_13-10-2022;Республика Калмыкия;90_105_days;AllVaccines;386;354;740;150440;54890;205330
2022.08_13-10-2022;Республика Калмыкия;90_105_days;CoviVac;1;0;1;150440;54890;205330
2022.08_13-10-2022;Республика Калмыкия;90_105_days;EpiVacCorona;86;31;117;150440;54890;205330
2022.08_13-10-2022;Республика Калмыкия;90_105_days;SputnikLite;96;61;157;150440;54890;205330
2022.08_13-10-2022;Республика Калмыкия;90_105_days;SputnikV;203;262;465;150440;54890;205330
2022.08_13-10-2022;Республика Карелия;105_165_days;AllVaccines;4967;5980;10947;334874;149526;484400
2022.08_13-10-2022;Республика Карелия;105_165_days;CoviVac;25;16;41;334874;149526;484400
2022.08_13-10-2022;Республика Карелия;105_165_days;EpiVacCorona;150;259;409;334874;149526;484400
2022.08_13-10-2022;Республика Карелия;105_165_days;SputnikLite;2352;2478;4830;334874;149526;484400
2022.08_13-10-2022;Республика Карелия;105_165_days;SputnikV;2440;3227;5667;334874;149526;484400
2022.08_13-10-2022;Республика Карелия;165_195_days;AllVaccines;5549;3788;9337;334874;149526;484400
2022.08_13-10-2022;Республика Карелия;165_195_days;CoviVac;69;15;84;334874;149526;484400
2022.08_13-10-2022;Республика Карелия;165_195_days;EpiVacCorona;150;95;245;334874;149526;484400
2022.08_13-10-2022;Республика Карелия;165_195_days;SputnikLite;3164;2300;5464;334874;149526;484400
2022.08_13-10-2022;Республика Карелия;165_195_days;SputnikV;2166;1378;3544;334874;149526;484400
2022.08_13-10-2022;Республика Карелия;21_45_days;AllVaccines;1634;1698;3332;334874;149526;484400
2022.08_13-10-2022;Республика Карелия;21_45_days;EpiVacCorona;1;2;3;334874;149526;484400
2022.08_13-10-2022;Республика Карелия;21_45_days;SputnikLite;8;3;11;334874;149526;484400
2022.08_13-10-2022;Республика Карелия;21_45_days;SputnikV;1625;1693;3318;334874;149526;484400
2022.08_13-10-2022;Республика Карелия;45_75_days;AllVaccines;1109;1183;2292;334874;149526;484400
2022.08_13-10-2022;Республика Карелия;45_75_days;CoviVac;1;0;1;334874;149526;484400
2022.08_13-10-2022;Республика Карелия;45_75_days;EpiVacCorona;54;43;97;334874;149526;484400
2022.08_13-10-2022;Республика Карелия;45_75_days;SputnikLite;36;10;46;334874;149526;484400
2022.08_13-10-2022;Республика Карелия;45_75_days;SputnikV;1018;1130;2148;334874;149526;484400
2022.08_13-10-2022;Республика Карелия;75_90_days;AllVaccines;781;842;1623;334874;149526;484400
2022.08_13-10-2022;Республика Карелия;75_90_days;EpiVacCorona;100;100;200;334874;149526;484400
2022.08_13-10-2022;Республика Карелия;75_90_days;SputnikLite;52;14;66;334874;149526;484400
2022.08_13-10-2022;Республика Карелия;75_90_days;SputnikV;629;728;1357;334874;149526;484400
2022.08_13-10-2022;Республика Карелия;90_105_days;AllVaccines;849;1397;2246;334874;149526;484400
2022.08_13-10-2022;Республика Карелия;90_105_days;EpiVacCorona;85;137;222;334874;149526;484400
2022.08_13-10-2022;Республика Карелия;90_105_days;SputnikLite;61;37;98;334874;149526;484400
2022.08_13-10-2022;Республика Карелия;90_105_days;SputnikV;703;1223;1926;334874;149526;484400
2022.08_13-10-2022;Республика Коми;105_165_days;AllVaccines;5872;3334;9206;465210;166370;631580
2022.08_13-10-2022;Республика Коми;105_165_days;CoviVac;356;89;445;465210;166370;631580
2022.08_13-10-2022;Республика Коми;105_165_days;EpiVacCorona;282;173;455;465210;166370;631580
2022.08_13-10-2022;Республика Коми;105_165_days;SputnikLite;1370;531;1901;465210;166370;631580
2022.08_13-10-2022;Республика Коми;105_165_days;SputnikV;3864;2541;6405;465210;166370;631580
2022.08_13-10-2022;Республика Коми;165_195_days;AllVaccines;7435;2939;10374;465210;166370;631580
2022.08_13-10-2022;Республика Коми;165_195_days;CoviVac;116;53;169;465210;166370;631580
2022.08_13-10-2022;Республика Коми;165_195_days;EpiVacCorona;186;55;241;465210;166370;631580
2022.08_13-10-2022;Республика Коми;165_195_days;SputnikLite;3568;1334;4902;465210;166370;631580
2022.08_13-10-2022;Республика Коми;165_195_days;SputnikV;3565;1497;5062;465210;166370;631580
2022.08_13-10-2022;Республика Коми;21_45_days;AllVaccines;1646;919;2565;465210;166370;631580
2022.08_13-10-2022;Республика Коми;21_45_days;EpiVacCorona;5;2;7;465210;166370;631580
2022.08_13-10-2022;Республика Коми;21_45_days;SputnikLite;8;3;11;465210;166370;631580
2022.08_13-10-2022;Республика Коми;21_45_days;SputnikV;1633;914;2547;465210;166370;631580
2022.08_13-10-2022;Республика Коми;45_75_days;AllVaccines;1516;1169;2685;465210;166370;631580
2022.08_13-10-2022;Республика Коми;45_75_days;CoviVac;4;0;4;465210;166370;631580
2022.08_13-10-2022;Республика Коми;45_75_days;EpiVacCorona;62;45;107;465210;166370;631580
2022.08_13-10-2022;Республика Коми;45_75_days;SputnikLite;20;2;22;465210;166370;631580
2022.08_13-10-2022;Республика Коми;45_75_days;SputnikV;1430;1122;2552;465210;166370;631580
2022.08_13-10-2022;Республика Коми;75_90_days;AllVaccines;1237;791;2028;465210;166370;631580
2022.08_13-10-2022;Республика Коми;75_90_days;CoviVac;118;46;164;465210;166370;631580
2022.08_13-10-2022;Республика Коми;75_90_days;EpiVacCorona;139;86;225;465210;166370;631580
2022.08_13-10-2022;Республика Коми;75_90_days;SputnikLite;21;9;30;465210;166370;631580
2022.08_13-10-2022;Республика Коми;75_90_days;SputnikV;959;650;1609;465210;166370;631580
2022.08_13-10-2022;Республика Коми;90_105_days;AllVaccines;1433;1050;2483;465210;166370;631580
2022.08_13-10-2022;Республика Коми;90_105_days;CoviVac;166;17;183;465210;166370;631580
2022.08_13-10-2022;Республика Коми;90_105_days;EpiVacCorona;102;79;181;465210;166370;631580
2022.08_13-10-2022;Республика Коми;90_105_days;SputnikLite;91;15;106;465210;166370;631580
2022.08_13-10-2022;Республика Коми;90_105_days;SputnikV;1074;939;2013;465210;166370;631580
2022.08_13-10-2022;Республика Крым;105_165_days;AllVaccines;15837;9768;25605;1036087;480146;1516233
2022.08_13-10-2022;Республика Крым;105_165_days;CoviVac;1318;431;1749;1036087;480146;1516233
2022.08_13-10-2022;Республика Крым;105_165_days;EpiVacCorona;1248;841;2089;1036087;480146;1516233
2022.08_13-10-2022;Республика Крым;105_165_days;SputnikLite;734;153;887;1036087;480146;1516233
2022.08_13-10-2022;Республика Крым;105_165_days;SputnikV;12537;8343;20880;1036087;480146;1516233
2022.08_13-10-2022;Республика Крым;165_195_days;AllVaccines;10368;5206;15574;1036087;480146;1516233
2022.08_13-10-2022;Республика Крым;165_195_days;CoviVac;327;106;433;1036087;480146;1516233
2022.08_13-10-2022;Республика Крым;165_195_days;EpiVacCorona;1167;683;1850;1036087;480146;1516233
2022.08_13-10-2022;Республика Крым;165_195_days;SputnikLite;516;202;718;1036087;480146;1516233
2022.08_13-10-2022;Республика Крым;165_195_days;SputnikV;8358;4215;12573;1036087;480146;1516233
2022.08_13-10-2022;Республика Крым;21_45_days;AllVaccines;8281;4878;13159;1036087;480146;1516233
2022.08_13-10-2022;Республика Крым;21_45_days;CoviVac;3;0;3;1036087;480146;1516233
2022.08_13-10-2022;Республика Крым;21_45_days;EpiVacCorona;41;7;48;1036087;480146;1516233
2022.08_13-10-2022;Республика Крым;21_45_days;SputnikLite;13;1;14;1036087;480146;1516233
2022.08_13-10-2022;Республика Крым;21_45_days;SputnikV;8224;4870;13094;1036087;480146;1516233
2022.08_13-10-2022;Республика Крым;45_75_days;AllVaccines;6679;3942;10621;1036087;480146;1516233
2022.08_13-10-2022;Республика Крым;45_75_days;CoviVac;38;6;44;1036087;480146;1516233
2022.08_13-10-2022;Республика Крым;45_75_days;EpiVacCorona;1085;665;1750;1036087;480146;1516233
2022.08_13-10-2022;Республика Крым;45_75_days;SputnikLite;23;3;26;1036087;480146;1516233
2022.08_13-10-2022;Республика Крым;45_75_days;SputnikV;5533;3268;8801;1036087;480146;1516233
2022.08_13-10-2022;Республика Крым;75_90_days;AllVaccines;5390;3342;8732;1036087;480146;1516233
2022.08_13-10-2022;Республика Крым;75_90_days;CoviVac;380;168;548;1036087;480146;1516233
2022.08_13-10-2022;Республика Крым;75_90_days;EpiVacCorona;826;571;1397;1036087;480146;1516233
2022.08_13-10-2022;Республика Крым;75_90_days;SputnikLite;12;0;12;1036087;480146;1516233
2022.08_13-10-2022;Республика Крым;75_90_days;SputnikV;4172;2603;6775;1036087;480146;1516233
2022.08_13-10-2022;Республика Крым;90_105_days;AllVaccines;4634;3385;8019;1036087;480146;1516233
2022.08_13-10-2022;Республика Крым;90_105_days;CoviVac;395;144;539;1036087;480146;1516233
2022.08_13-10-2022;Республика Крым;90_105_days;EpiVacCorona;884;454;1338;1036087;480146;1516233
2022.08_13-10-2022;Республика Крым;90_105_days;SputnikLite;30;1;31;1036087;480146;1516233
2022.08_13-10-2022;Республика Крым;90_105_days;SputnikV;3325;2786;6111;1036087;480146;1516233
2022.08_13-10-2022;Республика Марий Эл;105_165_days;AllVaccines;4207;1738;5945;370626;156749;527375
2022.08_13-10-2022;Республика Марий Эл;105_165_days;CoviVac;13;4;17;370626;156749;527375
2022.08_13-10-2022;Республика Марий Эл;105_165_days;EpiVacCorona;233;62;295;370626;156749;527375
2022.08_13-10-2022;Республика Марий Эл;105_165_days;SputnikLite;1385;91;1476;370626;156749;527375
2022.08_13-10-2022;Республика Марий Эл;105_165_days;SputnikV;2576;1581;4157;370626;156749;527375
2022.08_13-10-2022;Республика Марий Эл;165_195_days;AllVaccines;2274;2171;4445;370626;156749;527375
2022.08_13-10-2022;Республика Марий Эл;165_195_days;CoviVac;249;132;381;370626;156749;527375
2022.08_13-10-2022;Республика Марий Эл;165_195_days;EpiVacCorona;147;216;363;370626;156749;527375
2022.08_13-10-2022;Республика Марий Эл;165_195_days;SputnikLite;398;118;516;370626;156749;527375
2022.08_13-10-2022;Республика Марий Эл;165_195_days;SputnikV;1480;1705;3185;370626;156749;527375
2022.08_13-10-2022;Республика Марий Эл;21_45_days;AllVaccines;2089;720;2809;370626;156749;527375
2022.08_13-10-2022;Республика Марий Эл;21_45_days;EpiVacCorona;117;26;143;370626;156749;527375
2022.08_13-10-2022;Республика Марий Эл;21_45_days;SputnikLite;241;5;246;370626;156749;527375
2022.08_13-10-2022;Республика Марий Эл;21_45_days;SputnikV;1731;689;2420;370626;156749;527375
2022.08_13-10-2022;Республика Марий Эл;45_75_days;AllVaccines;1611;404;2015;370626;156749;527375
2022.08_13-10-2022;Республика Марий Эл;45_75_days;EpiVacCorona;106;31;137;370626;156749;527375
2022.08_13-10-2022;Республика Марий Эл;45_75_days;SputnikLite;408;16;424;370626;156749;527375
2022.08_13-10-2022;Республика Марий Эл;45_75_days;SputnikV;1097;357;1454;370626;156749;527375
2022.08_13-10-2022;Республика Марий Эл;75_90_days;AllVaccines;1105;367;1472;370626;156749;527375
2022.08_13-10-2022;Республика Марий Эл;75_90_days;EpiVacCorona;127;28;155;370626;156749;527375
2022.08_13-10-2022;Республика Марий Эл;75_90_days;SputnikLite;183;8;191;370626;156749;527375
2022.08_13-10-2022;Республика Марий Эл;75_90_days;SputnikV;795;331;1126;370626;156749;527375
2022.08_13-10-2022;Республика Марий Эл;90_105_days;AllVaccines;1487;563;2050;370626;156749;527375
2022.08_13-10-2022;Республика Марий Эл;90_105_days;EpiVacCorona;31;10;41;370626;156749;527375
2022.08_13-10-2022;Республика Марий Эл;90_105_days;SputnikLite;285;9;294;370626;156749;527375
2022.08_13-10-2022;Республика Марий Эл;90_105_days;SputnikV;1171;544;1715;370626;156749;527375
2022.08_13-10-2022;Республика Мордовия;105_165_days;AllVaccines;23972;20126;44098;448319;198808;647127
2022.08_13-10-2022;Республика Мордовия;105_165_days;CoviVac;285;115;400;448319;198808;647127
2022.08_13-10-2022;Республика Мордовия;105_165_days;EpiVacCorona;2044;1950;3994;448319;198808;647127
2022.08_13-10-2022;Республика Мордовия;105_165_days;SputnikLite;4020;3190;7210;448319;198808;647127
2022.08_13-10-2022;Республика Мордовия;105_165_days;SputnikV;17623;14871;32494;448319;198808;647127
2022.08_13-10-2022;Республика Мордовия;165_195_days;AllVaccines;12191;7295;19486;448319;198808;647127
2022.08_13-10-2022;Республика Мордовия;165_195_days;CoviVac;390;178;568;448319;198808;647127
2022.08_13-10-2022;Республика Мордовия;165_195_days;EpiVacCorona;888;651;1539;448319;198808;647127
2022.08_13-10-2022;Республика Мордовия;165_195_days;SputnikLite;4800;2427;7227;448319;198808;647127
2022.08_13-10-2022;Республика Мордовия;165_195_days;SputnikV;6113;4039;10152;448319;198808;647127
2022.08_13-10-2022;Республика Мордовия;21_45_days;AllVaccines;6915;3254;10169;448319;198808;647127
2022.08_13-10-2022;Республика Мордовия;21_45_days;EpiVacCorona;34;2;36;448319;198808;647127
2022.08_13-10-2022;Республика Мордовия;21_45_days;SputnikLite;1;1;2;448319;198808;647127
2022.08_13-10-2022;Республика Мордовия;21_45_days;SputnikV;6880;3251;10131;448319;198808;647127
2022.08_13-10-2022;Республика Мордовия;45_75_days;AllVaccines;5883;3529;9412;448319;198808;647127
2022.08_13-10-2022;Республика Мордовия;45_75_days;EpiVacCorona;384;336;720;448319;198808;647127
2022.08_13-10-2022;Республика Мордовия;45_75_days;SputnikV;5499;3193;8692;448319;198808;647127
2022.08_13-10-2022;Республика Мордовия;75_90_days;AllVaccines;4004;2432;6436;448319;198808;647127
2022.08_13-10-2022;Республика Мордовия;75_90_days;EpiVacCorona;1642;1089;2731;448319;198808;647127
2022.08_13-10-2022;Республика Мордовия;75_90_days;SputnikLite;9;1;10;448319;198808;647127
2022.08_13-10-2022;Республика Мордовия;75_90_days;SputnikV;2353;1342;3695;448319;198808;647127
2022.08_13-10-2022;Республика Мордовия;90_105_days;AllVaccines;6876;5506;12382;448319;198808;647127
2022.08_13-10-2022;Республика Мордовия;90_105_days;CoviVac;2;7;9;448319;198808;647127
2022.08_13-10-2022;Республика Мордовия;90_105_days;EpiVacCorona;1673;1540;3213;448319;198808;647127
2022.08_13-10-2022;Республика Мордовия;90_105_days;SputnikLite;10;22;32;448319;198808;647127
2022.08_13-10-2022;Республика Мордовия;90_105_days;SputnikV;5191;3937;9128;448319;198808;647127
2022.08_13-10-2022;Республика Саха (Якутия);105_165_days;AllVaccines;8383;2223;10606;568643;148395;717038
2022.08_13-10-2022;Республика Саха (Якутия);105_165_days;CoviVac;306;64;370;568643;148395;717038
2022.08_13-10-2022;Республика Саха (Якутия);105_165_days;EpiVacCorona;896;202;1098;568643;148395;717038
2022.08_13-10-2022;Республика Саха (Якутия);105_165_days;SputnikLite;881;288;1169;568643;148395;717038
2022.08_13-10-2022;Республика Саха (Якутия);105_165_days;SputnikV;6300;1669;7969;568643;148395;717038
2022.08_13-10-2022;Республика Саха (Якутия);165_195_days;AllVaccines;8979;1802;10781;568643;148395;717038
2022.08_13-10-2022;Республика Саха (Якутия);165_195_days;CoviVac;150;15;165;568643;148395;717038
2022.08_13-10-2022;Республика Саха (Якутия);165_195_days;EpiVacCorona;475;135;610;568643;148395;717038
2022.08_13-10-2022;Республика Саха (Якутия);165_195_days;SputnikLite;2304;504;2808;568643;148395;717038
2022.08_13-10-2022;Республика Саха (Якутия);165_195_days;SputnikV;6050;1148;7198;568643;148395;717038
2022.08_13-10-2022;Республика Саха (Якутия);21_45_days;AllVaccines;1803;453;2256;568643;148395;717038
2022.08_13-10-2022;Республика Саха (Якутия);21_45_days;EpiVacCorona;111;8;119;568643;148395;717038
2022.08_13-10-2022;Республика Саха (Якутия);21_45_days;SputnikLite;161;47;208;568643;148395;717038
2022.08_13-10-2022;Республика Саха (Якутия);21_45_days;SputnikV;1531;398;1929;568643;148395;717038
2022.08_13-10-2022;Республика Саха (Якутия);45_75_days;AllVaccines;1118;289;1407;568643;148395;717038
2022.08_13-10-2022;Республика Саха (Якутия);45_75_days;CoviVac;11;1;12;568643;148395;717038
2022.08_13-10-2022;Республика Саха (Якутия);45_75_days;EpiVacCorona;231;35;266;568643;148395;717038
2022.08_13-10-2022;Республика Саха (Якутия);45_75_days;SputnikLite;109;35;144;568643;148395;717038
2022.08_13-10-2022;Республика Саха (Якутия);45_75_days;SputnikV;767;218;985;568643;148395;717038
2022.08_13-10-2022;Республика Саха (Якутия);75_90_days;AllVaccines;1020;270;1290;568643;148395;717038
2022.08_13-10-2022;Республика Саха (Якутия);75_90_days;CoviVac;27;4;31;568643;148395;717038
2022.08_13-10-2022;Республика Саха (Якутия);75_90_days;EpiVacCorona;283;62;345;568643;148395;717038
2022.08_13-10-2022;Республика Саха (Якутия);75_90_days;SputnikLite;13;7;20;568643;148395;717038
2022.08_13-10-2022;Республика Саха (Якутия);75_90_days;SputnikV;697;197;894;568643;148395;717038
2022.08_13-10-2022;Республика Саха (Якутия);90_105_days;AllVaccines;1417;461;1878;568643;148395;717038
2022.08_13-10-2022;Республика Саха (Якутия);90_105_days;CoviVac;99;17;116;568643;148395;717038
2022.08_13-10-2022;Республика Саха (Якутия);90_105_days;EpiVacCorona;231;49;280;568643;148395;717038
2022.08_13-10-2022;Республика Саха (Якутия);90_105_days;SputnikLite;26;12;38;568643;148395;717038
2022.08_13-10-2022;Республика Саха (Якутия);90_105_days;SputnikV;1061;383;1444;568643;148395;717038
2022.08_13-10-2022;Республика Северная Осетия - Алания;105_165_days;AllVaccines;5153;3152;8305;385443;144230;529673
2022.08_13-10-2022;Республика Северная Осетия - Алания;105_165_days;CoviVac;464;361;825;385443;144230;529673
2022.08_13-10-2022;Республика Северная Осетия - Алания;105_165_days;EpiVacCorona;112;31;143;385443;144230;529673
2022.08_13-10-2022;Республика Северная Осетия - Алания;105_165_days;SputnikLite;440;141;581;385443;144230;529673
2022.08_13-10-2022;Республика Северная Осетия - Алания;105_165_days;SputnikV;4137;2619;6756;385443;144230;529673
2022.08_13-10-2022;Республика Северная Осетия - Алания;165_195_days;AllVaccines;3937;1770;5707;385443;144230;529673
2022.08_13-10-2022;Республика Северная Осетия - Алания;165_195_days;CoviVac;88;201;289;385443;144230;529673
2022.08_13-10-2022;Республика Северная Осетия - Алания;165_195_days;EpiVacCorona;289;461;750;385443;144230;529673
2022.08_13-10-2022;Республика Северная Осетия - Алания;165_195_days;SputnikLite;837;279;1116;385443;144230;529673
2022.08_13-10-2022;Республика Северная Осетия - Алания;165_195_days;SputnikV;2723;829;3552;385443;144230;529673
2022.08_13-10-2022;Республика Северная Осетия - Алания;21_45_days;AllVaccines;3485;527;4012;385443;144230;529673
2022.08_13-10-2022;Республика Северная Осетия - Алания;21_45_days;CoviVac;27;8;35;385443;144230;529673
2022.08_13-10-2022;Республика Северная Осетия - Алания;21_45_days;SputnikLite;137;14;151;385443;144230;529673
2022.08_13-10-2022;Республика Северная Осетия - Алания;21_45_days;SputnikV;3321;505;3826;385443;144230;529673
2022.08_13-10-2022;Республика Северная Осетия - Алания;45_75_days;AllVaccines;2772;796;3568;385443;144230;529673
2022.08_13-10-2022;Республика Северная Осетия - Алания;45_75_days;CoviVac;35;5;40;385443;144230;529673
2022.08_13-10-2022;Республика Северная Осетия - Алания;45_75_days;EpiVacCorona;1;0;1;385443;144230;529673
2022.08_13-10-2022;Республика Северная Осетия - Алания;45_75_days;SputnikLite;103;7;110;385443;144230;529673
2022.08_13-10-2022;Республика Северная Осетия - Алания;45_75_days;SputnikV;2633;784;3417;385443;144230;529673
2022.08_13-10-2022;Республика Северная Осетия - Алания;75_90_days;AllVaccines;1309;801;2110;385443;144230;529673
2022.08_13-10-2022;Республика Северная Осетия - Алания;75_90_days;CoviVac;101;18;119;385443;144230;529673
2022.08_13-10-2022;Республика Северная Осетия - Алания;75_90_days;SputnikLite;110;4;114;385443;144230;529673
2022.08_13-10-2022;Республика Северная Осетия - Алания;75_90_days;SputnikV;1098;779;1877;385443;144230;529673
2022.08_13-10-2022;Республика Северная Осетия - Алания;90_105_days;AllVaccines;1358;791;2149;385443;144230;529673
2022.08_13-10-2022;Республика Северная Осетия - Алания;90_105_days;CoviVac;15;3;18;385443;144230;529673
2022.08_13-10-2022;Республика Северная Осетия - Алания;90_105_days;EpiVacCorona;1;0;1;385443;144230;529673
2022.08_13-10-2022;Республика Северная Осетия - Алания;90_105_days;SputnikLite;98;13;111;385443;144230;529673
2022.08_13-10-2022;Республика Северная Осетия - Алания;90_105_days;SputnikV;1244;775;2019;385443;144230;529673
2022.08_13-10-2022;Республика Татарстан;105_165_days;AllVaccines;29506;15477;44983;2180132;866477;3046609
2022.08_13-10-2022;Республика Татарстан;105_165_days;CoviVac;859;365;1224;2180132;866477;3046609
2022.08_13-10-2022;Республика Татарстан;105_165_days;EpiVacCorona;1591;744;2335;2180132;866477;3046609
2022.08_13-10-2022;Республика Татарстан;105_165_days;SputnikLite;12212;8154;20366;2180132;866477;3046609
2022.08_13-10-2022;Республика Татарстан;105_165_days;SputnikV;14844;6214;21058;2180132;866477;3046609
2022.08_13-10-2022;Республика Татарстан;165_195_days;AllVaccines;31397;12398;43795;2180132;866477;3046609
2022.08_13-10-2022;Республика Татарстан;165_195_days;CoviVac;524;209;733;2180132;866477;3046609
2022.08_13-10-2022;Республика Татарстан;165_195_days;EpiVacCorona;1093;786;1879;2180132;866477;3046609
2022.08_13-10-2022;Республика Татарстан;165_195_days;SputnikLite;10652;4756;15408;2180132;866477;3046609
2022.08_13-10-2022;Республика Татарстан;165_195_days;SputnikV;19128;6647;25775;2180132;866477;3046609
2022.08_13-10-2022;Республика Татарстан;21_45_days;AllVaccines;17598;7154;24752;2180132;866477;3046609
2022.08_13-10-2022;Республика Татарстан;21_45_days;CoviVac;149;1;150;2180132;866477;3046609
2022.08_13-10-2022;Республика Татарстан;21_45_days;EpiVacCorona;138;116;254;2180132;866477;3046609
2022.08_13-10-2022;Республика Татарстан;21_45_days;SputnikLite;2887;786;3673;2180132;866477;3046609
2022.08_13-10-2022;Республика Татарстан;21_45_days;SputnikV;14424;6251;20675;2180132;866477;3046609
2022.08_13-10-2022;Республика Татарстан;45_75_days;AllVaccines;10399;3727;14126;2180132;866477;3046609
2022.08_13-10-2022;Республика Татарстан;45_75_days;CoviVac;30;4;34;2180132;866477;3046609
2022.08_13-10-2022;Республика Татарстан;45_75_days;EpiVacCorona;184;125;309;2180132;866477;3046609
2022.08_13-10-2022;Республика Татарстан;45_75_days;SputnikLite;1807;491;2298;2180132;866477;3046609
2022.08_13-10-2022;Республика Татарстан;45_75_days;SputnikV;8378;3107;11485;2180132;866477;3046609
2022.08_13-10-2022;Республика Татарстан;75_90_days;AllVaccines;9756;4260;14016;2180132;866477;3046609
2022.08_13-10-2022;Республика Татарстан;75_90_days;CoviVac;117;36;153;2180132;866477;3046609
2022.08_13-10-2022;Республика Татарстан;75_90_days;EpiVacCorona;1591;719;2310;2180132;866477;3046609
2022.08_13-10-2022;Республика Татарстан;75_90_days;SputnikLite;848;318;1166;2180132;866477;3046609
2022.08_13-10-2022;Республика Татарстан;75_90_days;SputnikV;7200;3187;10387;2180132;866477;3046609
2022.08_13-10-2022;Республика Татарстан;90_105_days;AllVaccines;7691;3542;11233;2180132;866477;3046609
2022.08_13-10-2022;Республика Татарстан;90_105_days;CoviVac;73;67;140;2180132;866477;3046609
2022.08_13-10-2022;Республика Татарстан;90_105_days;EpiVacCorona;424;166;590;2180132;866477;3046609
2022.08_13-10-2022;Республика Татарстан;90_105_days;SputnikLite;1268;557;1825;2180132;866477;3046609
2022.08_13-10-2022;Республика Татарстан;90_105_days;SputnikV;5926;2752;8678;2180132;866477;3046609
2022.08_13-10-2022;Республика Тыва;105_165_days;AllVaccines;9471;2175;11646;176122;31028;207150
2022.08_13-10-2022;Республика Тыва;105_165_days;CoviVac;708;107;815;176122;31028;207150
2022.08_13-10-2022;Республика Тыва;105_165_days;EpiVacCorona;1427;382;1809;176122;31028;207150
2022.08_13-10-2022;Республика Тыва;105_165_days;SputnikLite;2629;416;3045;176122;31028;207150
2022.08_13-10-2022;Республика Тыва;105_165_days;SputnikV;4707;1270;5977;176122;31028;207150
2022.08_13-10-2022;Республика Тыва;165_195_days;AllVaccines;7243;1321;8564;176122;31028;207150
2022.08_13-10-2022;Республика Тыва;165_195_days;CoviVac;102;36;138;176122;31028;207150
2022.08_13-10-2022;Республика Тыва;165_195_days;EpiVacCorona;328;49;377;176122;31028;207150
2022.08_13-10-2022;Республика Тыва;165_195_days;SputnikLite;3618;722;4340;176122;31028;207150
2022.08_13-10-2022;Республика Тыва;165_195_days;SputnikV;3195;514;3709;176122;31028;207150
2022.08_13-10-2022;Республика Тыва;21_45_days;AllVaccines;4032;690;4722;176122;31028;207150
2022.08_13-10-2022;Республика Тыва;21_45_days;CoviVac;7;0;7;176122;31028;207150
2022.08_13-10-2022;Республика Тыва;21_45_days;EpiVacCorona;53;14;67;176122;31028;207150
2022.08_13-10-2022;Республика Тыва;21_45_days;SputnikLite;99;13;112;176122;31028;207150
2022.08_13-10-2022;Республика Тыва;21_45_days;SputnikV;3873;663;4536;176122;31028;207150
2022.08_13-10-2022;Республика Тыва;45_75_days;AllVaccines;2088;396;2484;176122;31028;207150
2022.08_13-10-2022;Республика Тыва;45_75_days;EpiVacCorona;254;74;328;176122;31028;207150
2022.08_13-10-2022;Республика Тыва;45_75_days;SputnikLite;121;14;135;176122;31028;207150
2022.08_13-10-2022;Республика Тыва;45_75_days;SputnikV;1713;308;2021;176122;31028;207150
2022.08_13-10-2022;Республика Тыва;75_90_days;AllVaccines;1847;411;2258;176122;31028;207150
2022.08_13-10-2022;Республика Тыва;75_90_days;CoviVac;1;0;1;176122;31028;207150
2022.08_13-10-2022;Республика Тыва;75_90_days;EpiVacCorona;1177;264;1441;176122;31028;207150
2022.08_13-10-2022;Республика Тыва;75_90_days;SputnikLite;152;23;175;176122;31028;207150
2022.08_13-10-2022;Республика Тыва;75_90_days;SputnikV;517;124;641;176122;31028;207150
2022.08_13-10-2022;Республика Тыва;90_105_days;AllVaccines;1861;433;2294;176122;31028;207150
2022.08_13-10-2022;Республика Тыва;90_105_days;CoviVac;3;0;3;176122;31028;207150
2022.08_13-10-2022;Республика Тыва;90_105_days;EpiVacCorona;394;111;505;176122;31028;207150
2022.08_13-10-2022;Республика Тыва;90_105_days;SputnikLite;522;54;576;176122;31028;207150
2022.08_13-10-2022;Республика Тыва;90_105_days;SputnikV;942;268;1210;176122;31028;207150
2022.08_13-10-2022;Республика Хакасия;105_165_days;AllVaccines;2795;1613;4408;291439;112190;403629
2022.08_13-10-2022;Республика Хакасия;105_165_days;CoviVac;189;55;244;291439;112190;403629
2022.08_13-10-2022;Республика Хакасия;105_165_days;EpiVacCorona;203;165;368;291439;112190;403629
2022.08_13-10-2022;Республика Хакасия;105_165_days;SputnikLite;216;167;383;291439;112190;403629
2022.08_13-10-2022;Республика Хакасия;105_165_days;SputnikV;2187;1226;3413;291439;112190;403629
2022.08_13-10-2022;Республика Хакасия;165_195_days;AllVaccines;2912;1271;4183;291439;112190;403629
2022.08_13-10-2022;Республика Хакасия;165_195_days;CoviVac;77;11;88;291439;112190;403629
2022.08_13-10-2022;Республика Хакасия;165_195_days;EpiVacCorona;114;36;150;291439;112190;403629
2022.08_13-10-2022;Республика Хакасия;165_195_days;SputnikLite;488;198;686;291439;112190;403629
2022.08_13-10-2022;Республика Хакасия;165_195_days;SputnikV;2233;1026;3259;291439;112190;403629
2022.08_13-10-2022;Республика Хакасия;21_45_days;AllVaccines;1913;1051;2964;291439;112190;403629
2022.08_13-10-2022;Республика Хакасия;21_45_days;EpiVacCorona;77;32;109;291439;112190;403629
2022.08_13-10-2022;Республика Хакасия;21_45_days;SputnikLite;14;3;17;291439;112190;403629
2022.08_13-10-2022;Республика Хакасия;21_45_days;SputnikV;1822;1016;2838;291439;112190;403629
2022.08_13-10-2022;Республика Хакасия;45_75_days;AllVaccines;1151;725;1876;291439;112190;403629
2022.08_13-10-2022;Республика Хакасия;45_75_days;EpiVacCorona;156;80;236;291439;112190;403629
2022.08_13-10-2022;Республика Хакасия;45_75_days;SputnikLite;2;0;2;291439;112190;403629
2022.08_13-10-2022;Республика Хакасия;45_75_days;SputnikV;993;645;1638;291439;112190;403629
2022.08_13-10-2022;Республика Хакасия;75_90_days;AllVaccines;677;485;1162;291439;112190;403629
2022.08_13-10-2022;Республика Хакасия;75_90_days;EpiVacCorona;76;46;122;291439;112190;403629
2022.08_13-10-2022;Республика Хакасия;75_90_days;SputnikV;601;439;1040;291439;112190;403629
2022.08_13-10-2022;Республика Хакасия;90_105_days;AllVaccines;712;582;1294;291439;112190;403629
2022.08_13-10-2022;Республика Хакасия;90_105_days;EpiVacCorona;62;56;118;291439;112190;403629
2022.08_13-10-2022;Республика Хакасия;90_105_days;SputnikLite;2;0;2;291439;112190;403629
2022.08_13-10-2022;Республика Хакасия;90_105_days;SputnikV;648;526;1174;291439;112190;403629
2022.08_13-10-2022;Ростовская область;105_165_days;AllVaccines;60780;40721;101501;2367942;1020468;3388410
2022.08_13-10-2022;Ростовская область;105_165_days;CoviVac;3758;1247;5005;2367942;1020468;3388410
2022.08_13-10-2022;Ростовская область;105_165_days;EpiVacCorona;5345;4034;9379;2367942;1020468;3388410
2022.08_13-10-2022;Ростовская область;105_165_days;SputnikLite;4448;2116;6564;2367942;1020468;3388410
2022.08_13-10-2022;Ростовская область;105_165_days;SputnikV;47229;33324;80553;2367942;1020468;3388410
2022.08_13-10-2022;Ростовская область;165_195_days;AllVaccines;41553;24030;65583;2367942;1020468;3388410
2022.08_13-10-2022;Ростовская область;165_195_days;CoviVac;786;183;969;2367942;1020468;3388410
2022.08_13-10-2022;Ростовская область;165_195_days;EpiVacCorona;3135;1728;4863;2367942;1020468;3388410
2022.08_13-10-2022;Ростовская область;165_195_days;SputnikLite;6995;2505;9500;2367942;1020468;3388410
2022.08_13-10-2022;Ростовская область;165_195_days;SputnikV;30637;19614;50251;2367942;1020468;3388410
2022.08_13-10-2022;Ростовская область;21_45_days;AllVaccines;33211;18329;51540;2367942;1020468;3388410
2022.08_13-10-2022;Ростовская область;21_45_days;CoviVac;17;5;22;2367942;1020468;3388410
2022.08_13-10-2022;Ростовская область;21_45_days;EpiVacCorona;300;78;378;2367942;1020468;3388410
2022.08_13-10-2022;Ростовская область;21_45_days;SputnikLite;247;51;298;2367942;1020468;3388410
2022.08_13-10-2022;Ростовская область;21_45_days;SputnikV;32647;18195;50842;2367942;1020468;3388410
2022.08_13-10-2022;Ростовская область;45_75_days;AllVaccines;24647;16628;41275;2367942;1020468;3388410
2022.08_13-10-2022;Ростовская область;45_75_days;CoviVac;84;16;100;2367942;1020468;3388410
2022.08_13-10-2022;Ростовская область;45_75_days;EpiVacCorona;2219;1137;3356;2367942;1020468;3388410
2022.08_13-10-2022;Ростовская область;45_75_days;SputnikLite;342;67;409;2367942;1020468;3388410
2022.08_13-10-2022;Ростовская область;45_75_days;SputnikV;22002;15408;37410;2367942;1020468;3388410
2022.08_13-10-2022;Ростовская область;75_90_days;AllVaccines;15631;9221;24852;2367942;1020468;3388410
2022.08_13-10-2022;Ростовская область;75_90_days;CoviVac;239;125;364;2367942;1020468;3388410
2022.08_13-10-2022;Ростовская область;75_90_days;EpiVacCorona;1713;817;2530;2367942;1020468;3388410
2022.08_13-10-2022;Ростовская область;75_90_days;SputnikLite;110;37;147;2367942;1020468;3388410
2022.08_13-10-2022;Ростовская область;75_90_days;SputnikV;13569;8242;21811;2367942;1020468;3388410
2022.08_13-10-2022;Ростовская область;90_105_days;AllVaccines;14873;11263;26136;2367942;1020468;3388410
2022.08_13-10-2022;Ростовская область;90_105_days;CoviVac;426;149;575;2367942;1020468;3388410
2022.08_13-10-2022;Ростовская область;90_105_days;EpiVacCorona;1495;1049;2544;2367942;1020468;3388410
2022.08_13-10-2022;Ростовская область;90_105_days;SputnikLite;258;99;357;2367942;1020468;3388410
2022.08_13-10-2022;Ростовская область;90_105_days;SputnikV;12694;9966;22660;2367942;1020468;3388410
2022.08_13-10-2022;Рязанская область;105_165_days;AllVaccines;4974;4034;9008;600731;301318;902049
2022.08_13-10-2022;Рязанская область;105_165_days;CoviVac;298;111;409;600731;301318;902049
2022.08_13-10-2022;Рязанская область;105_165_days;EpiVacCorona;160;69;229;600731;301318;902049
2022.08_13-10-2022;Рязанская область;105_165_days;SputnikLite;1369;1369;2738;600731;301318;902049
2022.08_13-10-2022;Рязанская область;105_165_days;SputnikV;3147;2485;5632;600731;301318;902049
2022.08_13-10-2022;Рязанская область;165_195_days;AllVaccines;4647;2575;7222;600731;301318;902049
2022.08_13-10-2022;Рязанская область;165_195_days;CoviVac;201;49;250;600731;301318;902049
2022.08_13-10-2022;Рязанская область;165_195_days;EpiVacCorona;106;54;160;600731;301318;902049
2022.08_13-10-2022;Рязанская область;165_195_days;SputnikLite;1110;812;1922;600731;301318;902049
2022.08_13-10-2022;Рязанская область;165_195_days;SputnikV;3230;1660;4890;600731;301318;902049
2022.08_13-10-2022;Рязанская область;21_45_days;AllVaccines;2829;1678;4507;600731;301318;902049
2022.08_13-10-2022;Рязанская область;21_45_days;EpiVacCorona;15;12;27;600731;301318;902049
2022.08_13-10-2022;Рязанская область;21_45_days;SputnikLite;178;26;204;600731;301318;902049
2022.08_13-10-2022;Рязанская область;21_45_days;SputnikV;2636;1640;4276;600731;301318;902049
2022.08_13-10-2022;Рязанская область;45_75_days;AllVaccines;1915;879;2794;600731;301318;902049
2022.08_13-10-2022;Рязанская область;45_75_days;CoviVac;8;4;12;600731;301318;902049
2022.08_13-10-2022;Рязанская область;45_75_days;EpiVacCorona;485;204;689;600731;301318;902049
2022.08_13-10-2022;Рязанская область;45_75_days;SputnikLite;148;65;213;600731;301318;902049
2022.08_13-10-2022;Рязанская область;45_75_days;SputnikV;1274;606;1880;600731;301318;902049
2022.08_13-10-2022;Рязанская область;75_90_days;AllVaccines;1896;1180;3076;600731;301318;902049
2022.08_13-10-2022;Рязанская область;75_90_days;CoviVac;168;127;295;600731;301318;902049
2022.08_13-10-2022;Рязанская область;75_90_days;EpiVacCorona;712;489;1201;600731;301318;902049
2022.08_13-10-2022;Рязанская область;75_90_days;SputnikLite;82;44;126;600731;301318;902049
2022.08_13-10-2022;Рязанская область;75_90_days;SputnikV;934;520;1454;600731;301318;902049
2022.08_13-10-2022;Рязанская область;90_105_days;AllVaccines;1211;942;2153;600731;301318;902049
2022.08_13-10-2022;Рязанская область;90_105_days;CoviVac;21;9;30;600731;301318;902049
2022.08_13-10-2022;Рязанская область;90_105_days;EpiVacCorona;114;78;192;600731;301318;902049
2022.08_13-10-2022;Рязанская область;90_105_days;SputnikLite;110;54;164;600731;301318;902049
2022.08_13-10-2022;Рязанская область;90_105_days;SputnikV;966;801;1767;600731;301318;902049
2022.08_13-10-2022;Самарская область;105_165_days;AllVaccines;33986;31263;65249;1769846;769791;2539637
2022.08_13-10-2022;Самарская область;105_165_days;CoviVac;1024;549;1573;1769846;769791;2539637
2022.08_13-10-2022;Самарская область;105_165_days;EpiVacCorona;2035;3246;5281;1769846;769791;2539637
2022.08_13-10-2022;Самарская область;105_165_days;SputnikLite;11897;5412;17309;1769846;769791;2539637
2022.08_13-10-2022;Самарская область;105_165_days;SputnikV;19030;22056;41086;1769846;769791;2539637
2022.08_13-10-2022;Самарская область;165_195_days;AllVaccines;24908;18693;43601;1769846;769791;2539637
2022.08_13-10-2022;Самарская область;165_195_days;CoviVac;390;236;626;1769846;769791;2539637
2022.08_13-10-2022;Самарская область;165_195_days;EpiVacCorona;1875;2176;4051;1769846;769791;2539637
2022.08_13-10-2022;Самарская область;165_195_days;SputnikLite;8401;3930;12331;1769846;769791;2539637
2022.08_13-10-2022;Самарская область;165_195_days;SputnikV;14242;12351;26593;1769846;769791;2539637
2022.08_13-10-2022;Самарская область;21_45_days;AllVaccines;18317;8987;27304;1769846;769791;2539637
2022.08_13-10-2022;Самарская область;21_45_days;CoviVac;38;19;57;1769846;769791;2539637
2022.08_13-10-2022;Самарская область;21_45_days;EpiVacCorona;277;94;371;1769846;769791;2539637
2022.08_13-10-2022;Самарская область;21_45_days;SputnikLite;2555;967;3522;1769846;769791;2539637
2022.08_13-10-2022;Самарская область;21_45_days;SputnikV;15447;7907;23354;1769846;769791;2539637
2022.08_13-10-2022;Самарская область;45_75_days;AllVaccines;12289;9238;21527;1769846;769791;2539637
2022.08_13-10-2022;Самарская область;45_75_days;CoviVac;38;3;41;1769846;769791;2539637
2022.08_13-10-2022;Самарская область;45_75_days;EpiVacCorona;1101;1436;2537;1769846;769791;2539637
2022.08_13-10-2022;Самарская область;45_75_days;SputnikLite;2287;874;3161;1769846;769791;2539637
2022.08_13-10-2022;Самарская область;45_75_days;SputnikV;8863;6925;15788;1769846;769791;2539637
2022.08_13-10-2022;Самарская область;75_90_days;AllVaccines;6826;5692;12518;1769846;769791;2539637
2022.08_13-10-2022;Самарская область;75_90_days;CoviVac;110;205;315;1769846;769791;2539637
2022.08_13-10-2022;Самарская область;75_90_days;EpiVacCorona;686;1070;1756;1769846;769791;2539637
2022.08_13-10-2022;Самарская область;75_90_days;SputnikLite;1726;700;2426;1769846;769791;2539637
2022.08_13-10-2022;Самарская область;75_90_days;SputnikV;4304;3717;8021;1769846;769791;2539637
2022.08_13-10-2022;Самарская область;90_105_days;AllVaccines;6964;6475;13439;1769846;769791;2539637
2022.08_13-10-2022;Самарская область;90_105_days;CoviVac;154;134;288;1769846;769791;2539637
2022.08_13-10-2022;Самарская область;90_105_days;EpiVacCorona;454;410;864;1769846;769791;2539637
2022.08_13-10-2022;Самарская область;90_105_days;SputnikLite;1785;962;2747;1769846;769791;2539637
2022.08_13-10-2022;Самарская область;90_105_days;SputnikV;4571;4969;9540;1769846;769791;2539637
2022.08_13-10-2022;Саратовская область;105_165_days;AllVaccines;24924;17262;42186;1348454;599954;1948408
2022.08_13-10-2022;Саратовская область;105_165_days;CoviVac;2182;641;2823;1348454;599954;1948408
2022.08_13-10-2022;Саратовская область;105_165_days;EpiVacCorona;2903;2797;5700;1348454;599954;1948408
2022.08_13-10-2022;Саратовская область;105_165_days;SputnikLite;4933;2765;7698;1348454;599954;1948408
2022.08_13-10-2022;Саратовская область;105_165_days;SputnikV;14906;11059;25965;1348454;599954;1948408
2022.08_13-10-2022;Саратовская область;165_195_days;AllVaccines;14811;9451;24262;1348454;599954;1948408
2022.08_13-10-2022;Саратовская область;165_195_days;CoviVac;551;262;813;1348454;599954;1948408
2022.08_13-10-2022;Саратовская область;165_195_days;EpiVacCorona;1711;1311;3022;1348454;599954;1948408
2022.08_13-10-2022;Саратовская область;165_195_days;SputnikLite;4348;2319;6667;1348454;599954;1948408
2022.08_13-10-2022;Саратовская область;165_195_days;SputnikV;8201;5559;13760;1348454;599954;1948408
2022.08_13-10-2022;Саратовская область;21_45_days;AllVaccines;18408;9667;28075;1348454;599954;1948408
2022.08_13-10-2022;Саратовская область;21_45_days;CoviVac;10;3;13;1348454;599954;1948408
2022.08_13-10-2022;Саратовская область;21_45_days;EpiVacCorona;19;6;25;1348454;599954;1948408
2022.08_13-10-2022;Саратовская область;21_45_days;SputnikLite;245;127;372;1348454;599954;1948408
2022.08_13-10-2022;Саратовская область;21_45_days;SputnikV;18134;9531;27665;1348454;599954;1948408
2022.08_13-10-2022;Саратовская область;45_75_days;AllVaccines;13447;6340;19787;1348454;599954;1948408
2022.08_13-10-2022;Саратовская область;45_75_days;CoviVac;24;8;32;1348454;599954;1948408
2022.08_13-10-2022;Саратовская область;45_75_days;EpiVacCorona;1002;579;1581;1348454;599954;1948408
2022.08_13-10-2022;Саратовская область;45_75_days;SputnikLite;132;20;152;1348454;599954;1948408
2022.08_13-10-2022;Саратовская область;45_75_days;SputnikV;12289;5733;18022;1348454;599954;1948408
2022.08_13-10-2022;Саратовская область;75_90_days;AllVaccines;10970;5969;16939;1348454;599954;1948408
2022.08_13-10-2022;Саратовская область;75_90_days;CoviVac;320;103;423;1348454;599954;1948408
2022.08_13-10-2022;Саратовская область;75_90_days;EpiVacCorona;1278;718;1996;1348454;599954;1948408
2022.08_13-10-2022;Саратовская область;75_90_days;SputnikLite;155;30;185;1348454;599954;1948408
2022.08_13-10-2022;Саратовская область;75_90_days;SputnikV;9217;5118;14335;1348454;599954;1948408
2022.08_13-10-2022;Саратовская область;90_105_days;AllVaccines;6483;4113;10596;1348454;599954;1948408
2022.08_13-10-2022;Саратовская область;90_105_days;CoviVac;213;37;250;1348454;599954;1948408
2022.08_13-10-2022;Саратовская область;90_105_days;EpiVacCorona;669;450;1119;1348454;599954;1948408
2022.08_13-10-2022;Саратовская область;90_105_days;SputnikLite;180;83;263;1348454;599954;1948408
2022.08_13-10-2022;Саратовская область;90_105_days;SputnikV;5421;3543;8964;1348454;599954;1948408
2022.08_13-10-2022;Сахалинская область;105_165_days;AllVaccines;6083;2461;8544;276677;101794;378471
2022.08_13-10-2022;Сахалинская область;105_165_days;CoviVac;90;7;97;276677;101794;378471
2022.08_13-10-2022;Сахалинская область;105_165_days;EpiVacCorona;398;40;438;276677;101794;378471
2022.08_13-10-2022;Сахалинская область;105_165_days;SputnikLite;3325;1719;5044;276677;101794;378471
2022.08_13-10-2022;Сахалинская область;105_165_days;SputnikV;2270;695;2965;276677;101794;378471
2022.08_13-10-2022;Сахалинская область;165_195_days;AllVaccines;6346;1828;8174;276677;101794;378471
2022.08_13-10-2022;Сахалинская область;165_195_days;CoviVac;301;29;330;276677;101794;378471
2022.08_13-10-2022;Сахалинская область;165_195_days;EpiVacCorona;301;59;360;276677;101794;378471
2022.08_13-10-2022;Сахалинская область;165_195_days;SputnikLite;3069;1049;4118;276677;101794;378471
2022.08_13-10-2022;Сахалинская область;165_195_days;SputnikV;2675;691;3366;276677;101794;378471
2022.08_13-10-2022;Сахалинская область;21_45_days;AllVaccines;3073;1708;4781;276677;101794;378471
2022.08_13-10-2022;Сахалинская область;21_45_days;CoviVac;1;0;1;276677;101794;378471
2022.08_13-10-2022;Сахалинская область;21_45_days;EpiVacCorona;56;14;70;276677;101794;378471
2022.08_13-10-2022;Сахалинская область;21_45_days;SputnikLite;58;9;67;276677;101794;378471
2022.08_13-10-2022;Сахалинская область;21_45_days;SputnikV;2958;1685;4643;276677;101794;378471
2022.08_13-10-2022;Сахалинская область;45_75_days;AllVaccines;1891;826;2717;276677;101794;378471
2022.08_13-10-2022;Сахалинская область;45_75_days;EpiVacCorona;404;134;538;276677;101794;378471
2022.08_13-10-2022;Сахалинская область;45_75_days;SputnikLite;17;2;19;276677;101794;378471
2022.08_13-10-2022;Сахалинская область;45_75_days;SputnikV;1470;690;2160;276677;101794;378471
2022.08_13-10-2022;Сахалинская область;75_90_days;AllVaccines;1229;578;1807;276677;101794;378471
2022.08_13-10-2022;Сахалинская область;75_90_days;CoviVac;2;0;2;276677;101794;378471
2022.08_13-10-2022;Сахалинская область;75_90_days;EpiVacCorona;306;128;434;276677;101794;378471
2022.08_13-10-2022;Сахалинская область;75_90_days;SputnikLite;15;4;19;276677;101794;378471
2022.08_13-10-2022;Сахалинская область;75_90_days;SputnikV;906;446;1352;276677;101794;378471
2022.08_13-10-2022;Сахалинская область;90_105_days;AllVaccines;1021;538;1559;276677;101794;378471
2022.08_13-10-2022;Сахалинская область;90_105_days;CoviVac;1;0;1;276677;101794;378471
2022.08_13-10-2022;Сахалинская область;90_105_days;EpiVacCorona;106;51;157;276677;101794;378471
2022.08_13-10-2022;Сахалинская область;90_105_days;SputnikLite;114;39;153;276677;101794;378471
2022.08_13-10-2022;Сахалинская область;90_105_days;SputnikV;800;448;1248;276677;101794;378471
2022.08_13-10-2022;Свердловская область;105_165_days;AllVaccines;46112;32520;78632;2364046;987486;3351532
2022.08_13-10-2022;Свердловская область;105_165_days;CoviVac;1109;444;1553;2364046;987486;3351532
2022.08_13-10-2022;Свердловская область;105_165_days;EpiVacCorona;3308;1703;5011;2364046;987486;3351532
2022.08_13-10-2022;Свердловская область;105_165_days;SputnikLite;6517;3746;10263;2364046;987486;3351532
2022.08_13-10-2022;Свердловская область;105_165_days;SputnikV;35178;26627;61805;2364046;987486;3351532
2022.08_13-10-2022;Свердловская область;165_195_days;AllVaccines;33863;16618;50481;2364046;987486;3351532
2022.08_13-10-2022;Свердловская область;165_195_days;CoviVac;215;50;265;2364046;987486;3351532
2022.08_13-10-2022;Свердловская область;165_195_days;EpiVacCorona;1854;897;2751;2364046;987486;3351532
2022.08_13-10-2022;Свердловская область;165_195_days;SputnikLite;6773;3012;9785;2364046;987486;3351532
2022.08_13-10-2022;Свердловская область;165_195_days;SputnikV;25021;12659;37680;2364046;987486;3351532
2022.08_13-10-2022;Свердловская область;21_45_days;AllVaccines;26893;17998;44891;2364046;987486;3351532
2022.08_13-10-2022;Свердловская область;21_45_days;CoviVac;243;68;311;2364046;987486;3351532
2022.08_13-10-2022;Свердловская область;21_45_days;EpiVacCorona;111;64;175;2364046;987486;3351532
2022.08_13-10-2022;Свердловская область;21_45_days;SputnikLite;777;202;979;2364046;987486;3351532
2022.08_13-10-2022;Свердловская область;21_45_days;SputnikV;25762;17664;43426;2364046;987486;3351532
2022.08_13-10-2022;Свердловская область;45_75_days;AllVaccines;17472;12516;29988;2364046;987486;3351532
2022.08_13-10-2022;Свердловская область;45_75_days;CoviVac;283;46;329;2364046;987486;3351532
2022.08_13-10-2022;Свердловская область;45_75_days;EpiVacCorona;772;626;1398;2364046;987486;3351532
2022.08_13-10-2022;Свердловская область;45_75_days;SputnikLite;1144;408;1552;2364046;987486;3351532
2022.08_13-10-2022;Свердловская область;45_75_days;SputnikV;15273;11436;26709;2364046;987486;3351532
2022.08_13-10-2022;Свердловская область;75_90_days;AllVaccines;12263;9125;21388;2364046;987486;3351532
2022.08_13-10-2022;Свердловская область;75_90_days;CoviVac;570;246;816;2364046;987486;3351532
2022.08_13-10-2022;Свердловская область;75_90_days;EpiVacCorona;950;780;1730;2364046;987486;3351532
2022.08_13-10-2022;Свердловская область;75_90_days;SputnikLite;643;284;927;2364046;987486;3351532
2022.08_13-10-2022;Свердловская область;75_90_days;SputnikV;10100;7815;17915;2364046;987486;3351532
2022.08_13-10-2022;Свердловская область;90_105_days;AllVaccines;11462;9418;20880;2364046;987486;3351532
2022.08_13-10-2022;Свердловская область;90_105_days;CoviVac;589;338;927;2364046;987486;3351532
2022.08_13-10-2022;Свердловская область;90_105_days;EpiVacCorona;841;672;1513;2364046;987486;3351532
2022.08_13-10-2022;Свердловская область;90_105_days;SputnikLite;675;297;972;2364046;987486;3351532
2022.08_13-10-2022;Свердловская область;90_105_days;SputnikV;9357;8111;17468;2364046;987486;3351532
2022.08_13-10-2022;Смоленская область;105_165_days;AllVaccines;7404;5269;12673;521379;238479;759858
2022.08_13-10-2022;Смоленская область;105_165_days;CoviVac;454;378;832;521379;238479;759858
2022.08_13-10-2022;Смоленская область;105_165_days;EpiVacCorona;581;580;1161;521379;238479;759858
2022.08_13-10-2022;Смоленская область;105_165_days;SputnikLite;2441;1477;3918;521379;238479;759858
2022.08_13-10-2022;Смоленская область;105_165_days;SputnikV;3928;2834;6762;521379;238479;759858
2022.08_13-10-2022;Смоленская область;165_195_days;AllVaccines;6281;3264;9545;521379;238479;759858
2022.08_13-10-2022;Смоленская область;165_195_days;CoviVac;336;88;424;521379;238479;759858
2022.08_13-10-2022;Смоленская область;165_195_days;EpiVacCorona;487;232;719;521379;238479;759858
2022.08_13-10-2022;Смоленская область;165_195_days;SputnikLite;1153;668;1821;521379;238479;759858
2022.08_13-10-2022;Смоленская область;165_195_days;SputnikV;4305;2276;6581;521379;238479;759858
2022.08_13-10-2022;Смоленская область;21_45_days;AllVaccines;4332;2322;6654;521379;238479;759858
2022.08_13-10-2022;Смоленская область;21_45_days;CoviVac;19;11;30;521379;238479;759858
2022.08_13-10-2022;Смоленская область;21_45_days;EpiVacCorona;158;93;251;521379;238479;759858
2022.08_13-10-2022;Смоленская область;21_45_days;SputnikLite;375;83;458;521379;238479;759858
2022.08_13-10-2022;Смоленская область;21_45_days;SputnikV;3780;2135;5915;521379;238479;759858
2022.08_13-10-2022;Смоленская область;45_75_days;AllVaccines;2581;1714;4295;521379;238479;759858
2022.08_13-10-2022;Смоленская область;45_75_days;CoviVac;13;4;17;521379;238479;759858
2022.08_13-10-2022;Смоленская область;45_75_days;EpiVacCorona;443;413;856;521379;238479;759858
2022.08_13-10-2022;Смоленская область;45_75_days;SputnikLite;356;35;391;521379;238479;759858
2022.08_13-10-2022;Смоленская область;45_75_days;SputnikV;1769;1262;3031;521379;238479;759858
2022.08_13-10-2022;Смоленская область;75_90_days;AllVaccines;1741;1066;2807;521379;238479;759858
2022.08_13-10-2022;Смоленская область;75_90_days;CoviVac;78;26;104;521379;238479;759858
2022.08_13-10-2022;Смоленская область;75_90_days;EpiVacCorona;119;141;260;521379;238479;759858
2022.08_13-10-2022;Смоленская область;75_90_days;SputnikLite;302;35;337;521379;238479;759858
2022.08_13-10-2022;Смоленская область;75_90_days;SputnikV;1242;864;2106;521379;238479;759858
2022.08_13-10-2022;Смоленская область;90_105_days;AllVaccines;1625;1075;2700;521379;238479;759858
2022.08_13-10-2022;Смоленская область;90_105_days;CoviVac;46;21;67;521379;238479;759858
2022.08_13-10-2022;Смоленская область;90_105_days;EpiVacCorona;182;172;354;521379;238479;759858
2022.08_13-10-2022;Смоленская область;90_105_days;SputnikLite;224;38;262;521379;238479;759858
2022.08_13-10-2022;Смоленская область;90_105_days;SputnikV;1173;844;2017;521379;238479;759858
2022.08_13-10-2022;Ставропольский край;105_165_days;AllVaccines;20344;11643;31987;1590669;616030;2206699
2022.08_13-10-2022;Ставропольский край;105_165_days;CoviVac;1010;434;1444;1590669;616030;2206699
2022.08_13-10-2022;Ставропольский край;105_165_days;EpiVacCorona;2114;1072;3186;1590669;616030;2206699
2022.08_13-10-2022;Ставропольский край;105_165_days;SputnikLite;2588;1497;4085;1590669;616030;2206699
2022.08_13-10-2022;Ставропольский край;105_165_days;SputnikV;14632;8640;23272;1590669;616030;2206699
2022.08_13-10-2022;Ставропольский край;165_195_days;AllVaccines;15721;11814;27535;1590669;616030;2206699
2022.08_13-10-2022;Ставропольский край;165_195_days;CoviVac;658;446;1104;1590669;616030;2206699
2022.08_13-10-2022;Ставропольский край;165_195_days;EpiVacCorona;1279;627;1906;1590669;616030;2206699
2022.08_13-10-2022;Ставропольский край;165_195_days;SputnikLite;1768;974;2742;1590669;616030;2206699
2022.08_13-10-2022;Ставропольский край;165_195_days;SputnikV;12016;9767;21783;1590669;616030;2206699
2022.08_13-10-2022;Ставропольский край;21_45_days;AllVaccines;16522;7271;23793;1590669;616030;2206699
2022.08_13-10-2022;Ставропольский край;21_45_days;CoviVac;19;6;25;1590669;616030;2206699
2022.08_13-10-2022;Ставропольский край;21_45_days;EpiVacCorona;169;217;386;1590669;616030;2206699
2022.08_13-10-2022;Ставропольский край;21_45_days;SputnikLite;367;88;455;1590669;616030;2206699
2022.08_13-10-2022;Ставропольский край;21_45_days;SputnikV;15967;6960;22927;1590669;616030;2206699
2022.08_13-10-2022;Ставропольский край;45_75_days;AllVaccines;8535;3822;12357;1590669;616030;2206699
2022.08_13-10-2022;Ставропольский край;45_75_days;CoviVac;131;60;191;1590669;616030;2206699
2022.08_13-10-2022;Ставропольский край;45_75_days;EpiVacCorona;559;142;701;1590669;616030;2206699
2022.08_13-10-2022;Ставропольский край;45_75_days;SputnikLite;420;154;574;1590669;616030;2206699
2022.08_13-10-2022;Ставропольский край;45_75_days;SputnikV;7425;3466;10891;1590669;616030;2206699
2022.08_13-10-2022;Ставропольский край;75_90_days;AllVaccines;5191;2468;7659;1590669;616030;2206699
2022.08_13-10-2022;Ставропольский край;75_90_days;CoviVac;372;92;464;1590669;616030;2206699
2022.08_13-10-2022;Ставропольский край;75_90_days;EpiVacCorona;291;63;354;1590669;616030;2206699
2022.08_13-10-2022;Ставропольский край;75_90_days;SputnikLite;196;61;257;1590669;616030;2206699
2022.08_13-10-2022;Ставропольский край;75_90_days;SputnikV;4332;2252;6584;1590669;616030;2206699
2022.08_13-10-2022;Ставропольский край;90_105_days;AllVaccines;4522;2847;7369;1590669;616030;2206699
2022.08_13-10-2022;Ставропольский край;90_105_days;CoviVac;429;151;580;1590669;616030;2206699
2022.08_13-10-2022;Ставропольский край;90_105_days;EpiVacCorona;298;145;443;1590669;616030;2206699
2022.08_13-10-2022;Ставропольский край;90_105_days;SputnikLite;234;96;330;1590669;616030;2206699
2022.08_13-10-2022;Ставропольский край;90_105_days;SputnikV;3561;2455;6016;1590669;616030;2206699
2022.08_13-10-2022;Тамбовская область;105_165_days;AllVaccines;19837;24259;44096;545785;279936;825721
2022.08_13-10-2022;Тамбовская область;105_165_days;CoviVac;2485;706;3191;545785;279936;825721
2022.08_13-10-2022;Тамбовская область;105_165_days;EpiVacCorona;2356;3146;5502;545785;279936;825721
2022.08_13-10-2022;Тамбовская область;105_165_days;SputnikLite;262;118;380;545785;279936;825721
2022.08_13-10-2022;Тамбовская область;105_165_days;SputnikV;14734;20289;35023;545785;279936;825721
2022.08_13-10-2022;Тамбовская область;165_195_days;AllVaccines;13123;8572;21695;545785;279936;825721
2022.08_13-10-2022;Тамбовская область;165_195_days;CoviVac;580;61;641;545785;279936;825721
2022.08_13-10-2022;Тамбовская область;165_195_days;EpiVacCorona;1098;955;2053;545785;279936;825721
2022.08_13-10-2022;Тамбовская область;165_195_days;SputnikLite;814;552;1366;545785;279936;825721
2022.08_13-10-2022;Тамбовская область;165_195_days;SputnikV;10631;7004;17635;545785;279936;825721
2022.08_13-10-2022;Тамбовская область;21_45_days;AllVaccines;11656;7431;19087;545785;279936;825721
2022.08_13-10-2022;Тамбовская область;21_45_days;EpiVacCorona;8;0;8;545785;279936;825721
2022.08_13-10-2022;Тамбовская область;21_45_days;SputnikLite;171;47;218;545785;279936;825721
2022.08_13-10-2022;Тамбовская область;21_45_days;SputnikV;11477;7384;18861;545785;279936;825721
2022.08_13-10-2022;Тамбовская область;45_75_days;AllVaccines;7601;4698;12299;545785;279936;825721
2022.08_13-10-2022;Тамбовская область;45_75_days;CoviVac;4;0;4;545785;279936;825721
2022.08_13-10-2022;Тамбовская область;45_75_days;EpiVacCorona;1654;1049;2703;545785;279936;825721
2022.08_13-10-2022;Тамбовская область;45_75_days;SputnikLite;89;15;104;545785;279936;825721
2022.08_13-10-2022;Тамбовская область;45_75_days;SputnikV;5854;3634;9488;545785;279936;825721
2022.08_13-10-2022;Тамбовская область;75_90_days;AllVaccines;6800;5692;12492;545785;279936;825721
2022.08_13-10-2022;Тамбовская область;75_90_days;CoviVac;261;50;311;545785;279936;825721
2022.08_13-10-2022;Тамбовская область;75_90_days;EpiVacCorona;2232;1872;4104;545785;279936;825721
2022.08_13-10-2022;Тамбовская область;75_90_days;SputnikLite;54;25;79;545785;279936;825721
2022.08_13-10-2022;Тамбовская область;75_90_days;SputnikV;4253;3745;7998;545785;279936;825721
2022.08_13-10-2022;Тамбовская область;90_105_days;AllVaccines;5490;7285;12775;545785;279936;825721
2022.08_13-10-2022;Тамбовская область;90_105_days;CoviVac;189;41;230;545785;279936;825721
2022.08_13-10-2022;Тамбовская область;90_105_days;EpiVacCorona;1297;1757;3054;545785;279936;825721
2022.08_13-10-2022;Тамбовская область;90_105_days;SputnikLite;59;73;132;545785;279936;825721
2022.08_13-10-2022;Тамбовская область;90_105_days;SputnikV;3945;5414;9359;545785;279936;825721
2022.08_13-10-2022;Тверская область;105_165_days;AllVaccines;6811;7552;14363;681519;330234;1011753
2022.08_13-10-2022;Тверская область;105_165_days;CoviVac;365;85;450;681519;330234;1011753
2022.08_13-10-2022;Тверская область;105_165_days;EpiVacCorona;481;528;1009;681519;330234;1011753
2022.08_13-10-2022;Тверская область;105_165_days;SputnikLite;1920;2526;4446;681519;330234;1011753
2022.08_13-10-2022;Тверская область;105_165_days;SputnikV;4045;4413;8458;681519;330234;1011753
2022.08_13-10-2022;Тверская область;165_195_days;AllVaccines;6236;4827;11063;681519;330234;1011753
2022.08_13-10-2022;Тверская область;165_195_days;CoviVac;283;68;351;681519;330234;1011753
2022.08_13-10-2022;Тверская область;165_195_days;EpiVacCorona;249;161;410;681519;330234;1011753
2022.08_13-10-2022;Тверская область;165_195_days;SputnikLite;2754;2447;5201;681519;330234;1011753
2022.08_13-10-2022;Тверская область;165_195_days;SputnikV;2950;2151;5101;681519;330234;1011753
2022.08_13-10-2022;Тверская область;21_45_days;AllVaccines;4680;4516;9196;681519;330234;1011753
2022.08_13-10-2022;Тверская область;21_45_days;EpiVacCorona;21;8;29;681519;330234;1011753
2022.08_13-10-2022;Тверская область;21_45_days;SputnikLite;137;80;217;681519;330234;1011753
2022.08_13-10-2022;Тверская область;21_45_days;SputnikV;4522;4428;8950;681519;330234;1011753
2022.08_13-10-2022;Тверская область;45_75_days;AllVaccines;2374;2026;4400;681519;330234;1011753
2022.08_13-10-2022;Тверская область;45_75_days;CoviVac;1;0;1;681519;330234;1011753
2022.08_13-10-2022;Тверская область;45_75_days;EpiVacCorona;93;79;172;681519;330234;1011753
2022.08_13-10-2022;Тверская область;45_75_days;SputnikLite;136;85;221;681519;330234;1011753
2022.08_13-10-2022;Тверская область;45_75_days;SputnikV;2144;1862;4006;681519;330234;1011753
2022.08_13-10-2022;Тверская область;75_90_days;AllVaccines;1460;1450;2910;681519;330234;1011753
2022.08_13-10-2022;Тверская область;75_90_days;CoviVac;1;2;3;681519;330234;1011753
2022.08_13-10-2022;Тверская область;75_90_days;EpiVacCorona;177;150;327;681519;330234;1011753
2022.08_13-10-2022;Тверская область;75_90_days;SputnikLite;184;77;261;681519;330234;1011753
2022.08_13-10-2022;Тверская область;75_90_days;SputnikV;1098;1221;2319;681519;330234;1011753
2022.08_13-10-2022;Тверская область;90_105_days;AllVaccines;1442;1968;3410;681519;330234;1011753
2022.08_13-10-2022;Тверская область;90_105_days;CoviVac;4;2;6;681519;330234;1011753
2022.08_13-10-2022;Тверская область;90_105_days;EpiVacCorona;345;277;622;681519;330234;1011753
2022.08_13-10-2022;Тверская область;90_105_days;SputnikLite;78;72;150;681519;330234;1011753
2022.08_13-10-2022;Тверская область;90_105_days;SputnikV;1015;1617;2632;681519;330234;1011753
2022.08_13-10-2022;Томская область;105_165_days;AllVaccines;7176;5153;12329;621613;222482;844095
2022.08_13-10-2022;Томская область;105_165_days;CoviVac;413;107;520;621613;222482;844095
2022.08_13-10-2022;Томская область;105_165_days;EpiVacCorona;469;369;838;621613;222482;844095
2022.08_13-10-2022;Томская область;105_165_days;SputnikLite;2025;1514;3539;621613;222482;844095
2022.08_13-10-2022;Томская область;105_165_days;SputnikV;4269;3163;7432;621613;222482;844095
2022.08_13-10-2022;Томская область;165_195_days;AllVaccines;6825;3302;10127;621613;222482;844095
2022.08_13-10-2022;Томская область;165_195_days;CoviVac;212;15;227;621613;222482;844095
2022.08_13-10-2022;Томская область;165_195_days;EpiVacCorona;403;143;546;621613;222482;844095
2022.08_13-10-2022;Томская область;165_195_days;SputnikLite;2476;1313;3789;621613;222482;844095
2022.08_13-10-2022;Томская область;165_195_days;SputnikV;3734;1831;5565;621613;222482;844095
2022.08_13-10-2022;Томская область;21_45_days;AllVaccines;2052;1396;3448;621613;222482;844095
2022.08_13-10-2022;Томская область;21_45_days;CoviVac;0;1;1;621613;222482;844095
2022.08_13-10-2022;Томская область;21_45_days;EpiVacCorona;1;0;1;621613;222482;844095
2022.08_13-10-2022;Томская область;21_45_days;SputnikLite;61;14;75;621613;222482;844095
2022.08_13-10-2022;Томская область;21_45_days;SputnikV;1990;1381;3371;621613;222482;844095
2022.08_13-10-2022;Томская область;45_75_days;AllVaccines;1929;1175;3104;621613;222482;844095
2022.08_13-10-2022;Томская область;45_75_days;CoviVac;1;0;1;621613;222482;844095
2022.08_13-10-2022;Томская область;45_75_days;EpiVacCorona;29;10;39;621613;222482;844095
2022.08_13-10-2022;Томская область;45_75_days;SputnikLite;198;90;288;621613;222482;844095
2022.08_13-10-2022;Томская область;45_75_days;SputnikV;1701;1075;2776;621613;222482;844095
2022.08_13-10-2022;Томская область;75_90_days;AllVaccines;1695;966;2661;621613;222482;844095
2022.08_13-10-2022;Томская область;75_90_days;CoviVac;62;8;70;621613;222482;844095
2022.08_13-10-2022;Томская область;75_90_days;EpiVacCorona;48;24;72;621613;222482;844095
2022.08_13-10-2022;Томская область;75_90_days;SputnikLite;493;325;818;621613;222482;844095
2022.08_13-10-2022;Томская область;75_90_days;SputnikV;1092;609;1701;621613;222482;844095
2022.08_13-10-2022;Томская область;90_105_days;AllVaccines;1719;1060;2779;621613;222482;844095
2022.08_13-10-2022;Томская область;90_105_days;CoviVac;86;12;98;621613;222482;844095
2022.08_13-10-2022;Томская область;90_105_days;EpiVacCorona;54;19;73;621613;222482;844095
2022.08_13-10-2022;Томская область;90_105_days;SputnikLite;517;318;835;621613;222482;844095
2022.08_13-10-2022;Томская область;90_105_days;SputnikV;1062;711;1773;621613;222482;844095
2022.08_13-10-2022;Тульская область;105_165_days;AllVaccines;10999;7419;18418;804510;401385;1205895
2022.08_13-10-2022;Тульская область;105_165_days;CoviVac;377;186;563;804510;401385;1205895
2022.08_13-10-2022;Тульская область;105_165_days;EpiVacCorona;923;647;1570;804510;401385;1205895
2022.08_13-10-2022;Тульская область;105_165_days;SputnikLite;277;104;381;804510;401385;1205895
2022.08_13-10-2022;Тульская область;105_165_days;SputnikV;9422;6482;15904;804510;401385;1205895
2022.08_13-10-2022;Тульская область;165_195_days;AllVaccines;13039;5733;18772;804510;401385;1205895
2022.08_13-10-2022;Тульская область;165_195_days;CoviVac;191;29;220;804510;401385;1205895
2022.08_13-10-2022;Тульская область;165_195_days;EpiVacCorona;954;536;1490;804510;401385;1205895
2022.08_13-10-2022;Тульская область;165_195_days;SputnikLite;960;406;1366;804510;401385;1205895
2022.08_13-10-2022;Тульская область;165_195_days;SputnikV;10934;4762;15696;804510;401385;1205895
2022.08_13-10-2022;Тульская область;21_45_days;AllVaccines;9842;5026;14868;804510;401385;1205895
2022.08_13-10-2022;Тульская область;21_45_days;CoviVac;40;4;44;804510;401385;1205895
2022.08_13-10-2022;Тульская область;21_45_days;EpiVacCorona;51;15;66;804510;401385;1205895
2022.08_13-10-2022;Тульская область;21_45_days;SputnikLite;144;1;145;804510;401385;1205895
2022.08_13-10-2022;Тульская область;21_45_days;SputnikV;9607;5006;14613;804510;401385;1205895
2022.08_13-10-2022;Тульская область;45_75_days;AllVaccines;4552;2490;7042;804510;401385;1205895
2022.08_13-10-2022;Тульская область;45_75_days;CoviVac;26;9;35;804510;401385;1205895
2022.08_13-10-2022;Тульская область;45_75_days;EpiVacCorona;192;129;321;804510;401385;1205895
2022.08_13-10-2022;Тульская область;45_75_days;SputnikLite;9;0;9;804510;401385;1205895
2022.08_13-10-2022;Тульская область;45_75_days;SputnikV;4325;2352;6677;804510;401385;1205895
2022.08_13-10-2022;Тульская область;75_90_days;AllVaccines;2408;1701;4109;804510;401385;1205895
2022.08_13-10-2022;Тульская область;75_90_days;CoviVac;169;88;257;804510;401385;1205895
2022.08_13-10-2022;Тульская область;75_90_days;EpiVacCorona;147;140;287;804510;401385;1205895
2022.08_13-10-2022;Тульская область;75_90_days;SputnikLite;4;2;6;804510;401385;1205895
2022.08_13-10-2022;Тульская область;75_90_days;SputnikV;2088;1471;3559;804510;401385;1205895
2022.08_13-10-2022;Тульская область;90_105_days;AllVaccines;3113;2563;5676;804510;401385;1205895
2022.08_13-10-2022;Тульская область;90_105_days;CoviVac;201;64;265;804510;401385;1205895
2022.08_13-10-2022;Тульская область;90_105_days;EpiVacCorona;156;188;344;804510;401385;1205895
2022.08_13-10-2022;Тульская область;90_105_days;SputnikLite;4;0;4;804510;401385;1205895
2022.08_13-10-2022;Тульская область;90_105_days;SputnikV;2752;2311;5063;804510;401385;1205895
2022.08_13-10-2022;Тюменская область;105_165_days;AllVaccines;11219;6049;17268;870789;301209;1171998
2022.08_13-10-2022;Тюменская область;105_165_days;CoviVac;507;165;672;870789;301209;1171998
2022.08_13-10-2022;Тюменская область;105_165_days;EpiVacCorona;775;279;1054;870789;301209;1171998
2022.08_13-10-2022;Тюменская область;105_165_days;SputnikLite;1462;456;1918;870789;301209;1171998
2022.08_13-10-2022;Тюменская область;105_165_days;SputnikV;8475;5149;13624;870789;301209;1171998
2022.08_13-10-2022;Тюменская область;165_195_days;AllVaccines;10742;4368;15110;870789;301209;1171998
2022.08_13-10-2022;Тюменская область;165_195_days;CoviVac;148;47;195;870789;301209;1171998
2022.08_13-10-2022;Тюменская область;165_195_days;EpiVacCorona;384;152;536;870789;301209;1171998
2022.08_13-10-2022;Тюменская область;165_195_days;SputnikLite;3302;922;4224;870789;301209;1171998
2022.08_13-10-2022;Тюменская область;165_195_days;SputnikV;6908;3247;10155;870789;301209;1171998
2022.08_13-10-2022;Тюменская область;21_45_days;AllVaccines;4981;2904;7885;870789;301209;1171998
2022.08_13-10-2022;Тюменская область;21_45_days;CoviVac;5;0;5;870789;301209;1171998
2022.08_13-10-2022;Тюменская область;21_45_days;EpiVacCorona;9;2;11;870789;301209;1171998
2022.08_13-10-2022;Тюменская область;21_45_days;SputnikLite;151;28;179;870789;301209;1171998
2022.08_13-10-2022;Тюменская область;21_45_days;SputnikV;4816;2874;7690;870789;301209;1171998
2022.08_13-10-2022;Тюменская область;45_75_days;AllVaccines;3952;2146;6098;870789;301209;1171998
2022.08_13-10-2022;Тюменская область;45_75_days;CoviVac;9;0;9;870789;301209;1171998
2022.08_13-10-2022;Тюменская область;45_75_days;EpiVacCorona;309;80;389;870789;301209;1171998
2022.08_13-10-2022;Тюменская область;45_75_days;SputnikLite;160;47;207;870789;301209;1171998
2022.08_13-10-2022;Тюменская область;45_75_days;SputnikV;3474;2019;5493;870789;301209;1171998
2022.08_13-10-2022;Тюменская область;75_90_days;AllVaccines;2663;1596;4259;870789;301209;1171998
2022.08_13-10-2022;Тюменская область;75_90_days;CoviVac;8;5;13;870789;301209;1171998
2022.08_13-10-2022;Тюменская область;75_90_days;EpiVacCorona;112;61;173;870789;301209;1171998
2022.08_13-10-2022;Тюменская область;75_90_days;SputnikLite;88;38;126;870789;301209;1171998
2022.08_13-10-2022;Тюменская область;75_90_days;SputnikV;2455;1492;3947;870789;301209;1171998
2022.08_13-10-2022;Тюменская область;90_105_days;AllVaccines;2496;1636;4132;870789;301209;1171998
2022.08_13-10-2022;Тюменская область;90_105_days;CoviVac;45;16;61;870789;301209;1171998
2022.08_13-10-2022;Тюменская область;90_105_days;EpiVacCorona;75;48;123;870789;301209;1171998
2022.08_13-10-2022;Тюменская область;90_105_days;SputnikLite;77;25;102;870789;301209;1171998
2022.08_13-10-2022;Тюменская область;90_105_days;SputnikV;2299;1547;3846;870789;301209;1171998
2022.08_13-10-2022;Удмуртская Республика;105_165_days;AllVaccines;9885;7460;17345;818861;336450;1155311
2022.08_13-10-2022;Удмуртская Республика;105_165_days;CoviVac;1416;445;1861;818861;336450;1155311
2022.08_13-10-2022;Удмуртская Республика;105_165_days;EpiVacCorona;1158;1026;2184;818861;336450;1155311
2022.08_13-10-2022;Удмуртская Республика;105_165_days;SputnikLite;724;484;1208;818861;336450;1155311
2022.08_13-10-2022;Удмуртская Республика;105_165_days;SputnikV;6587;5505;12092;818861;336450;1155311
2022.08_13-10-2022;Удмуртская Республика;165_195_days;AllVaccines;9619;5365;14984;818861;336450;1155311
2022.08_13-10-2022;Удмуртская Республика;165_195_days;CoviVac;419;68;487;818861;336450;1155311
2022.08_13-10-2022;Удмуртская Республика;165_195_days;EpiVacCorona;742;492;1234;818861;336450;1155311
2022.08_13-10-2022;Удмуртская Республика;165_195_days;SputnikLite;1705;953;2658;818861;336450;1155311
2022.08_13-10-2022;Удмуртская Республика;165_195_days;SputnikV;6753;3852;10605;818861;336450;1155311
2022.08_13-10-2022;Удмуртская Республика;21_45_days;AllVaccines;4735;3235;7970;818861;336450;1155311
2022.08_13-10-2022;Удмуртская Республика;21_45_days;CoviVac;4;0;4;818861;336450;1155311
2022.08_13-10-2022;Удмуртская Республика;21_45_days;EpiVacCorona;84;55;139;818861;336450;1155311
2022.08_13-10-2022;Удмуртская Республика;21_45_days;SputnikLite;170;53;223;818861;336450;1155311
2022.08_13-10-2022;Удмуртская Республика;21_45_days;SputnikV;4477;3127;7604;818861;336450;1155311
2022.08_13-10-2022;Удмуртская Республика;45_75_days;AllVaccines;3571;2400;5971;818861;336450;1155311
2022.08_13-10-2022;Удмуртская Республика;45_75_days;CoviVac;22;6;28;818861;336450;1155311
2022.08_13-10-2022;Удмуртская Республика;45_75_days;EpiVacCorona;251;138;389;818861;336450;1155311
2022.08_13-10-2022;Удмуртская Республика;45_75_days;SputnikLite;170;65;235;818861;336450;1155311
2022.08_13-10-2022;Удмуртская Республика;45_75_days;SputnikV;3128;2191;5319;818861;336450;1155311
2022.08_13-10-2022;Удмуртская Республика;75_90_days;AllVaccines;2518;1998;4516;818861;336450;1155311
2022.08_13-10-2022;Удмуртская Республика;75_90_days;CoviVac;238;52;290;818861;336450;1155311
2022.08_13-10-2022;Удмуртская Республика;75_90_days;EpiVacCorona;135;121;256;818861;336450;1155311
2022.08_13-10-2022;Удмуртская Республика;75_90_days;SputnikLite;53;19;72;818861;336450;1155311
2022.08_13-10-2022;Удмуртская Республика;75_90_days;SputnikV;2092;1806;3898;818861;336450;1155311
2022.08_13-10-2022;Удмуртская Республика;90_105_days;AllVaccines;2179;2202;4381;818861;336450;1155311
2022.08_13-10-2022;Удмуртская Республика;90_105_days;CoviVac;127;30;157;818861;336450;1155311
2022.08_13-10-2022;Удмуртская Республика;90_105_days;EpiVacCorona;203;304;507;818861;336450;1155311
2022.08_13-10-2022;Удмуртская Республика;90_105_days;SputnikLite;65;52;117;818861;336450;1155311
2022.08_13-10-2022;Удмуртская Республика;90_105_days;SputnikV;1784;1816;3600;818861;336450;1155311
2022.08_13-10-2022;Ульяновская область;105_165_days;AllVaccines;7542;5951;13493;672149;320065;992214
2022.08_13-10-2022;Ульяновская область;105_165_days;CoviVac;351;227;578;672149;320065;992214
2022.08_13-10-2022;Ульяновская область;105_165_days;EpiVacCorona;627;484;1111;672149;320065;992214
2022.08_13-10-2022;Ульяновская область;105_165_days;SputnikLite;643;377;1020;672149;320065;992214
2022.08_13-10-2022;Ульяновская область;105_165_days;SputnikV;5921;4863;10784;672149;320065;992214
2022.08_13-10-2022;Ульяновская область;165_195_days;AllVaccines;5872;3083;8955;672149;320065;992214
2022.08_13-10-2022;Ульяновская область;165_195_days;CoviVac;99;38;137;672149;320065;992214
2022.08_13-10-2022;Ульяновская область;165_195_days;EpiVacCorona;402;195;597;672149;320065;992214
2022.08_13-10-2022;Ульяновская область;165_195_days;SputnikLite;971;478;1449;672149;320065;992214
2022.08_13-10-2022;Ульяновская область;165_195_days;SputnikV;4400;2372;6772;672149;320065;992214
2022.08_13-10-2022;Ульяновская область;21_45_days;AllVaccines;4152;2508;6660;672149;320065;992214
2022.08_13-10-2022;Ульяновская область;21_45_days;CoviVac;1;0;1;672149;320065;992214
2022.08_13-10-2022;Ульяновская область;21_45_days;EpiVacCorona;37;40;77;672149;320065;992214
2022.08_13-10-2022;Ульяновская область;21_45_days;SputnikLite;492;226;718;672149;320065;992214
2022.08_13-10-2022;Ульяновская область;21_45_days;SputnikV;3622;2242;5864;672149;320065;992214
2022.08_13-10-2022;Ульяновская область;45_75_days;AllVaccines;2697;1710;4407;672149;320065;992214
2022.08_13-10-2022;Ульяновская область;45_75_days;CoviVac;17;8;25;672149;320065;992214
2022.08_13-10-2022;Ульяновская область;45_75_days;EpiVacCorona;355;283;638;672149;320065;992214
2022.08_13-10-2022;Ульяновская область;45_75_days;SputnikLite;222;80;302;672149;320065;992214
2022.08_13-10-2022;Ульяновская область;45_75_days;SputnikV;2103;1339;3442;672149;320065;992214
2022.08_13-10-2022;Ульяновская область;75_90_days;AllVaccines;1867;1540;3407;672149;320065;992214
2022.08_13-10-2022;Ульяновская область;75_90_days;CoviVac;212;240;452;672149;320065;992214
2022.08_13-10-2022;Ульяновская область;75_90_days;EpiVacCorona;156;146;302;672149;320065;992214
2022.08_13-10-2022;Ульяновская область;75_90_days;SputnikLite;69;44;113;672149;320065;992214
2022.08_13-10-2022;Ульяновская область;75_90_days;SputnikV;1430;1110;2540;672149;320065;992214
2022.08_13-10-2022;Ульяновская область;90_105_days;AllVaccines;1592;1369;2961;672149;320065;992214
2022.08_13-10-2022;Ульяновская область;90_105_days;CoviVac;117;66;183;672149;320065;992214
2022.08_13-10-2022;Ульяновская область;90_105_days;EpiVacCorona;121;92;213;672149;320065;992214
2022.08_13-10-2022;Ульяновская область;90_105_days;SputnikLite;113;51;164;672149;320065;992214
2022.08_13-10-2022;Ульяновская область;90_105_days;SputnikV;1241;1160;2401;672149;320065;992214
2022.08_13-10-2022;Хабаровский край;105_165_days;AllVaccines;8994;5774;14768;757169;265178;1022347
2022.08_13-10-2022;Хабаровский край;105_165_days;CoviVac;507;240;747;757169;265178;1022347
2022.08_13-10-2022;Хабаровский край;105_165_days;EpiVacCorona;1444;1087;2531;757169;265178;1022347
2022.08_13-10-2022;Хабаровский край;105_165_days;SputnikLite;1555;647;2202;757169;265178;1022347
2022.08_13-10-2022;Хабаровский край;105_165_days;SputnikV;5488;3800;9288;757169;265178;1022347
2022.08_13-10-2022;Хабаровский край;165_195_days;AllVaccines;6477;3138;9615;757169;265178;1022347
2022.08_13-10-2022;Хабаровский край;165_195_days;CoviVac;193;80;273;757169;265178;1022347
2022.08_13-10-2022;Хабаровский край;165_195_days;EpiVacCorona;471;252;723;757169;265178;1022347
2022.08_13-10-2022;Хабаровский край;165_195_days;SputnikLite;1395;557;1952;757169;265178;1022347
2022.08_13-10-2022;Хабаровский край;165_195_days;SputnikV;4418;2249;6667;757169;265178;1022347
2022.08_13-10-2022;Хабаровский край;21_45_days;AllVaccines;5216;2905;8121;757169;265178;1022347
2022.08_13-10-2022;Хабаровский край;21_45_days;CoviVac;10;2;12;757169;265178;1022347
2022.08_13-10-2022;Хабаровский край;21_45_days;EpiVacCorona;59;57;116;757169;265178;1022347
2022.08_13-10-2022;Хабаровский край;21_45_days;SputnikLite;154;29;183;757169;265178;1022347
2022.08_13-10-2022;Хабаровский край;21_45_days;SputnikV;4993;2817;7810;757169;265178;1022347
2022.08_13-10-2022;Хабаровский край;45_75_days;AllVaccines;4924;2622;7546;757169;265178;1022347
2022.08_13-10-2022;Хабаровский край;45_75_days;CoviVac;21;8;29;757169;265178;1022347
2022.08_13-10-2022;Хабаровский край;45_75_days;EpiVacCorona;862;546;1408;757169;265178;1022347
2022.08_13-10-2022;Хабаровский край;45_75_days;SputnikLite;194;66;260;757169;265178;1022347
2022.08_13-10-2022;Хабаровский край;45_75_days;SputnikV;3847;2002;5849;757169;265178;1022347
2022.08_13-10-2022;Хабаровский край;75_90_days;AllVaccines;3440;1955;5395;757169;265178;1022347
2022.08_13-10-2022;Хабаровский край;75_90_days;CoviVac;69;16;85;757169;265178;1022347
2022.08_13-10-2022;Хабаровский край;75_90_days;EpiVacCorona;702;435;1137;757169;265178;1022347
2022.08_13-10-2022;Хабаровский край;75_90_days;SputnikLite;109;53;162;757169;265178;1022347
2022.08_13-10-2022;Хабаровский край;75_90_days;SputnikV;2560;1451;4011;757169;265178;1022347
2022.08_13-10-2022;Хабаровский край;90_105_days;AllVaccines;2831;2166;4997;757169;265178;1022347
2022.08_13-10-2022;Хабаровский край;90_105_days;CoviVac;84;22;106;757169;265178;1022347
2022.08_13-10-2022;Хабаровский край;90_105_days;EpiVacCorona;751;670;1421;757169;265178;1022347
2022.08_13-10-2022;Хабаровский край;90_105_days;SputnikLite;160;94;254;757169;265178;1022347
2022.08_13-10-2022;Хабаровский край;90_105_days;SputnikV;1836;1380;3216;757169;265178;1022347
2022.08_13-10-2022;Ханты-Мансийский автономный округ - Югра;105_165_days;AllVaccines;17824;3808;21632;1019471;240107;1259578
2022.08_13-10-2022;Ханты-Мансийский автономный округ - Югра;105_165_days;CoviVac;489;64;553;1019471;240107;1259578
2022.08_13-10-2022;Ханты-Мансийский автономный округ - Югра;105_165_days;EpiVacCorona;1159;283;1442;1019471;240107;1259578
2022.08_13-10-2022;Ханты-Мансийский автономный округ - Югра;105_165_days;SputnikLite;1849;398;2247;1019471;240107;1259578
2022.08_13-10-2022;Ханты-Мансийский автономный округ - Югра;105_165_days;SputnikV;14327;3063;17390;1019471;240107;1259578
2022.08_13-10-2022;Ханты-Мансийский автономный округ - Югра;165_195_days;AllVaccines;15577;2917;18494;1019471;240107;1259578
2022.08_13-10-2022;Ханты-Мансийский автономный округ - Югра;165_195_days;CoviVac;264;35;299;1019471;240107;1259578
2022.08_13-10-2022;Ханты-Мансийский автономный округ - Югра;165_195_days;EpiVacCorona;310;63;373;1019471;240107;1259578
2022.08_13-10-2022;Ханты-Мансийский автономный округ - Югра;165_195_days;SputnikLite;4556;948;5504;1019471;240107;1259578
2022.08_13-10-2022;Ханты-Мансийский автономный округ - Югра;165_195_days;SputnikV;10447;1871;12318;1019471;240107;1259578
2022.08_13-10-2022;Ханты-Мансийский автономный округ - Югра;21_45_days;AllVaccines;5351;1301;6652;1019471;240107;1259578
2022.08_13-10-2022;Ханты-Мансийский автономный округ - Югра;21_45_days;CoviVac;109;22;131;1019471;240107;1259578
2022.08_13-10-2022;Ханты-Мансийский автономный округ - Югра;21_45_days;EpiVacCorona;20;0;20;1019471;240107;1259578
2022.08_13-10-2022;Ханты-Мансийский автономный округ - Югра;21_45_days;SputnikLite;14;0;14;1019471;240107;1259578
2022.08_13-10-2022;Ханты-Мансийский автономный округ - Югра;21_45_days;SputnikV;5208;1279;6487;1019471;240107;1259578
2022.08_13-10-2022;Ханты-Мансийский автономный округ - Югра;45_75_days;AllVaccines;5260;978;6238;1019471;240107;1259578
2022.08_13-10-2022;Ханты-Мансийский автономный округ - Югра;45_75_days;CoviVac;22;0;22;1019471;240107;1259578
2022.08_13-10-2022;Ханты-Мансийский автономный округ - Югра;45_75_days;EpiVacCorona;144;21;165;1019471;240107;1259578
2022.08_13-10-2022;Ханты-Мансийский автономный округ - Югра;45_75_days;SputnikLite;25;0;25;1019471;240107;1259578
2022.08_13-10-2022;Ханты-Мансийский автономный округ - Югра;45_75_days;SputnikV;5069;957;6026;1019471;240107;1259578
2022.08_13-10-2022;Ханты-Мансийский автономный округ - Югра;75_90_days;AllVaccines;4262;842;5104;1019471;240107;1259578
2022.08_13-10-2022;Ханты-Мансийский автономный округ - Югра;75_90_days;CoviVac;37;6;43;1019471;240107;1259578
2022.08_13-10-2022;Ханты-Мансийский автономный округ - Югра;75_90_days;EpiVacCorona;274;59;333;1019471;240107;1259578
2022.08_13-10-2022;Ханты-Мансийский автономный округ - Югра;75_90_days;SputnikLite;18;3;21;1019471;240107;1259578
2022.08_13-10-2022;Ханты-Мансийский автономный округ - Югра;75_90_days;SputnikV;3933;774;4707;1019471;240107;1259578
2022.08_13-10-2022;Ханты-Мансийский автономный округ - Югра;90_105_days;AllVaccines;4379;974;5353;1019471;240107;1259578
2022.08_13-10-2022;Ханты-Мансийский автономный округ - Югра;90_105_days;CoviVac;74;8;82;1019471;240107;1259578
2022.08_13-10-2022;Ханты-Мансийский автономный округ - Югра;90_105_days;EpiVacCorona;343;64;407;1019471;240107;1259578
2022.08_13-10-2022;Ханты-Мансийский автономный округ - Югра;90_105_days;SputnikLite;51;2;53;1019471;240107;1259578
2022.08_13-10-2022;Ханты-Мансийский автономный округ - Югра;90_105_days;SputnikV;3911;900;4811;1019471;240107;1259578
2022.08_13-10-2022;Челябинская область;105_165_days;AllVaccines;34018;24598;58616;1901705;795956;2697661
2022.08_13-10-2022;Челябинская область;105_165_days;CoviVac;1789;725;2514;1901705;795956;2697661
2022.08_13-10-2022;Челябинская область;105_165_days;EpiVacCorona;2770;1850;4620;1901705;795956;2697661
2022.08_13-10-2022;Челябинская область;105_165_days;SputnikLite;11938;6759;18697;1901705;795956;2697661
2022.08_13-10-2022;Челябинская область;105_165_days;SputnikV;17521;15264;32785;1901705;795956;2697661
2022.08_13-10-2022;Челябинская область;165_195_days;AllVaccines;25022;13470;38492;1901705;795956;2697661
2022.08_13-10-2022;Челябинская область;165_195_days;CoviVac;285;56;341;1901705;795956;2697661
2022.08_13-10-2022;Челябинская область;165_195_days;EpiVacCorona;1207;1427;2634;1901705;795956;2697661
2022.08_13-10-2022;Челябинская область;165_195_days;SputnikLite;10742;5597;16339;1901705;795956;2697661
2022.08_13-10-2022;Челябинская область;165_195_days;SputnikV;12788;6390;19178;1901705;795956;2697661
2022.08_13-10-2022;Челябинская область;21_45_days;AllVaccines;11946;8782;20728;1901705;795956;2697661
2022.08_13-10-2022;Челябинская область;21_45_days;CoviVac;33;3;36;1901705;795956;2697661
2022.08_13-10-2022;Челябинская область;21_45_days;EpiVacCorona;228;191;419;1901705;795956;2697661
2022.08_13-10-2022;Челябинская область;21_45_days;SputnikLite;672;257;929;1901705;795956;2697661
2022.08_13-10-2022;Челябинская область;21_45_days;SputnikV;11013;8331;19344;1901705;795956;2697661
2022.08_13-10-2022;Челябинская область;45_75_days;AllVaccines;8634;6007;14641;1901705;795956;2697661
2022.08_13-10-2022;Челябинская область;45_75_days;CoviVac;156;79;235;1901705;795956;2697661
2022.08_13-10-2022;Челябинская область;45_75_days;EpiVacCorona;1031;408;1439;1901705;795956;2697661
2022.08_13-10-2022;Челябинская область;45_75_days;SputnikLite;974;536;1510;1901705;795956;2697661
2022.08_13-10-2022;Челябинская область;45_75_days;SputnikV;6473;4984;11457;1901705;795956;2697661
2022.08_13-10-2022;Челябинская область;75_90_days;AllVaccines;7233;5038;12271;1901705;795956;2697661
2022.08_13-10-2022;Челябинская область;75_90_days;CoviVac;606;82;688;1901705;795956;2697661
2022.08_13-10-2022;Челябинская область;75_90_days;EpiVacCorona;657;364;1021;1901705;795956;2697661
2022.08_13-10-2022;Челябинская область;75_90_days;SputnikLite;762;326;1088;1901705;795956;2697661
2022.08_13-10-2022;Челябинская область;75_90_days;SputnikV;5208;4266;9474;1901705;795956;2697661
2022.08_13-10-2022;Челябинская область;90_105_days;AllVaccines;7383;6088;13471;1901705;795956;2697661
2022.08_13-10-2022;Челябинская область;90_105_days;CoviVac;249;77;326;1901705;795956;2697661
2022.08_13-10-2022;Челябинская область;90_105_days;EpiVacCorona;622;485;1107;1901705;795956;2697661
2022.08_13-10-2022;Челябинская область;90_105_days;SputnikLite;1020;384;1404;1901705;795956;2697661
2022.08_13-10-2022;Челябинская область;90_105_days;SputnikV;5492;5142;10634;1901705;795956;2697661
2022.08_13-10-2022;Чеченская Республика;105_165_days;AllVaccines;20796;3684;24480;809759;137234;946993
2022.08_13-10-2022;Чеченская Республика;105_165_days;CoviVac;878;172;1050;809759;137234;946993
2022.08_13-10-2022;Чеченская Республика;105_165_days;EpiVacCorona;39;0;39;809759;137234;946993
2022.08_13-10-2022;Чеченская Республика;105_165_days;SputnikLite;8560;1234;9794;809759;137234;946993
2022.08_13-10-2022;Чеченская Республика;105_165_days;SputnikV;11319;2278;13597;809759;137234;946993
2022.08_13-10-2022;Чеченская Республика;165_195_days;AllVaccines;13917;2825;16742;809759;137234;946993
2022.08_13-10-2022;Чеченская Республика;165_195_days;CoviVac;3349;643;3992;809759;137234;946993
2022.08_13-10-2022;Чеченская Республика;165_195_days;EpiVacCorona;153;10;163;809759;137234;946993
2022.08_13-10-2022;Чеченская Республика;165_195_days;SputnikLite;2842;736;3578;809759;137234;946993
2022.08_13-10-2022;Чеченская Республика;165_195_days;SputnikV;7573;1436;9009;809759;137234;946993
2022.08_13-10-2022;Чеченская Республика;21_45_days;AllVaccines;8657;1271;9928;809759;137234;946993
2022.08_13-10-2022;Чеченская Республика;21_45_days;CoviVac;5;0;5;809759;137234;946993
2022.08_13-10-2022;Чеченская Республика;21_45_days;SputnikLite;483;20;503;809759;137234;946993
2022.08_13-10-2022;Чеченская Республика;21_45_days;SputnikV;8169;1251;9420;809759;137234;946993
2022.08_13-10-2022;Чеченская Республика;45_75_days;AllVaccines;14571;2788;17359;809759;137234;946993
2022.08_13-10-2022;Чеченская Республика;45_75_days;CoviVac;2;0;2;809759;137234;946993
2022.08_13-10-2022;Чеченская Республика;45_75_days;EpiVacCorona;1;1;2;809759;137234;946993
2022.08_13-10-2022;Чеченская Республика;45_75_days;SputnikLite;402;5;407;809759;137234;946993
2022.08_13-10-2022;Чеченская Республика;45_75_days;SputnikV;14166;2782;16948;809759;137234;946993
2022.08_13-10-2022;Чеченская Республика;75_90_days;AllVaccines;14777;3225;18002;809759;137234;946993
2022.08_13-10-2022;Чеченская Республика;75_90_days;CoviVac;126;24;150;809759;137234;946993
2022.08_13-10-2022;Чеченская Республика;75_90_days;EpiVacCorona;2;0;2;809759;137234;946993
2022.08_13-10-2022;Чеченская Республика;75_90_days;SputnikLite;113;9;122;809759;137234;946993
2022.08_13-10-2022;Чеченская Республика;75_90_days;SputnikV;14536;3192;17728;809759;137234;946993
2022.08_13-10-2022;Чеченская Республика;90_105_days;AllVaccines;9246;1884;11130;809759;137234;946993
2022.08_13-10-2022;Чеченская Республика;90_105_days;CoviVac;7;1;8;809759;137234;946993
2022.08_13-10-2022;Чеченская Республика;90_105_days;EpiVacCorona;1;0;1;809759;137234;946993
2022.08_13-10-2022;Чеченская Республика;90_105_days;SputnikLite;253;28;281;809759;137234;946993
2022.08_13-10-2022;Чеченская Республика;90_105_days;SputnikV;8985;1855;10840;809759;137234;946993
2022.08_13-10-2022;Чувашская Республика;105_165_days;AllVaccines;12569;9343;21912;674689;275580;950269
2022.08_13-10-2022;Чувашская Республика;105_165_days;CoviVac;1122;365;1487;674689;275580;950269
2022.08_13-10-2022;Чувашская Республика;105_165_days;EpiVacCorona;1507;946;2453;674689;275580;950269
2022.08_13-10-2022;Чувашская Республика;105_165_days;SputnikLite;2948;2377;5325;674689;275580;950269
2022.08_13-10-2022;Чувашская Республика;105_165_days;SputnikV;6992;5655;12647;674689;275580;950269
2022.08_13-10-2022;Чувашская Республика;165_195_days;AllVaccines;8720;4940;13660;674689;275580;950269
2022.08_13-10-2022;Чувашская Республика;165_195_days;CoviVac;143;15;158;674689;275580;950269
2022.08_13-10-2022;Чувашская Республика;165_195_days;EpiVacCorona;666;481;1147;674689;275580;950269
2022.08_13-10-2022;Чувашская Республика;165_195_days;SputnikLite;2028;957;2985;674689;275580;950269
2022.08_13-10-2022;Чувашская Республика;165_195_days;SputnikV;5883;3487;9370;674689;275580;950269
2022.08_13-10-2022;Чувашская Республика;21_45_days;AllVaccines;4461;1996;6457;674689;275580;950269
2022.08_13-10-2022;Чувашская Республика;21_45_days;EpiVacCorona;44;16;60;674689;275580;950269
2022.08_13-10-2022;Чувашская Республика;21_45_days;SputnikLite;93;29;122;674689;275580;950269
2022.08_13-10-2022;Чувашская Республика;21_45_days;SputnikV;4324;1951;6275;674689;275580;950269
2022.08_13-10-2022;Чувашская Республика;45_75_days;AllVaccines;3668;1892;5560;674689;275580;950269
2022.08_13-10-2022;Чувашская Республика;45_75_days;EpiVacCorona;848;268;1116;674689;275580;950269
2022.08_13-10-2022;Чувашская Республика;45_75_days;SputnikLite;62;37;99;674689;275580;950269
2022.08_13-10-2022;Чувашская Республика;45_75_days;SputnikV;2758;1587;4345;674689;275580;950269
2022.08_13-10-2022;Чувашская Республика;75_90_days;AllVaccines;4195;2698;6893;674689;275580;950269
2022.08_13-10-2022;Чувашская Республика;75_90_days;CoviVac;1;0;1;674689;275580;950269
2022.08_13-10-2022;Чувашская Республика;75_90_days;EpiVacCorona;1932;1435;3367;674689;275580;950269
2022.08_13-10-2022;Чувашская Республика;75_90_days;SputnikLite;16;6;22;674689;275580;950269
2022.08_13-10-2022;Чувашская Республика;75_90_days;SputnikV;2246;1257;3503;674689;275580;950269
2022.08_13-10-2022;Чувашская Республика;90_105_days;AllVaccines;3606;2752;6358;674689;275580;950269
2022.08_13-10-2022;Чувашская Республика;90_105_days;CoviVac;6;2;8;674689;275580;950269
2022.08_13-10-2022;Чувашская Республика;90_105_days;EpiVacCorona;1668;1196;2864;674689;275580;950269
2022.08_13-10-2022;Чувашская Республика;90_105_days;SputnikLite;96;19;115;674689;275580;950269
2022.08_13-10-2022;Чувашская Республика;90_105_days;SputnikV;1836;1535;3371;674689;275580;950269
2022.08_13-10-2022;Чукотский автономный округ;105_165_days;AllVaccines;940;186;1126;30806;6299;37105
2022.08_13-10-2022;Чукотский автономный округ;105_165_days;CoviVac;48;8;56;30806;6299;37105
2022.08_13-10-2022;Чукотский автономный округ;105_165_days;EpiVacCorona;106;19;125;30806;6299;37105
2022.08_13-10-2022;Чукотский автономный округ;105_165_days;SputnikLite;537;115;652;30806;6299;37105
2022.08_13-10-2022;Чукотский автономный округ;105_165_days;SputnikV;249;44;293;30806;6299;37105
2022.08_13-10-2022;Чукотский автономный округ;165_195_days;AllVaccines;771;134;905;30806;6299;37105
2022.08_13-10-2022;Чукотский автономный округ;165_195_days;CoviVac;18;1;19;30806;6299;37105
2022.08_13-10-2022;Чукотский автономный округ;165_195_days;EpiVacCorona;24;1;25;30806;6299;37105
2022.08_13-10-2022;Чукотский автономный округ;165_195_days;SputnikLite;499;89;588;30806;6299;37105
2022.08_13-10-2022;Чукотский автономный округ;165_195_days;SputnikV;230;43;273;30806;6299;37105
2022.08_13-10-2022;Чукотский автономный округ;21_45_days;AllVaccines;27;5;32;30806;6299;37105
2022.08_13-10-2022;Чукотский автономный округ;21_45_days;SputnikLite;7;1;8;30806;6299;37105
2022.08_13-10-2022;Чукотский автономный округ;21_45_days;SputnikV;20;4;24;30806;6299;37105
2022.08_13-10-2022;Чукотский автономный округ;45_75_days;AllVaccines;102;29;131;30806;6299;37105
2022.08_13-10-2022;Чукотский автономный округ;45_75_days;EpiVacCorona;2;1;3;30806;6299;37105
2022.08_13-10-2022;Чукотский автономный округ;45_75_days;SputnikLite;18;9;27;30806;6299;37105
2022.08_13-10-2022;Чукотский автономный округ;45_75_days;SputnikV;82;19;101;30806;6299;37105
2022.08_13-10-2022;Чукотский автономный округ;75_90_days;AllVaccines;73;15;88;30806;6299;37105
2022.08_13-10-2022;Чукотский автономный округ;75_90_days;CoviVac;2;1;3;30806;6299;37105
2022.08_13-10-2022;Чукотский автономный округ;75_90_days;EpiVacCorona;7;1;8;30806;6299;37105
2022.08_13-10-2022;Чукотский автономный округ;75_90_days;SputnikLite;25;10;35;30806;6299;37105
2022.08_13-10-2022;Чукотский автономный округ;75_90_days;SputnikV;39;3;42;30806;6299;37105
2022.08_13-10-2022;Чукотский автономный округ;90_105_days;AllVaccines;165;37;202;30806;6299;37105
2022.08_13-10-2022;Чукотский автономный округ;90_105_days;CoviVac;4;6;10;30806;6299;37105
2022.08_13-10-2022;Чукотский автономный округ;90_105_days;EpiVacCorona;47;5;52;30806;6299;37105
2022.08_13-10-2022;Чукотский автономный округ;90_105_days;SputnikLite;35;5;40;30806;6299;37105
2022.08_13-10-2022;Чукотский автономный округ;90_105_days;SputnikV;79;21;100;30806;6299;37105
2022.08_13-10-2022;Ямало-Ненецкий автономный округ;105_165_days;AllVaccines;9326;1357;10683;346064;56429;402493
2022.08_13-10-2022;Ямало-Ненецкий автономный округ;105_165_days;CoviVac;234;26;260;346064;56429;402493
2022.08_13-10-2022;Ямало-Ненецкий автономный округ;105_165_days;EpiVacCorona;171;31;202;346064;56429;402493
2022.08_13-10-2022;Ямало-Ненецкий автономный округ;105_165_days;SputnikLite;6770;1001;7771;346064;56429;402493
2022.08_13-10-2022;Ямало-Ненецкий автономный округ;105_165_days;SputnikV;2151;299;2450;346064;56429;402493
2022.08_13-10-2022;Ямало-Ненецкий автономный округ;165_195_days;AllVaccines;5989;711;6700;346064;56429;402493
2022.08_13-10-2022;Ямало-Ненецкий автономный округ;165_195_days;CoviVac;49;7;56;346064;56429;402493
2022.08_13-10-2022;Ямало-Ненецкий автономный округ;165_195_days;EpiVacCorona;128;23;151;346064;56429;402493
2022.08_13-10-2022;Ямало-Ненецкий автономный округ;165_195_days;SputnikLite;3678;451;4129;346064;56429;402493
2022.08_13-10-2022;Ямало-Ненецкий автономный округ;165_195_days;SputnikV;2134;230;2364;346064;56429;402493
2022.08_13-10-2022;Ямало-Ненецкий автономный округ;21_45_days;AllVaccines;3927;453;4380;346064;56429;402493
2022.08_13-10-2022;Ямало-Ненецкий автономный округ;21_45_days;EpiVacCorona;2;0;2;346064;56429;402493
2022.08_13-10-2022;Ямало-Ненецкий автономный округ;21_45_days;SputnikLite;1926;210;2136;346064;56429;402493
2022.08_13-10-2022;Ямало-Ненецкий автономный округ;21_45_days;SputnikV;1999;243;2242;346064;56429;402493
2022.08_13-10-2022;Ямало-Ненецкий автономный округ;45_75_days;AllVaccines;3879;386;4265;346064;56429;402493
2022.08_13-10-2022;Ямало-Ненецкий автономный округ;45_75_days;EpiVacCorona;57;22;79;346064;56429;402493
2022.08_13-10-2022;Ямало-Ненецкий автономный округ;45_75_days;SputnikLite;1971;202;2173;346064;56429;402493
2022.08_13-10-2022;Ямало-Ненецкий автономный округ;45_75_days;SputnikV;1851;162;2013;346064;56429;402493
2022.08_13-10-2022;Ямало-Ненецкий автономный округ;75_90_days;AllVaccines;1972;176;2148;346064;56429;402493
2022.08_13-10-2022;Ямало-Ненецкий автономный округ;75_90_days;CoviVac;3;0;3;346064;56429;402493
2022.08_13-10-2022;Ямало-Ненецкий автономный округ;75_90_days;EpiVacCorona;57;6;63;346064;56429;402493
2022.08_13-10-2022;Ямало-Ненецкий автономный округ;75_90_days;SputnikLite;863;76;939;346064;56429;402493
2022.08_13-10-2022;Ямало-Ненецкий автономный округ;75_90_days;SputnikV;1049;94;1143;346064;56429;402493
2022.08_13-10-2022;Ямало-Ненецкий автономный округ;90_105_days;AllVaccines;2427;311;2738;346064;56429;402493
2022.08_13-10-2022;Ямало-Ненецкий автономный округ;90_105_days;CoviVac;17;0;17;346064;56429;402493
2022.08_13-10-2022;Ямало-Ненецкий автономный округ;90_105_days;EpiVacCorona;92;16;108;346064;56429;402493
2022.08_13-10-2022;Ямало-Ненецкий автономный округ;90_105_days;SputnikLite;1262;187;1449;346064;56429;402493
2022.08_13-10-2022;Ямало-Ненецкий автономный округ;90_105_days;SputnikV;1056;108;1164;346064;56429;402493
2022.08_13-10-2022;Ярославская область;105_165_days;AllVaccines;5935;4535;10470;682586;317712;1000298
2022.08_13-10-2022;Ярославская область;105_165_days;CoviVac;426;214;640;682586;317712;1000298
2022.08_13-10-2022;Ярославская область;105_165_days;EpiVacCorona;232;166;398;682586;317712;1000298
2022.08_13-10-2022;Ярославская область;105_165_days;SputnikLite;1204;575;1779;682586;317712;1000298
2022.08_13-10-2022;Ярославская область;105_165_days;SputnikV;4073;3580;7653;682586;317712;1000298
2022.08_13-10-2022;Ярославская область;165_195_days;AllVaccines;6422;3303;9725;682586;317712;1000298
2022.08_13-10-2022;Ярославская область;165_195_days;CoviVac;262;67;329;682586;317712;1000298
2022.08_13-10-2022;Ярославская область;165_195_days;EpiVacCorona;293;112;405;682586;317712;1000298
2022.08_13-10-2022;Ярославская область;165_195_days;SputnikLite;1662;835;2497;682586;317712;1000298
2022.08_13-10-2022;Ярославская область;165_195_days;SputnikV;4205;2289;6494;682586;317712;1000298
2022.08_13-10-2022;Ярославская область;21_45_days;AllVaccines;4083;2192;6275;682586;317712;1000298
2022.08_13-10-2022;Ярославская область;21_45_days;EpiVacCorona;1;1;2;682586;317712;1000298
2022.08_13-10-2022;Ярославская область;21_45_days;SputnikLite;104;32;136;682586;317712;1000298
2022.08_13-10-2022;Ярославская область;21_45_days;SputnikV;3978;2159;6137;682586;317712;1000298
2022.08_13-10-2022;Ярославская область;45_75_days;AllVaccines;2533;1248;3781;682586;317712;1000298
2022.08_13-10-2022;Ярославская область;45_75_days;CoviVac;2;2;4;682586;317712;1000298
2022.08_13-10-2022;Ярославская область;45_75_days;EpiVacCorona;24;7;31;682586;317712;1000298
2022.08_13-10-2022;Ярославская область;45_75_days;SputnikLite;98;19;117;682586;317712;1000298
2022.08_13-10-2022;Ярославская область;45_75_days;SputnikV;2409;1220;3629;682586;317712;1000298
2022.08_13-10-2022;Ярославская область;75_90_days;AllVaccines;1534;948;2482;682586;317712;1000298
2022.08_13-10-2022;Ярославская область;75_90_days;CoviVac;86;41;127;682586;317712;1000298
2022.08_13-10-2022;Ярославская область;75_90_days;EpiVacCorona;53;20;73;682586;317712;1000298
2022.08_13-10-2022;Ярославская область;75_90_days;SputnikLite;7;13;20;682586;317712;1000298
2022.08_13-10-2022;Ярославская область;75_90_days;SputnikV;1388;874;2262;682586;317712;1000298
2022.08_13-10-2022;Ярославская область;90_105_days;AllVaccines;1417;1205;2622;682586;317712;1000298
2022.08_13-10-2022;Ярославская область;90_105_days;CoviVac;75;46;121;682586;317712;1000298
2022.08_13-10-2022;Ярославская область;90_105_days;EpiVacCorona;35;22;57;682586;317712;1000298
2022.08_13-10-2022;Ярославская область;90_105_days;SputnikLite;24;20;44;682586;317712;1000298
2022.08_13-10-2022;Ярославская область;90_105_days;SputnikV;1283;1117;2400;682586;317712;1000298
2022.08_13-10-2022;г. Москва;105_165_days;AllVaccines;37149;23962;61111;7299088;3167729;10466817
2022.08_13-10-2022;г. Москва;105_165_days;CoviVac;1663;165;1828;7299088;3167729;10466817
2022.08_13-10-2022;г. Москва;105_165_days;EpiVacCorona;46;28;74;7299088;3167729;10466817
2022.08_13-10-2022;г. Москва;105_165_days;SputnikLite;7034;2094;9128;7299088;3167729;10466817
2022.08_13-10-2022;г. Москва;105_165_days;SputnikV;28406;21675;50081;7299088;3167729;10466817
2022.08_13-10-2022;г. Москва;165_195_days;AllVaccines;50058;24258;74316;7299088;3167729;10466817
2022.08_13-10-2022;г. Москва;165_195_days;CoviVac;1198;122;1320;7299088;3167729;10466817
2022.08_13-10-2022;г. Москва;165_195_days;EpiVacCorona;29;23;52;7299088;3167729;10466817
2022.08_13-10-2022;г. Москва;165_195_days;SputnikLite;10953;4185;15138;7299088;3167729;10466817
2022.08_13-10-2022;г. Москва;165_195_days;SputnikV;37878;19928;57806;7299088;3167729;10466817
2022.08_13-10-2022;г. Москва;21_45_days;AllVaccines;36139;14326;50465;7299088;3167729;10466817
2022.08_13-10-2022;г. Москва;21_45_days;CoviVac;68;23;91;7299088;3167729;10466817
2022.08_13-10-2022;г. Москва;21_45_days;EpiVacCorona;108;35;143;7299088;3167729;10466817
2022.08_13-10-2022;г. Москва;21_45_days;SputnikLite;2302;412;2714;7299088;3167729;10466817
2022.08_13-10-2022;г. Москва;21_45_days;SputnikV;33661;13856;47517;7299088;3167729;10466817
2022.08_13-10-2022;г. Москва;45_75_days;AllVaccines;18056;5852;23908;7299088;3167729;10466817
2022.08_13-10-2022;г. Москва;45_75_days;CoviVac;33;5;38;7299088;3167729;10466817
2022.08_13-10-2022;г. Москва;45_75_days;EpiVacCorona;37;13;50;7299088;3167729;10466817
2022.08_13-10-2022;г. Москва;45_75_days;SputnikLite;2319;345;2664;7299088;3167729;10466817
2022.08_13-10-2022;г. Москва;45_75_days;SputnikV;15667;5489;21156;7299088;3167729;10466817
2022.08_13-10-2022;г. Москва;75_90_days;AllVaccines;8643;4051;12694;7299088;3167729;10466817
2022.08_13-10-2022;г. Москва;75_90_days;CoviVac;193;13;206;7299088;3167729;10466817
2022.08_13-10-2022;г. Москва;75_90_days;EpiVacCorona;17;7;24;7299088;3167729;10466817
2022.08_13-10-2022;г. Москва;75_90_days;SputnikLite;856;143;999;7299088;3167729;10466817
2022.08_13-10-2022;г. Москва;75_90_days;SputnikV;7577;3888;11465;7299088;3167729;10466817
2022.08_13-10-2022;г. Москва;90_105_days;AllVaccines;8578;5200;13778;7299088;3167729;10466817
2022.08_13-10-2022;г. Москва;90_105_days;CoviVac;172;14;186;7299088;3167729;10466817
2022.08_13-10-2022;г. Москва;90_105_days;EpiVacCorona;7;2;9;7299088;3167729;10466817
2022.08_13-10-2022;г. Москва;90_105_days;SputnikLite;770;206;976;7299088;3167729;10466817
2022.08_13-10-2022;г. Москва;90_105_days;SputnikV;7629;4978;12607;7299088;3167729;10466817
2022.08_13-10-2022;г. Санкт-Петербург;105_165_days;AllVaccines;30681;16646;47327;3114778;1306302;4421080
2022.08_13-10-2022;г. Санкт-Петербург;105_165_days;CoviVac;1585;130;1715;3114778;1306302;4421080
2022.08_13-10-2022;г. Санкт-Петербург;105_165_days;EpiVacCorona;671;282;953;3114778;1306302;4421080
2022.08_13-10-2022;г. Санкт-Петербург;105_165_days;SputnikLite;8026;2570;10596;3114778;1306302;4421080
2022.08_13-10-2022;г. Санкт-Петербург;105_165_days;SputnikV;20399;13664;34063;3114778;1306302;4421080
2022.08_13-10-2022;г. Санкт-Петербург;165_195_days;AllVaccines;31195;14570;45765;3114778;1306302;4421080
2022.08_13-10-2022;г. Санкт-Петербург;165_195_days;CoviVac;585;36;621;3114778;1306302;4421080
2022.08_13-10-2022;г. Санкт-Петербург;165_195_days;EpiVacCorona;356;268;624;3114778;1306302;4421080
2022.08_13-10-2022;г. Санкт-Петербург;165_195_days;SputnikLite;9955;5849;15804;3114778;1306302;4421080
2022.08_13-10-2022;г. Санкт-Петербург;165_195_days;SputnikV;20299;8417;28716;3114778;1306302;4421080
2022.08_13-10-2022;г. Санкт-Петербург;21_45_days;AllVaccines;23645;9451;33096;3114778;1306302;4421080
2022.08_13-10-2022;г. Санкт-Петербург;21_45_days;EpiVacCorona;0;1;1;3114778;1306302;4421080
2022.08_13-10-2022;г. Санкт-Петербург;21_45_days;SputnikLite;6071;1054;7125;3114778;1306302;4421080
2022.08_13-10-2022;г. Санкт-Петербург;21_45_days;SputnikV;17574;8396;25970;3114778;1306302;4421080
2022.08_13-10-2022;г. Санкт-Петербург;45_75_days;AllVaccines;13471;4089;17560;3114778;1306302;4421080
2022.08_13-10-2022;г. Санкт-Петербург;45_75_days;CoviVac;11;4;15;3114778;1306302;4421080
2022.08_13-10-2022;г. Санкт-Петербург;45_75_days;EpiVacCorona;1;2;3;3114778;1306302;4421080
2022.08_13-10-2022;г. Санкт-Петербург;45_75_days;SputnikLite;4789;856;5645;3114778;1306302;4421080
2022.08_13-10-2022;г. Санкт-Петербург;45_75_days;SputnikV;8670;3227;11897;3114778;1306302;4421080
2022.08_13-10-2022;г. Санкт-Петербург;75_90_days;AllVaccines;7669;2679;10348;3114778;1306302;4421080
2022.08_13-10-2022;г. Санкт-Петербург;75_90_days;CoviVac;708;120;828;3114778;1306302;4421080
2022.08_13-10-2022;г. Санкт-Петербург;75_90_days;EpiVacCorona;7;6;13;3114778;1306302;4421080
2022.08_13-10-2022;г. Санкт-Петербург;75_90_days;SputnikLite;1905;328;2233;3114778;1306302;4421080
2022.08_13-10-2022;г. Санкт-Петербург;75_90_days;SputnikV;5049;2225;7274;3114778;1306302;4421080
2022.08_13-10-2022;г. Санкт-Петербург;90_105_days;AllVaccines;7789;3569;11358;3114778;1306302;4421080
2022.08_13-10-2022;г. Санкт-Петербург;90_105_days;CoviVac;233;10;243;3114778;1306302;4421080
2022.08_13-10-2022;г. Санкт-Петербург;90_105_days;EpiVacCorona;24;21;45;3114778;1306302;4421080
2022.08_13-10-2022;г. Санкт-Петербург;90_105_days;SputnikLite;2212;568;2780;3114778;1306302;4421080
2022.08_13-10-2022;г. Санкт-Петербург;90_105_days;SputnikV;5320;2970;8290;3114778;1306302;4421080
2022.08_13-10-2022;г. Севастополь;105_165_days;AllVaccines;5478;4931;10409;293051;116400;409451
2022.08_13-10-2022;г. Севастополь;105_165_days;CoviVac;23;12;35;293051;116400;409451
2022.08_13-10-2022;г. Севастополь;105_165_days;EpiVacCorona;35;44;79;293051;116400;409451
2022.08_13-10-2022;г. Севастополь;105_165_days;SputnikLite;3573;2617;6190;293051;116400;409451
2022.08_13-10-2022;г. Севастополь;105_165_days;SputnikV;1847;2258;4105;293051;116400;409451
2022.08_13-10-2022;г. Севастополь;165_195_days;AllVaccines;2585;1619;4204;293051;116400;409451
2022.08_13-10-2022;г. Севастополь;165_195_days;CoviVac;24;10;34;293051;116400;409451
2022.08_13-10-2022;г. Севастополь;165_195_days;EpiVacCorona;21;41;62;293051;116400;409451
2022.08_13-10-2022;г. Севастополь;165_195_days;SputnikLite;1407;909;2316;293051;116400;409451
2022.08_13-10-2022;г. Севастополь;165_195_days;SputnikV;1133;659;1792;293051;116400;409451
2022.08_13-10-2022;г. Севастополь;21_45_days;AllVaccines;3613;1861;5474;293051;116400;409451
2022.08_13-10-2022;г. Севастополь;21_45_days;EpiVacCorona;2;4;6;293051;116400;409451
2022.08_13-10-2022;г. Севастополь;21_45_days;SputnikLite;898;280;1178;293051;116400;409451
2022.08_13-10-2022;г. Севастополь;21_45_days;SputnikV;2713;1577;4290;293051;116400;409451
2022.08_13-10-2022;г. Севастополь;45_75_days;AllVaccines;2509;1498;4007;293051;116400;409451
2022.08_13-10-2022;г. Севастополь;45_75_days;EpiVacCorona;24;29;53;293051;116400;409451
2022.08_13-10-2022;г. Севастополь;45_75_days;SputnikLite;1176;312;1488;293051;116400;409451
2022.08_13-10-2022;г. Севастополь;45_75_days;SputnikV;1309;1157;2466;293051;116400;409451
2022.08_13-10-2022;г. Севастополь;75_90_days;AllVaccines;1092;1103;2195;293051;116400;409451
2022.08_13-10-2022;г. Севастополь;75_90_days;EpiVacCorona;22;12;34;293051;116400;409451
2022.08_13-10-2022;г. Севастополь;75_90_days;SputnikLite;225;144;369;293051;116400;409451
2022.08_13-10-2022;г. Севастополь;75_90_days;SputnikV;845;947;1792;293051;116400;409451
2022.08_13-10-2022;г. Севастополь;90_105_days;AllVaccines;1140;1361;2501;293051;116400;409451
2022.08_13-10-2022;г. Севастополь;90_105_days;EpiVacCorona;14;18;32;293051;116400;409451
2022.08_13-10-2022;г. Севастополь;90_105_days;SputnikLite;216;109;325;293051;116400;409451
2022.08_13-10-2022;г. Севастополь;90_105_days;SputnikV;910;1234;2144;293051;116400;409451
